"state_from","county_from","state_to","county_to","in","out","change"
1,1,1,3,0,90,-90
1,1,1,21,203,278,-75
1,1,1,47,212,89,123
1,1,1,51,1426,1388,38
1,1,1,73,106,129,-23
1,1,1,81,72,120,-48
1,1,1,85,72,0,72
1,1,1,101,1214,915,299
1,1,1,117,70,114,-44
1,1,1,125,0,51,-51
1,3,1,1,90,0,90
1,3,1,15,91,0,91
1,3,1,25,86,0,86
1,3,1,51,111,67,44
1,3,1,53,300,250,50
1,3,1,55,75,0,75
1,3,1,69,97,57,40
1,3,1,73,542,317,225
1,3,1,77,74,0,74
1,3,1,81,221,145,76
1,3,1,89,164,106,58
1,3,1,97,3008,2031,977
1,3,1,99,106,82,24
1,3,1,101,164,106,58
1,3,1,115,76,0,76
1,3,1,117,295,191,104
1,3,1,121,56,0,56
1,3,1,125,225,98,127
1,3,1,127,69,0,69
1,3,1,129,64,0,64
1,3,4,13,77,0,77
1,3,6,37,71,0,71
1,3,6,73,100,62,38
1,3,12,5,98,56,42
1,3,12,11,75,0,75
1,3,12,31,109,69,40
1,3,12,33,1091,927,164
1,3,12,57,0,96,-96
1,3,12,91,125,143,-18
1,3,12,95,58,103,-45
1,3,12,103,52,0,52
1,3,12,113,230,231,-1
1,3,12,131,77,60,17
1,3,13,67,128,0,128
1,3,13,89,66,52,14
1,3,13,121,73,59,14
1,3,13,135,62,0,62
1,3,22,33,71,0,71
1,3,22,55,62,0,62
1,3,22,71,0,52,-52
1,3,22,103,77,54,23
1,3,28,47,104,106,-2
1,3,28,59,127,115,12
1,3,28,75,57,0,57
1,3,47,37,99,0,99
1,3,47,157,165,0,165
1,3,48,29,62,0,62
1,3,48,113,65,68,-3
1,3,48,201,110,101,9
1,3,48,439,82,0,82
1,5,1,11,0,64,-64
1,5,1,45,110,129,-19
1,5,1,67,81,124,-43
1,5,1,69,97,184,-87
1,5,1,81,0,76,-76
1,5,1,109,61,62,-1
1,5,13,239,101,0,101
1,7,1,21,100,114,-14
1,7,1,73,249,251,-2
1,7,1,117,168,229,-61
1,7,1,125,356,421,-65
1,9,1,43,297,437,-140
1,9,1,55,151,215,-64
1,9,1,73,1507,1087,420
1,9,1,95,284,328,-44
1,9,1,103,0,81,-81
1,9,1,115,263,279,-16
1,9,1,117,128,100,28
1,9,1,127,72,86,-14
1,11,1,5,64,0,64
1,11,1,101,119,117,2
1,11,1,109,86,82,4
1,13,1,41,83,91,-8
1,13,1,85,112,81,31
1,13,1,101,99,153,-54
1,15,1,3,0,91,-91
1,15,1,19,183,134,49
1,15,1,27,105,98,7
1,15,1,29,267,202,65
1,15,1,49,80,0,80
1,15,1,55,536,616,-80
1,15,1,73,233,394,-161
1,15,1,81,57,0,57
1,15,1,89,69,153,-84
1,15,1,95,61,0,61
1,15,1,97,0,60,-60
1,15,1,101,0,54,-54
1,15,1,111,96,102,-6
1,15,1,115,309,285,24
1,15,1,117,111,147,-36
1,15,1,121,1245,1290,-45
1,15,1,125,54,53,1
1,15,13,45,88,101,-13
1,15,13,67,0,63,-63
1,15,13,97,72,0,72
1,17,1,81,830,829,1
1,17,1,111,151,109,42
1,17,1,123,50,62,-12
1,17,13,285,499,396,103
1,19,1,15,134,183,-49
1,19,1,49,215,220,-5
1,19,1,55,192,251,-59
1,19,13,55,82,0,82
1,19,13,115,201,139,62
1,19,13,233,78,0,78
1,21,1,1,278,203,75
1,21,1,7,114,100,14
1,21,1,47,83,57,26
1,21,1,51,106,123,-17
1,21,1,73,253,307,-54
1,21,1,101,84,80,4
1,21,1,117,881,719,162
1,23,28,75,0,87,-87
1,25,1,3,0,86,-86
1,25,1,91,105,87,18
1,25,1,97,137,171,-34
1,25,1,129,161,115,46
1,25,1,131,103,92,11
1,27,1,15,98,105,-7
1,27,1,111,119,138,-19
1,27,1,121,142,144,-2
1,27,1,123,0,81,-81
1,29,1,15,202,267,-65
1,29,1,111,0,122,-122
1,29,1,121,0,74,-74
1,29,13,45,149,134,15
1,29,13,143,99,80,19
1,31,1,39,202,168,34
1,31,1,45,1058,881,177
1,31,1,61,229,297,-68
1,31,1,69,351,346,5
1,31,1,73,0,61,-61
1,31,1,89,0,106,-106
1,31,1,101,85,0,85
1,31,1,109,213,171,42
1,31,8,41,90,118,-28
1,31,12,5,80,66,14
1,31,13,51,73,0,73
1,31,15,3,95,0,95
1,31,36,45,93,77,16
1,31,37,51,66,0,66
1,31,47,125,84,87,-3
1,31,48,27,82,0,82
1,31,48,141,0,76,-76
1,33,1,59,417,321,96
1,33,1,73,60,74,-14
1,33,1,77,1353,1249,104
1,33,1,79,160,139,21
1,33,1,83,0,74,-74
1,33,1,89,111,174,-63
1,33,1,93,63,0,63
1,33,1,103,75,104,-29
1,35,1,39,0,62,-62
1,35,1,53,105,122,-17
1,35,1,99,100,113,-13
1,37,1,51,0,62,-62
1,37,1,121,274,262,12
1,37,1,123,244,221,23
1,39,1,31,168,202,-34
1,39,1,35,62,0,62
1,39,1,41,112,141,-29
1,39,1,61,0,87,-87
1,39,1,69,0,65,-65
1,39,12,91,144,132,12
1,39,12,131,87,76,11
1,41,1,13,91,83,8
1,41,1,39,141,112,29
1,41,1,101,131,133,-2
1,41,1,109,112,107,5
1,43,1,9,437,297,140
1,43,1,55,74,0,74
1,43,1,73,610,392,218
1,43,1,83,73,81,-8
1,43,1,89,233,200,33
1,43,1,95,351,394,-43
1,43,1,103,568,670,-102
1,43,1,115,63,0,63
1,43,1,117,148,72,76
1,43,1,127,96,114,-18
1,43,1,133,173,135,38
1,45,1,5,129,110,19
1,45,1,31,881,1058,-177
1,45,1,61,117,184,-67
1,45,1,67,130,122,8
1,45,1,69,1132,1160,-28
1,45,1,73,0,53,-53
1,45,1,89,0,98,-98
1,45,1,101,0,62,-62
1,45,1,109,183,116,67
1,45,2,90,0,101,-101
1,45,8,41,125,137,-12
1,45,12,5,84,0,84
1,45,13,51,0,85,-85
1,45,15,3,83,140,-57
1,45,36,45,108,153,-45
1,45,37,51,114,0,114
1,45,47,125,118,144,-26
1,45,48,27,95,142,-47
1,45,48,141,106,164,-58
1,45,53,53,128,85,43
1,47,1,1,89,212,-123
1,47,1,21,57,83,-26
1,47,1,51,0,86,-86
1,47,1,73,125,168,-43
1,47,1,101,209,485,-276
1,47,1,125,0,93,-93
1,49,1,15,0,80,-80
1,49,1,19,220,215,5
1,49,1,55,242,362,-120
1,49,1,71,531,595,-64
1,49,1,73,63,95,-32
1,49,1,89,0,127,-127
1,49,1,95,743,748,-5
1,49,13,83,85,59,26
1,49,47,65,105,119,-14
1,51,1,1,1388,1426,-38
1,51,1,3,67,111,-44
1,51,1,21,123,106,17
1,51,1,37,62,0,62
1,51,1,47,86,0,86
1,51,1,73,106,123,-17
1,51,1,81,181,172,9
1,51,1,87,87,0,87
1,51,1,97,78,0,78
1,51,1,101,2198,1562,636
1,51,1,117,125,134,-9
1,51,1,123,359,363,-4
1,53,1,3,250,300,-50
1,53,1,35,122,105,17
1,53,1,97,100,151,-51
1,53,1,99,105,69,36
1,53,12,33,342,384,-42
1,53,12,113,126,166,-40
1,55,1,3,0,75,-75
1,55,1,9,215,151,64
1,55,1,15,616,536,80
1,55,1,19,251,192,59
1,55,1,43,0,74,-74
1,55,1,49,362,242,120
1,55,1,73,360,348,12
1,55,1,89,95,201,-106
1,55,1,95,826,718,108
1,55,1,115,380,341,39
1,55,1,117,65,115,-50
1,55,1,121,119,82,37
1,55,1,125,0,59,-59
1,57,1,75,75,68,7
1,57,1,93,212,218,-6
1,57,1,125,223,253,-30
1,59,1,33,321,417,-96
1,59,1,77,111,148,-37
1,59,1,79,65,122,-57
1,59,1,93,212,232,-20
1,59,1,133,108,101,7
1,59,28,57,91,89,2
1,59,28,141,82,98,-16
1,61,1,31,297,229,68
1,61,1,39,87,0,87
1,61,1,45,184,117,67
1,61,1,69,511,481,30
1,61,12,59,68,106,-38
1,63,1,125,172,193,-21
1,65,1,91,75,101,-26
1,65,1,125,469,579,-110
1,67,1,5,124,81,43
1,67,1,45,122,130,-8
1,67,1,69,633,562,71
1,69,1,3,57,97,-40
1,69,1,5,184,97,87
1,69,1,31,346,351,-5
1,69,1,39,65,0,65
1,69,1,45,1160,1132,28
1,69,1,61,481,511,-30
1,69,1,67,562,633,-71
1,69,1,73,134,111,23
1,69,1,81,68,98,-30
1,69,1,89,0,79,-79
1,69,1,97,74,84,-10
1,69,1,101,74,153,-79
1,69,1,109,117,130,-13
1,69,1,117,63,71,-8
1,69,1,125,63,0,63
1,69,12,5,385,156,229
1,69,12,33,65,0,65
1,69,12,57,71,0,71
1,69,12,63,221,182,39
1,69,12,73,0,74,-74
1,69,12,91,58,96,-38
1,69,13,99,84,0,84
1,69,13,121,0,60,-60
1,71,1,49,595,531,64
1,71,1,89,333,439,-106
1,71,1,95,226,237,-11
1,71,13,83,125,112,13
1,71,47,65,133,110,23
1,71,47,115,146,174,-28
1,73,1,1,129,106,23
1,73,1,3,317,542,-225
1,73,1,7,251,249,2
1,73,1,9,1087,1507,-420
1,73,1,15,394,233,161
1,73,1,21,307,253,54
1,73,1,31,61,0,61
1,73,1,33,74,60,14
1,73,1,43,392,610,-218
1,73,1,45,53,0,53
1,73,1,47,168,125,43
1,73,1,49,95,63,32
1,73,1,51,123,106,17
1,73,1,55,348,360,-12
1,73,1,69,111,134,-23
1,73,1,77,109,115,-6
1,73,1,81,458,326,132
1,73,1,83,110,94,16
1,73,1,89,729,828,-99
1,73,1,95,167,158,9
1,73,1,97,450,428,22
1,73,1,101,779,427,352
1,73,1,103,154,222,-68
1,73,1,109,59,0,59
1,73,1,115,2166,3150,-984
1,73,1,117,6821,8385,-1564
1,73,1,121,344,334,10
1,73,1,123,84,84,0
1,73,1,125,1710,1385,325
1,73,1,127,836,881,-45
1,73,1,133,64,74,-10
1,73,4,13,79,193,-114
1,73,6,1,0,55,-55
1,73,6,37,176,161,15
1,73,6,59,0,91,-91
1,73,6,73,67,95,-28
1,73,8,31,0,83,-83
1,73,8,41,88,0,88
1,73,11,1,0,74,-74
1,73,12,5,116,110,6
1,73,12,11,100,77,23
1,73,12,31,132,179,-47
1,73,12,33,188,197,-9
1,73,12,57,100,180,-80
1,73,12,73,0,82,-82
1,73,12,86,103,0,103
1,73,12,91,61,115,-54
1,73,12,95,132,159,-27
1,73,12,99,123,78,45
1,73,12,103,79,82,-3
1,73,12,105,69,67,2
1,73,12,113,0,83,-83
1,73,12,115,0,60,-60
1,73,12,131,0,85,-85
1,73,13,51,0,61,-61
1,73,13,63,64,101,-37
1,73,13,67,241,317,-76
1,73,13,89,264,343,-79
1,73,13,97,51,62,-11
1,73,13,117,0,84,-84
1,73,13,121,448,616,-168
1,73,13,135,185,196,-11
1,73,13,151,0,66,-66
1,73,13,215,116,0,116
1,73,13,245,67,0,67
1,73,17,31,187,170,17
1,73,18,97,72,84,-12
1,73,21,111,70,60,10
1,73,22,33,54,0,54
1,73,22,51,74,0,74
1,73,22,71,84,114,-30
1,73,25,25,0,60,-60
1,73,26,125,92,0,92
1,73,26,163,108,75,33
1,73,28,47,0,73,-73
1,73,28,49,77,70,7
1,73,28,75,56,0,56
1,73,28,89,105,0,105
1,73,28,105,53,0,53
1,73,28,121,78,0,78
1,73,29,189,0,73,-73
1,73,32,3,0,117,-117
1,73,36,47,78,44,34
1,73,36,61,112,122,-10
1,73,36,81,67,0,67
1,73,37,63,58,0,58
1,73,37,119,86,156,-70
1,73,39,35,55,0,55
1,73,39,49,57,92,-35
1,73,39,61,70,0,70
1,73,45,19,0,74,-74
1,73,45,45,75,0,75
1,73,45,79,57,0,57
1,73,47,37,267,425,-158
1,73,47,65,127,102,25
1,73,47,93,88,94,-6
1,73,47,125,0,56,-56
1,73,47,149,64,102,-38
1,73,47,157,218,178,40
1,73,47,187,72,152,-80
1,73,48,29,79,109,-30
1,73,48,85,0,78,-78
1,73,48,113,185,241,-56
1,73,48,121,0,72,-72
1,73,48,201,258,257,1
1,73,48,439,90,131,-41
1,73,48,453,131,75,56
1,73,51,59,0,67,-67
1,73,53,33,66,108,-42
1,75,1,57,68,75,-7
1,75,1,93,118,146,-28
1,75,28,87,101,95,6
1,77,1,3,0,74,-74
1,77,1,33,1249,1353,-104
1,77,1,59,148,111,37
1,77,1,73,115,109,6
1,77,1,79,102,96,6
1,77,1,83,291,346,-55
1,77,1,89,299,398,-99
1,77,1,103,106,123,-17
1,77,47,37,0,67,-67
1,77,47,99,143,146,-3
1,77,47,181,78,83,-5
1,79,1,33,139,160,-21
1,79,1,59,122,65,57
1,79,1,77,96,102,-6
1,79,1,83,70,81,-11
1,79,1,89,105,81,24
1,79,1,103,783,910,-127
1,81,1,1,120,72,48
1,81,1,3,145,221,-76
1,81,1,5,76,0,76
1,81,1,15,0,57,-57
1,81,1,17,829,830,-1
1,81,1,51,172,181,-9
1,81,1,69,98,68,30
1,81,1,73,326,458,-132
1,81,1,87,444,331,113
1,81,1,89,109,189,-80
1,81,1,97,117,55,62
1,81,1,101,499,310,189
1,81,1,111,71,0,71
1,81,1,113,1765,1694,71
1,81,1,117,160,192,-32
1,81,1,121,0,68,-68
1,81,1,123,466,546,-80
1,81,1,125,82,79,3
1,81,4,13,0,63,-63
1,81,12,5,0,57,-57
1,81,12,31,0,76,-76
1,81,12,33,0,60,-60
1,81,12,91,0,75,-75
1,81,12,113,0,64,-64
1,81,13,53,79,70,9
1,81,13,67,137,113,24
1,81,13,77,68,123,-55
1,81,13,89,76,105,-29
1,81,13,121,140,208,-68
1,81,13,135,101,137,-36
1,81,13,145,133,163,-30
1,81,13,215,1132,900,232
1,81,13,285,158,130,28
1,81,47,37,0,70,-70
1,81,47,157,0,53,-53
1,81,48,29,0,58,-58
1,81,48,201,0,47,-47
1,83,1,33,74,0,74
1,83,1,43,81,73,8
1,83,1,73,94,110,-16
1,83,1,77,346,291,55
1,83,1,79,81,70,11
1,83,1,89,4232,2619,1613
1,83,1,103,672,618,54
1,83,47,37,58,0,58
1,83,47,55,166,208,-42
1,83,47,103,94,64,30
1,85,1,1,0,72,-72
1,85,1,13,81,112,-31
1,85,1,101,420,436,-16
1,87,1,51,0,87,-87
1,87,1,81,331,444,-113
1,87,1,101,177,257,-80
1,89,1,3,106,164,-58
1,89,1,15,153,69,84
1,89,1,31,106,0,106
1,89,1,33,174,111,63
1,89,1,43,200,233,-33
1,89,1,45,98,0,98
1,89,1,49,127,0,127
1,89,1,55,201,95,106
1,89,1,69,79,0,79
1,89,1,71,439,333,106
1,89,1,73,828,729,99
1,89,1,77,398,299,99
1,89,1,79,81,105,-24
1,89,1,81,189,109,80
1,89,1,83,2619,4232,-1613
1,89,1,95,767,703,64
1,89,1,97,221,162,59
1,89,1,101,258,112,146
1,89,1,103,1227,1385,-158
1,89,1,115,0,90,-90
1,89,1,117,245,251,-6
1,89,1,121,63,0,63
1,89,1,125,243,184,59
1,89,1,127,59,0,59
1,89,4,13,82,130,-48
1,89,4,19,110,67,43
1,89,6,37,160,113,47
1,89,6,59,89,0,89
1,89,6,65,81,0,81
1,89,6,67,132,0,132
1,89,6,73,196,65,131
1,89,6,85,0,63,-63
1,89,8,41,229,125,104
1,89,12,5,106,81,25
1,89,12,9,172,96,76
1,89,12,11,109,63,46
1,89,12,31,106,72,34
1,89,12,33,81,103,-22
1,89,12,57,108,106,2
1,89,12,86,72,0,72
1,89,12,91,109,134,-25
1,89,12,95,102,122,-20
1,89,12,99,70,69,1
1,89,12,103,74,80,-6
1,89,12,113,0,75,-75
1,89,12,127,65,0,65
1,89,13,63,54,0,54
1,89,13,67,150,99,51
1,89,13,89,129,74,55
1,89,13,121,138,234,-96
1,89,13,135,145,140,5
1,89,13,153,70,0,70
1,89,13,215,82,0,82
1,89,15,3,94,0,94
1,89,17,31,149,98,51
1,89,21,111,86,56,30
1,89,24,3,62,0,62
1,89,26,125,0,61,-61
1,89,26,163,68,0,68
1,89,28,47,78,0,78
1,89,29,189,60,0,60
1,89,32,3,94,64,30
1,89,37,51,92,87,5
1,89,37,119,89,79,10
1,89,37,183,0,79,-79
1,89,47,31,60,0,60
1,89,47,37,337,304,33
1,89,47,51,0,77,-77
1,89,47,55,169,91,78
1,89,47,65,141,125,16
1,89,47,93,141,69,72
1,89,47,103,457,619,-162
1,89,47,119,56,59,-3
1,89,47,125,185,114,71
1,89,47,149,152,137,15
1,89,47,157,141,119,22
1,89,47,187,115,91,24
1,89,48,27,93,0,93
1,89,48,29,121,81,40
1,89,48,85,0,65,-65
1,89,48,113,104,76,28
1,89,48,141,102,0,102
1,89,48,201,136,120,16
1,89,48,439,110,102,8
1,89,48,453,63,0,63
1,89,51,13,0,49,-49
1,89,51,41,62,0,62
1,89,51,59,235,91,144
1,89,51,153,89,0,89
1,89,53,33,100,81,19
1,89,53,53,87,68,19
1,89,53,61,61,0,61
1,91,1,25,87,105,-18
1,91,1,65,101,75,26
1,91,1,125,120,207,-87
1,93,1,33,0,63,-63
1,93,1,57,218,212,6
1,93,1,59,232,212,20
1,93,1,75,146,118,28
1,93,1,125,0,74,-74
1,93,1,127,91,119,-28
1,93,1,133,264,242,22
1,95,1,9,328,284,44
1,95,1,15,0,61,-61
1,95,1,43,394,351,43
1,95,1,49,748,743,5
1,95,1,55,718,826,-108
1,95,1,71,237,226,11
1,95,1,73,158,167,-9
1,95,1,89,703,767,-64
1,95,1,103,290,272,18
1,95,1,115,49,0,49
1,95,1,117,69,63,6
1,97,1,3,2031,3008,-977
1,97,1,15,60,0,60
1,97,1,25,171,137,34
1,97,1,51,0,78,-78
1,97,1,53,151,100,51
1,97,1,69,84,74,10
1,97,1,73,428,450,-22
1,97,1,81,55,117,-62
1,97,1,89,162,221,-59
1,97,1,99,84,85,-1
1,97,1,101,237,213,24
1,97,1,117,127,170,-43
1,97,1,125,121,121,0
1,97,1,129,431,419,12
1,97,4,13,0,97,-97
1,97,6,37,74,70,4
1,97,6,73,87,120,-33
1,97,8,41,0,67,-67
1,97,12,5,145,0,145
1,97,12,11,71,0,71
1,97,12,31,88,127,-39
1,97,12,33,313,446,-133
1,97,12,57,82,109,-27
1,97,12,91,103,154,-51
1,97,12,95,85,53,32
1,97,12,103,0,52,-52
1,97,12,113,123,138,-15
1,97,13,63,91,0,91
1,97,13,67,63,117,-54
1,97,13,89,90,178,-88
1,97,13,121,112,169,-57
1,97,13,135,90,117,-27
1,97,17,31,83,58,25
1,97,22,33,59,86,-27
1,97,22,51,87,111,-24
1,97,22,71,76,104,-28
1,97,22,103,77,94,-17
1,97,28,35,77,75,2
1,97,28,39,198,346,-148
1,97,28,41,59,0,59
1,97,28,47,312,273,39
1,97,28,59,637,743,-106
1,97,28,73,54,0,54
1,97,28,75,59,0,59
1,97,47,37,58,105,-47
1,97,47,65,0,63,-63
1,97,47,157,52,0,52
1,97,48,27,0,61,-61
1,97,48,29,66,118,-52
1,97,48,113,65,93,-28
1,97,48,201,248,308,-60
1,97,48,439,63,128,-65
1,97,48,453,76,55,21
1,99,1,3,82,106,-24
1,99,1,35,113,100,13
1,99,1,53,69,105,-36
1,99,1,97,85,84,1
1,101,1,1,915,1214,-299
1,101,1,3,106,164,-58
1,101,1,11,117,119,-2
1,101,1,13,153,99,54
1,101,1,15,54,0,54
1,101,1,21,80,84,-4
1,101,1,31,0,85,-85
1,101,1,41,133,131,2
1,101,1,45,62,0,62
1,101,1,47,485,209,276
1,101,1,51,1562,2198,-636
1,101,1,69,153,74,79
1,101,1,73,427,779,-352
1,101,1,81,310,499,-189
1,101,1,85,436,420,16
1,101,1,87,257,177,80
1,101,1,89,112,258,-146
1,101,1,97,213,237,-24
1,101,1,109,260,225,35
1,101,1,113,0,64,-64
1,101,1,117,202,286,-84
1,101,1,121,73,0,73
1,101,1,123,105,126,-21
1,101,1,125,133,146,-13
1,101,6,37,55,79,-24
1,101,8,41,113,115,-2
1,101,12,31,70,86,-16
1,101,12,33,88,102,-14
1,101,12,57,82,72,10
1,101,12,86,73,0,73
1,101,12,91,124,121,3
1,101,12,113,87,86,1
1,101,13,63,64,111,-47
1,101,13,67,83,195,-112
1,101,13,89,76,150,-74
1,101,13,121,107,268,-161
1,101,13,135,95,157,-62
1,101,13,215,111,101,10
1,101,15,3,85,94,-9
1,101,17,31,66,0,66
1,101,32,3,0,72,-72
1,101,36,61,0,76,-76
1,101,47,37,0,97,-97
1,101,48,29,120,148,-28
1,101,48,201,66,76,-10
1,101,51,59,91,157,-66
1,103,1,9,81,0,81
1,103,1,33,104,75,29
1,103,1,43,670,568,102
1,103,1,73,222,154,68
1,103,1,77,123,106,17
1,103,1,79,910,783,127
1,103,1,83,618,672,-54
1,103,1,89,1385,1227,158
1,103,1,95,272,290,-18
1,103,1,117,77,71,6
1,103,1,125,59,0,59
1,103,1,133,63,0,63
1,103,47,37,0,44,-44
1,105,1,125,0,130,-130
1,107,1,125,311,382,-71
1,107,28,87,84,96,-12
1,109,1,5,62,61,1
1,109,1,11,82,86,-4
1,109,1,31,171,213,-42
1,109,1,41,107,112,-5
1,109,1,45,116,183,-67
1,109,1,69,130,117,13
1,109,1,73,0,59,-59
1,109,1,101,225,260,-35
1,111,1,15,102,96,6
1,111,1,17,109,151,-42
1,111,1,27,138,119,19
1,111,1,29,122,0,122
1,111,1,81,0,71,-71
1,111,13,45,176,157,19
1,111,13,285,0,70,-70
1,113,1,81,1694,1765,-71
1,113,1,101,64,0,64
1,113,8,41,139,0,139
1,113,13,53,139,91,48
1,113,13,89,0,60,-60
1,113,13,121,0,67,-67
1,113,13,145,112,137,-25
1,113,13,215,2256,2042,214
1,113,15,3,84,0,84
1,113,37,51,111,63,48
1,113,47,125,57,0,57
1,113,48,27,115,0,115
1,113,48,141,92,0,92
1,113,53,53,113,0,113
1,115,1,3,0,76,-76
1,115,1,9,279,263,16
1,115,1,15,285,309,-24
1,115,1,43,0,63,-63
1,115,1,55,341,380,-39
1,115,1,73,3150,2166,984
1,115,1,89,90,0,90
1,115,1,95,0,49,-49
1,115,1,117,531,481,50
1,115,1,121,551,631,-80
1,115,1,125,74,77,-3
1,117,1,1,114,70,44
1,117,1,3,191,295,-104
1,117,1,7,229,168,61
1,117,1,9,100,128,-28
1,117,1,15,147,111,36
1,117,1,21,719,881,-162
1,117,1,43,72,148,-76
1,117,1,51,134,125,9
1,117,1,55,115,65,50
1,117,1,69,71,63,8
1,117,1,73,8385,6821,1564
1,117,1,81,192,160,32
1,117,1,89,251,245,6
1,117,1,95,63,69,-6
1,117,1,97,170,127,43
1,117,1,101,286,202,84
1,117,1,103,71,77,-6
1,117,1,115,481,531,-50
1,117,1,121,352,403,-51
1,117,1,123,66,60,6
1,117,1,125,499,326,173
1,117,1,127,98,74,24
1,117,6,73,63,0,63
1,117,12,5,86,60,26
1,117,12,31,76,0,76
1,117,12,33,0,86,-86
1,117,12,57,59,82,-23
1,117,12,91,0,56,-56
1,117,12,95,65,0,65
1,117,12,131,0,52,-52
1,117,13,67,96,87,9
1,117,13,89,0,74,-74
1,117,13,121,93,192,-99
1,117,13,135,83,108,-25
1,117,37,119,54,0,54
1,117,47,37,74,101,-27
1,117,47,157,0,66,-66
1,117,48,113,0,68,-68
1,117,48,201,74,66,8
1,119,1,125,91,129,-38
1,119,28,75,0,86,-86
1,121,1,3,0,56,-56
1,121,1,15,1290,1245,45
1,121,1,27,144,142,2
1,121,1,29,74,0,74
1,121,1,37,262,274,-12
1,121,1,55,82,119,-37
1,121,1,73,334,344,-10
1,121,1,81,68,0,68
1,121,1,89,0,63,-63
1,121,1,101,0,73,-73
1,121,1,115,631,551,80
1,121,1,117,403,352,51
1,121,1,123,141,123,18
1,123,1,17,62,50,12
1,123,1,27,81,0,81
1,123,1,37,221,244,-23
1,123,1,51,363,359,4
1,123,1,73,84,84,0
1,123,1,81,546,466,80
1,123,1,101,126,105,21
1,123,1,117,60,66,-6
1,123,1,121,123,141,-18
1,125,1,1,51,0,51
1,125,1,3,98,225,-127
1,125,1,7,421,356,65
1,125,1,15,53,54,-1
1,125,1,47,93,0,93
1,125,1,55,59,0,59
1,125,1,57,253,223,30
1,125,1,63,193,172,21
1,125,1,65,579,469,110
1,125,1,69,0,63,-63
1,125,1,73,1385,1710,-325
1,125,1,81,79,82,-3
1,125,1,89,184,243,-59
1,125,1,91,207,120,87
1,125,1,93,74,0,74
1,125,1,97,121,121,0
1,125,1,101,146,133,13
1,125,1,103,0,59,-59
1,125,1,105,130,0,130
1,125,1,107,382,311,71
1,125,1,115,77,74,3
1,125,1,117,326,499,-173
1,125,1,119,129,91,38
1,125,1,127,101,75,26
1,125,13,67,0,91,-91
1,125,13,89,0,54,-54
1,125,13,121,60,152,-92
1,125,17,31,55,0,55
1,125,28,75,54,0,54
1,125,28,87,72,76,-4
1,125,47,37,0,91,-91
1,125,47,157,53,78,-25
1,125,48,113,0,52,-52
1,125,48,201,87,86,1
1,127,1,3,0,69,-69
1,127,1,9,86,72,14
1,127,1,43,114,96,18
1,127,1,73,881,836,45
1,127,1,89,0,59,-59
1,127,1,93,119,91,28
1,127,1,117,74,98,-24
1,127,1,125,75,101,-26
1,127,1,133,257,283,-26
1,129,1,3,0,64,-64
1,129,1,25,115,161,-46
1,129,1,97,419,431,-12
1,131,1,25,92,103,-11
1,133,1,43,135,173,-38
1,133,1,59,101,108,-7
1,133,1,73,74,64,10
1,133,1,93,242,264,-22
1,133,1,103,0,63,-63
1,133,1,127,283,257,26
2,13,53,33,0,65,-65
2,16,2,20,0,86,-86
2,16,53,33,0,55,-55
2,20,2,16,86,0,86
2,20,2,50,274,166,108
2,20,2,70,92,89,3
2,20,2,90,726,536,190
2,20,2,110,222,187,35
2,20,2,122,680,751,-71
2,20,2,130,56,0,56
2,20,2,150,218,148,70
2,20,2,158,65,53,12
2,20,2,170,2056,3624,-1568
2,20,2,180,130,91,39
2,20,2,185,147,84,63
2,20,2,188,168,75,93
2,20,2,220,0,63,-63
2,20,2,261,126,163,-37
2,20,2,290,51,0,51
2,20,4,13,327,830,-503
2,20,4,19,117,202,-85
2,20,4,21,0,111,-111
2,20,4,25,0,73,-73
2,20,6,1,52,73,-21
2,20,6,13,77,0,77
2,20,6,29,0,61,-61
2,20,6,37,204,249,-45
2,20,6,59,84,114,-30
2,20,6,65,94,118,-24
2,20,6,67,90,173,-83
2,20,6,71,124,143,-19
2,20,6,73,178,198,-20
2,20,6,85,0,67,-67
2,20,6,95,86,105,-19
2,20,8,5,65,93,-28
2,20,8,31,0,119,-119
2,20,8,41,218,362,-144
2,20,8,59,69,70,-1
2,20,8,69,0,100,-100
2,20,11,1,0,48,-48
2,20,12,5,121,79,42
2,20,12,9,0,57,-57
2,20,12,31,0,71,-71
2,20,12,57,77,110,-33
2,20,12,91,109,122,-13
2,20,12,103,0,69,-69
2,20,13,153,0,75,-75
2,20,13,215,80,93,-13
2,20,15,1,67,80,-13
2,20,15,3,338,453,-115
2,20,16,1,0,173,-173
2,20,16,55,0,76,-76
2,20,17,31,76,80,-4
2,20,24,3,0,108,-108
2,20,27,37,0,109,-109
2,20,27,53,0,67,-67
2,20,27,123,0,98,-98
2,20,28,47,54,0,54
2,20,32,3,291,625,-334
2,20,32,31,0,73,-73
2,20,34,5,0,75,-75
2,20,35,1,0,108,-108
2,20,35,35,0,66,-66
2,20,37,51,314,234,80
2,20,37,85,0,90,-90
2,20,38,101,0,75,-75
2,20,40,31,0,95,-95
2,20,40,109,139,126,13
2,20,41,5,0,53,-53
2,20,41,17,0,138,-138
2,20,41,29,0,68,-68
2,20,41,39,56,89,-33
2,20,41,47,0,81,-81
2,20,41,51,140,204,-64
2,20,41,67,89,145,-56
2,20,47,125,79,0,79
2,20,48,27,74,133,-59
2,20,48,29,245,300,-55
2,20,48,113,72,99,-27
2,20,48,141,128,87,41
2,20,48,157,0,113,-113
2,20,48,201,206,278,-72
2,20,48,339,0,92,-92
2,20,48,439,0,93,-93
2,20,48,451,61,0,61
2,20,48,453,63,98,-35
2,20,48,491,0,70,-70
2,20,49,11,0,58,-58
2,20,49,35,112,184,-72
2,20,49,49,0,76,-76
2,20,51,59,125,116,9
2,20,53,11,59,171,-112
2,20,53,33,366,766,-400
2,20,53,35,57,96,-39
2,20,53,53,329,533,-204
2,20,53,61,98,175,-77
2,20,53,63,89,236,-147
2,20,53,67,80,191,-111
2,20,53,73,72,108,-36
2,50,2,20,166,274,-108
2,50,2,158,112,0,112
2,50,2,170,0,101,-101
2,68,2,90,0,66,-66
2,70,2,20,89,92,-3
2,90,1,45,101,0,101
2,90,2,20,536,726,-190
2,90,2,68,66,0,66
2,90,2,110,0,70,-70
2,90,2,122,136,141,-5
2,90,2,170,170,293,-123
2,90,2,240,123,117,6
2,90,2,261,62,0,62
2,90,2,290,214,158,56
2,90,4,13,128,226,-98
2,90,4,19,0,75,-75
2,90,6,37,102,115,-13
2,90,6,59,48,0,48
2,90,6,71,105,91,14
2,90,6,73,69,69,0
2,90,8,41,263,340,-77
2,90,13,215,76,130,-54
2,90,15,3,114,190,-76
2,90,16,1,0,77,-77
2,90,20,61,83,130,-47
2,90,20,161,75,0,75
2,90,21,47,0,78,-78
2,90,22,115,0,90,-90
2,90,32,3,71,169,-98
2,90,32,7,0,63,-63
2,90,36,45,0,120,-120
2,90,37,51,102,77,25
2,90,40,31,0,106,-106
2,90,41,51,0,49,-49
2,90,47,125,120,183,-63
2,90,48,27,185,265,-80
2,90,48,29,136,160,-24
2,90,48,141,152,293,-141
2,90,48,201,62,62,0
2,90,49,11,0,84,-84
2,90,53,33,87,168,-81
2,90,53,53,144,245,-101
2,90,53,63,0,78,-78
2,90,53,67,0,88,-88
2,110,2,20,187,222,-35
2,110,2,90,70,0,70
2,110,2,122,0,49,-49
2,110,2,130,91,50,41
2,110,2,170,65,0,65
2,110,2,220,57,0,57
2,110,53,33,72,91,-19
2,122,2,20,751,680,71
2,122,2,90,141,136,5
2,122,2,110,49,0,49
2,122,2,170,290,267,23
2,122,4,13,51,130,-79
2,122,53,33,0,67,-67
2,130,2,20,0,56,-56
2,130,2,110,50,91,-41
2,130,2,198,64,64,0
2,130,53,33,0,57,-57
2,150,2,20,148,218,-70
2,150,37,139,73,0,73
2,158,2,20,53,65,-12
2,158,2,50,0,112,-112
2,170,2,20,3624,2056,1568
2,170,2,50,101,0,101
2,170,2,90,293,170,123
2,170,2,110,0,65,-65
2,170,2,122,267,290,-23
2,170,2,261,60,67,-7
2,170,4,13,129,181,-52
2,170,15,1,0,55,-55
2,170,15,3,74,73,1
2,170,16,55,0,88,-88
2,170,32,3,71,84,-13
2,170,53,33,58,75,-17
2,170,53,53,59,121,-62
2,170,53,63,0,70,-70
2,180,2,20,91,130,-39
2,185,2,20,84,147,-63
2,188,2,20,75,168,-93
2,198,2,130,64,64,0
2,220,2,20,63,0,63
2,220,2,110,0,57,-57
2,240,2,90,117,123,-6
2,261,2,20,163,126,37
2,261,2,90,0,62,-62
2,261,2,170,67,60,7
2,290,2,20,0,51,-51
2,290,2,90,158,214,-56
4,1,4,5,290,388,-98
4,1,4,13,1180,1075,105
4,1,4,17,733,1003,-270
4,1,4,19,132,116,16
4,1,4,21,126,78,48
4,1,8,83,0,76,-76
4,1,35,1,136,161,-25
4,1,35,31,982,921,61
4,1,35,45,562,395,167
4,1,49,37,102,123,-21
4,3,4,5,64,0,64
4,3,4,9,68,130,-62
4,3,4,13,984,1195,-211
4,3,4,15,0,65,-65
4,3,4,17,0,88,-88
4,3,4,19,1650,2163,-513
4,3,4,21,219,218,1
4,3,4,23,86,0,86
4,3,4,25,115,86,29
4,3,4,27,67,0,67
4,3,6,37,148,93,55
4,3,6,65,81,78,3
4,3,6,71,87,0,87
4,3,6,73,234,160,74
4,3,8,41,236,153,83
4,3,13,51,61,0,61
4,3,13,73,0,107,-107
4,3,13,179,111,0,111
4,3,13,245,69,75,-6
4,3,15,3,168,130,38
4,3,24,3,94,0,94
4,3,32,3,113,122,-9
4,3,36,45,0,100,-100
4,3,37,51,127,83,44
4,3,47,125,87,103,-16
4,3,48,27,160,132,28
4,3,48,29,106,128,-22
4,3,48,141,187,185,2
4,3,51,59,74,72,2
4,3,53,53,178,93,85
4,3,53,67,71,0,71
4,5,4,1,388,290,98
4,5,4,3,0,64,-64
4,5,4,7,66,68,-2
4,5,4,13,2986,3746,-760
4,5,4,15,339,250,89
4,5,4,17,606,666,-60
4,5,4,19,412,689,-277
4,5,4,21,156,176,-20
4,5,4,25,823,1279,-456
4,5,4,27,55,0,55
4,5,6,29,56,0,56
4,5,6,37,252,154,98
4,5,6,59,168,68,100
4,5,6,65,135,78,57
4,5,6,71,131,0,131
4,5,6,73,193,147,46
4,5,8,31,0,59,-59
4,5,8,41,0,57,-57
4,5,32,3,212,238,-26
4,5,35,1,76,61,15
4,5,35,31,124,96,28
4,5,35,45,115,0,115
4,5,41,51,0,57,-57
4,5,48,453,0,53,-53
4,5,49,25,62,70,-8
4,5,49,35,77,74,3
4,5,49,53,63,113,-50
4,5,53,33,61,100,-39
4,5,53,53,0,64,-64
4,7,4,5,68,66,2
4,7,4,9,0,135,-135
4,7,4,13,1728,1402,326
4,7,4,17,121,118,3
4,7,4,19,146,127,19
4,7,4,21,283,304,-21
4,7,4,25,139,149,-10
4,7,6,37,61,0,61
4,7,6,59,59,0,59
4,7,6,65,63,0,63
4,7,6,73,78,0,78
4,9,4,3,130,68,62
4,9,4,7,135,0,135
4,9,4,11,252,171,81
4,9,4,13,341,404,-63
4,9,4,17,112,0,112
4,9,4,19,217,228,-11
4,9,4,21,93,107,-14
4,11,4,9,171,252,-81
4,11,4,13,151,79,72
4,11,4,19,69,89,-20
4,12,4,13,220,249,-29
4,12,4,15,106,149,-43
4,12,4,25,60,0,60
4,12,6,65,103,83,20
4,12,6,71,89,65,24
4,13,1,3,0,77,-77
4,13,1,73,193,79,114
4,13,1,81,63,0,63
4,13,1,89,130,82,48
4,13,1,97,97,0,97
4,13,2,20,830,327,503
4,13,2,90,226,128,98
4,13,2,122,130,51,79
4,13,2,170,181,129,52
4,13,4,1,1075,1180,-105
4,13,4,3,1195,984,211
4,13,4,5,3746,2986,760
4,13,4,7,1402,1728,-326
4,13,4,9,404,341,63
4,13,4,11,79,151,-72
4,13,4,12,249,220,29
4,13,4,15,1272,989,283
4,13,4,17,2120,2869,-749
4,13,4,19,8078,6079,1999
4,13,4,21,19049,25257,-6208
4,13,4,23,392,460,-68
4,13,4,25,4721,5494,-773
4,13,4,27,2384,1387,997
4,13,5,7,145,142,3
4,13,5,45,50,0,50
4,13,5,51,0,51,-51
4,13,5,119,192,125,67
4,13,5,143,79,120,-41
4,13,6,1,1461,829,632
4,13,6,7,142,90,52
4,13,6,13,1318,508,810
4,13,6,17,190,129,61
4,13,6,19,510,387,123
4,13,6,23,62,0,62
4,13,6,25,503,319,184
4,13,6,29,738,430,308
4,13,6,31,80,65,15
4,13,6,37,9943,5000,4943
4,13,6,39,90,0,90
4,13,6,41,186,92,94
4,13,6,45,68,0,68
4,13,6,47,157,148,9
4,13,6,53,374,201,173
4,13,6,55,123,69,54
4,13,6,57,100,59,41
4,13,6,59,5289,2475,2814
4,13,6,61,545,280,265
4,13,6,65,4403,1906,2497
4,13,6,67,1303,821,482
4,13,6,71,3159,1427,1732
4,13,6,73,7086,4109,2977
4,13,6,75,511,515,-4
4,13,6,77,622,263,359
4,13,6,79,387,238,149
4,13,6,81,629,351,278
4,13,6,83,464,278,186
4,13,6,85,2130,1458,672
4,13,6,87,204,109,95
4,13,6,89,158,91,67
4,13,6,95,428,236,192
4,13,6,97,518,170,348
4,13,6,99,422,171,251
4,13,6,107,251,169,82
4,13,6,109,49,0,49
4,13,6,111,1366,551,815
4,13,6,113,111,74,37
4,13,6,115,65,0,65
4,13,8,1,829,591,238
4,13,8,5,1281,985,296
4,13,8,7,54,67,-13
4,13,8,13,346,351,-5
4,13,8,14,154,116,38
4,13,8,31,1091,1080,11
4,13,8,35,1020,714,306
4,13,8,37,99,68,31
4,13,8,39,71,0,71
4,13,8,41,1494,1299,195
4,13,8,45,76,82,-6
4,13,8,59,1034,619,415
4,13,8,67,220,219,1
4,13,8,69,607,532,75
4,13,8,77,279,234,45
4,13,8,83,142,106,36
4,13,8,85,72,77,-5
4,13,8,101,178,127,51
4,13,8,117,49,0,49
4,13,8,123,388,398,-10
4,13,9,1,414,225,189
4,13,9,3,357,213,144
4,13,9,9,255,143,112
4,13,9,11,99,78,21
4,13,9,13,71,0,71
4,13,10,3,229,141,88
4,13,10,5,61,0,61
4,13,11,1,280,293,-13
4,13,12,1,77,60,17
4,13,12,5,159,93,66
4,13,12,9,222,188,34
4,13,12,11,669,470,199
4,13,12,15,0,74,-74
4,13,12,17,61,0,61
4,13,12,19,81,75,6
4,13,12,21,160,144,16
4,13,12,31,358,301,57
4,13,12,33,120,121,-1
4,13,12,53,61,0,61
4,13,12,57,618,558,60
4,13,12,61,0,57,-57
4,13,12,69,96,127,-31
4,13,12,71,268,238,30
4,13,12,73,69,47,22
4,13,12,81,130,158,-28
4,13,12,83,87,106,-19
4,13,12,85,0,53,-53
4,13,12,86,666,475,191
4,13,12,87,66,0,66
4,13,12,91,245,129,116
4,13,12,95,526,498,28
4,13,12,97,95,103,-8
4,13,12,99,503,359,144
4,13,12,101,152,191,-39
4,13,12,103,359,368,-9
4,13,12,105,148,157,-9
4,13,12,109,86,120,-34
4,13,12,111,92,92,0
4,13,12,113,80,90,-10
4,13,12,115,151,154,-3
4,13,12,117,208,177,31
4,13,12,119,0,60,-60
4,13,12,127,170,184,-14
4,13,13,51,97,119,-22
4,13,13,57,65,80,-15
4,13,13,63,66,0,66
4,13,13,67,356,293,63
4,13,13,73,62,53,9
4,13,13,77,69,64,5
4,13,13,89,319,244,75
4,13,13,97,65,0,65
4,13,13,117,118,137,-19
4,13,13,121,429,521,-92
4,13,13,135,319,276,43
4,13,13,151,51,0,51
4,13,13,185,55,0,55
4,13,13,215,70,0,70
4,13,13,245,63,0,63
4,13,15,1,208,186,22
4,13,15,3,985,672,313
4,13,15,7,99,84,15
4,13,15,9,191,159,32
4,13,16,1,707,868,-161
4,13,16,5,87,98,-11
4,13,16,19,211,171,40
4,13,16,27,252,196,56
4,13,16,39,64,59,5
4,13,16,55,263,267,-4
4,13,16,65,316,111,205
4,13,16,83,99,111,-12
4,13,17,19,177,72,105
4,13,17,31,4978,2173,2805
4,13,17,37,113,0,113
4,13,17,43,1294,531,763
4,13,17,89,655,256,399
4,13,17,91,125,52,73
4,13,17,93,186,80,106
4,13,17,97,935,363,572
4,13,17,99,90,0,90
4,13,17,111,586,158,428
4,13,17,113,673,126,547
4,13,17,115,90,0,90
4,13,17,119,117,0,117
4,13,17,143,147,64,83
4,13,17,161,84,60,24
4,13,17,163,137,125,12
4,13,17,167,107,81,26
4,13,17,179,141,47,94
4,13,17,197,1057,259,798
4,13,17,201,359,172,187
4,13,18,3,181,163,18
4,13,18,35,56,0,56
4,13,18,39,72,0,72
4,13,18,57,266,204,62
4,13,18,63,138,67,71
4,13,18,81,0,79,-79
4,13,18,89,484,211,273
4,13,18,97,676,330,346
4,13,18,105,80,58,22
4,13,18,127,172,56,116
4,13,18,141,219,120,99
4,13,18,157,87,0,87
4,13,18,163,67,79,-12
4,13,19,13,105,62,43
4,13,19,49,153,79,74
4,13,19,61,79,0,79
4,13,19,103,155,71,84
4,13,19,113,264,167,97
4,13,19,153,473,321,152
4,13,19,155,71,0,71
4,13,19,163,173,68,105
4,13,19,169,83,0,83
4,13,19,193,62,0,62
4,13,20,45,87,50,37
4,13,20,61,89,82,7
4,13,20,91,595,389,206
4,13,20,103,69,66,3
4,13,20,161,74,0,74
4,13,20,173,403,245,158
4,13,20,177,82,73,9
4,13,20,209,87,0,87
4,13,21,15,63,0,63
4,13,21,47,61,88,-27
4,13,21,67,118,84,34
4,13,21,93,74,0,74
4,13,21,111,299,272,27
4,13,21,117,67,0,67
4,13,22,15,66,0,66
4,13,22,17,94,0,94
4,13,22,33,160,59,101
4,13,22,51,77,70,7
4,13,22,55,83,0,83
4,13,22,71,130,82,48
4,13,22,103,73,0,73
4,13,22,115,62,0,62
4,13,23,5,115,107,8
4,13,23,19,59,0,59
4,13,23,31,57,0,57
4,13,24,3,236,156,80
4,13,24,5,232,103,129
4,13,24,21,104,90,14
4,13,24,25,85,0,85
4,13,24,27,107,134,-27
4,13,24,31,369,299,70
4,13,24,33,200,153,47
4,13,24,510,134,104,30
4,13,25,1,79,60,19
4,13,25,5,110,58,52
4,13,25,9,219,128,91
4,13,25,13,107,85,22
4,13,25,17,510,369,141
4,13,25,21,224,169,55
4,13,25,23,135,84,51
4,13,25,25,308,166,142
4,13,25,27,313,146,167
4,13,26,21,84,60,24
4,13,26,25,68,0,68
4,13,26,45,62,0,62
4,13,26,49,305,131,174
4,13,26,55,0,59,-59
4,13,26,65,154,120,34
4,13,26,75,63,0,63
4,13,26,77,157,100,57
4,13,26,81,417,327,90
4,13,26,93,106,79,27
4,13,26,99,568,295,273
4,13,26,103,66,0,66
4,13,26,111,59,0,59
4,13,26,121,0,70,-70
4,13,26,125,902,565,337
4,13,26,139,132,113,19
4,13,26,145,93,0,93
4,13,26,147,71,60,11
4,13,26,161,260,165,95
4,13,26,163,918,690,228
4,13,27,3,265,218,47
4,13,27,5,59,0,59
4,13,27,13,62,0,62
4,13,27,19,106,76,30
4,13,27,35,80,0,80
4,13,27,37,504,342,162
4,13,27,53,1383,970,413
4,13,27,109,252,137,115
4,13,27,123,486,317,169
4,13,27,137,147,94,53
4,13,27,139,166,96,70
4,13,27,141,70,69,1
4,13,27,145,117,0,117
4,13,27,163,291,119,172
4,13,27,171,127,80,47
4,13,28,47,119,88,31
4,13,28,49,55,0,55
4,13,29,19,134,123,11
4,13,29,21,0,55,-55
4,13,29,37,0,71,-71
4,13,29,47,191,157,34
4,13,29,77,211,101,110
4,13,29,95,587,380,207
4,13,29,165,102,64,38
4,13,29,183,290,141,149
4,13,29,189,736,411,325
4,13,29,213,67,0,67
4,13,29,510,205,132,73
4,13,30,13,142,82,60
4,13,30,29,155,147,8
4,13,30,31,174,171,3
4,13,30,49,113,84,29
4,13,30,63,180,136,44
4,13,30,81,78,0,78
4,13,30,111,253,163,90
4,13,31,55,797,399,398
4,13,31,79,68,0,68
4,13,31,109,393,230,163
4,13,31,153,224,144,80
4,13,32,3,4102,3504,598
4,13,32,5,68,0,68
4,13,32,7,94,66,28
4,13,32,19,69,69,0
4,13,32,23,70,77,-7
4,13,32,31,837,636,201
4,13,32,510,80,0,80
4,13,33,11,183,166,17
4,13,33,13,64,0,64
4,13,33,15,126,88,38
4,13,33,17,55,0,55
4,13,34,3,274,173,101
4,13,34,5,129,97,32
4,13,34,7,59,68,-9
4,13,34,13,195,97,98
4,13,34,15,61,0,61
4,13,34,17,248,227,21
4,13,34,21,139,0,139
4,13,34,23,303,242,61
4,13,34,25,186,70,116
4,13,34,27,257,156,101
4,13,34,29,140,105,35
4,13,34,31,81,68,13
4,13,34,35,97,51,46
4,13,34,37,60,0,60
4,13,34,39,167,61,106
4,13,35,1,1759,980,779
4,13,35,5,145,68,77
4,13,35,9,109,79,30
4,13,35,13,538,442,96
4,13,35,15,0,72,-72
4,13,35,17,103,90,13
4,13,35,25,68,83,-15
4,13,35,29,77,129,-52
4,13,35,31,293,197,96
4,13,35,35,205,197,8
4,13,35,43,464,252,212
4,13,35,45,426,253,173
4,13,35,49,247,159,88
4,13,35,61,99,131,-32
4,13,36,1,156,80,76
4,13,36,5,176,112,64
4,13,36,27,101,0,101
4,13,36,29,397,246,151
4,13,36,45,139,75,64
4,13,36,47,474,354,120
4,13,36,55,305,192,113
4,13,36,59,359,139,220
4,13,36,61,640,457,183
4,13,36,63,78,0,78
4,13,36,65,53,0,53
4,13,36,67,196,121,75
4,13,36,71,71,59,12
4,13,36,81,550,257,293
4,13,36,85,114,0,114
4,13,36,91,159,90,69
4,13,36,103,440,187,253
4,13,36,111,52,52,0
4,13,36,119,231,109,122
4,13,37,19,0,63,-63
4,13,37,21,79,54,25
4,13,37,25,78,0,78
4,13,37,49,89,0,89
4,13,37,51,214,247,-33
4,13,37,63,131,119,12
4,13,37,67,80,102,-22
4,13,37,81,170,167,3
4,13,37,97,0,73,-73
4,13,37,119,530,660,-130
4,13,37,129,84,67,17
4,13,37,133,253,165,88
4,13,37,179,0,60,-60
4,13,37,183,395,536,-141
4,13,38,15,164,86,78
4,13,38,17,289,160,129
4,13,38,35,144,72,72
4,13,38,101,175,79,96
4,13,38,105,85,142,-57
4,13,39,17,112,93,19
4,13,39,25,74,72,2
4,13,39,35,740,404,336
4,13,39,41,128,108,20
4,13,39,45,77,0,77
4,13,39,49,900,547,353
4,13,39,57,86,58,28
4,13,39,61,300,219,81
4,13,39,85,119,67,52
4,13,39,89,0,83,-83
4,13,39,93,125,67,58
4,13,39,95,211,154,57
4,13,39,99,59,59,0
4,13,39,103,94,0,94
4,13,39,113,184,170,14
4,13,39,133,99,0,99
4,13,39,151,133,77,56
4,13,39,153,287,175,112
4,13,39,165,93,74,19
4,13,39,173,65,0,65
4,13,40,17,0,74,-74
4,13,40,27,138,117,21
4,13,40,31,79,56,23
4,13,40,47,61,0,61
4,13,40,109,461,436,25
4,13,40,119,71,0,71
4,13,40,143,433,303,130
4,13,41,3,122,76,46
4,13,41,5,684,393,291
4,13,41,7,0,67,-67
4,13,41,11,0,90,-90
4,13,41,17,393,330,63
4,13,41,19,115,97,18
4,13,41,29,297,166,131
4,13,41,33,109,98,11
4,13,41,35,85,0,85
4,13,41,39,440,393,47
4,13,41,41,88,79,9
4,13,41,43,111,105,6
4,13,41,47,328,223,105
4,13,41,51,882,881,1
4,13,41,53,65,112,-47
4,13,41,67,1413,981,432
4,13,41,71,66,83,-17
4,13,42,3,500,382,118
4,13,42,7,56,0,56
4,13,42,11,104,0,104
4,13,42,17,171,94,77
4,13,42,29,172,134,38
4,13,42,41,81,0,81
4,13,42,43,109,70,39
4,13,42,45,134,105,29
4,13,42,49,103,66,37
4,13,42,69,74,0,74
4,13,42,71,129,81,48
4,13,42,77,116,67,49
4,13,42,79,74,0,74
4,13,42,91,290,214,76
4,13,42,95,123,0,123
4,13,42,101,400,308,92
4,13,42,125,48,0,48
4,13,42,129,97,77,20
4,13,42,133,112,98,14
4,13,44,3,75,0,75
4,13,44,7,206,88,118
4,13,45,13,87,141,-54
4,13,45,15,70,93,-23
4,13,45,19,159,127,32
4,13,45,35,86,0,86
4,13,45,45,166,169,-3
4,13,45,51,143,121,22
4,13,45,63,72,122,-50
4,13,45,79,160,116,44
4,13,45,83,0,74,-74
4,13,45,91,108,153,-45
4,13,46,81,70,0,70
4,13,46,93,71,0,71
4,13,46,99,281,167,114
4,13,46,103,262,149,113
4,13,47,37,344,428,-84
4,13,47,65,81,147,-66
4,13,47,93,194,147,47
4,13,47,125,138,160,-22
4,13,47,149,117,132,-15
4,13,47,157,402,276,126
4,13,47,165,63,83,-20
4,13,47,187,106,239,-133
4,13,47,189,67,61,6
4,13,48,27,316,304,12
4,13,48,29,1266,1118,148
4,13,48,39,178,117,61
4,13,48,41,76,61,15
4,13,48,61,72,0,72
4,13,48,85,791,1051,-260
4,13,48,91,76,103,-27
4,13,48,113,1333,1334,-1
4,13,48,121,662,703,-41
4,13,48,135,86,117,-31
4,13,48,141,1441,930,511
4,13,48,157,266,354,-88
4,13,48,167,120,120,0
4,13,48,187,91,80,11
4,13,48,201,1571,1231,340
4,13,48,209,152,105,47
4,13,48,215,90,109,-19
4,13,48,221,59,0,59
4,13,48,245,70,0,70
4,13,48,251,0,66,-66
4,13,48,257,0,64,-64
4,13,48,303,126,187,-61
4,13,48,309,89,106,-17
4,13,48,329,116,137,-21
4,13,48,339,273,314,-41
4,13,48,355,123,92,31
4,13,48,367,0,100,-100
4,13,48,373,137,0,137
4,13,48,381,102,73,29
4,13,48,423,72,81,-9
4,13,48,439,1136,1231,-95
4,13,48,441,72,81,-9
4,13,48,451,81,68,13
4,13,48,453,1154,1070,84
4,13,48,485,135,72,63
4,13,48,491,411,548,-137
4,13,49,5,210,180,30
4,13,49,11,582,533,49
4,13,49,21,76,82,-6
4,13,49,35,1818,1605,213
4,13,49,43,76,0,76
4,13,49,45,99,0,99
4,13,49,49,1489,1090,399
4,13,49,53,402,350,52
4,13,49,57,371,268,103
4,13,50,7,99,78,21
4,13,51,13,173,175,-2
4,13,51,41,112,70,42
4,13,51,59,600,536,64
4,13,51,87,105,116,-11
4,13,51,107,214,202,12
4,13,51,153,198,115,83
4,13,51,177,59,0,59
4,13,51,179,0,94,-94
4,13,51,510,137,98,39
4,13,51,550,69,82,-13
4,13,51,650,74,0,74
4,13,51,700,122,58,64
4,13,51,710,131,101,30
4,13,51,760,49,58,-9
4,13,51,810,247,181,66
4,13,53,5,253,225,28
4,13,53,7,101,0,101
4,13,53,9,103,122,-19
4,13,53,11,790,513,277
4,13,53,15,147,96,51
4,13,53,25,102,0,102
4,13,53,27,79,56,23
4,13,53,29,148,135,13
4,13,53,33,3776,2652,1124
4,13,53,35,443,294,149
4,13,53,37,58,0,58
4,13,53,41,76,54,22
4,13,53,45,119,51,68
4,13,53,53,1868,1106,762
4,13,53,57,183,93,90
4,13,53,61,1654,846,808
4,13,53,63,713,645,68
4,13,53,67,542,332,210
4,13,53,71,63,0,63
4,13,53,73,314,226,88
4,13,53,75,59,0,59
4,13,53,77,162,164,-2
4,13,55,9,154,117,37
4,13,55,25,468,319,149
4,13,55,35,60,0,60
4,13,55,55,59,0,59
4,13,55,59,188,75,113
4,13,55,63,85,0,85
4,13,55,79,1227,472,755
4,13,55,87,100,85,15
4,13,55,89,83,62,21
4,13,55,101,181,111,70
4,13,55,105,84,78,6
4,13,55,109,97,0,97
4,13,55,117,63,0,63
4,13,55,127,103,55,48
4,13,55,131,93,61,32
4,13,55,133,417,256,161
4,13,55,139,77,77,0
4,13,56,1,64,0,64
4,13,56,5,93,0,93
4,13,56,21,241,109,132
4,13,56,25,123,68,55
4,13,56,37,75,0,75
4,15,4,3,65,0,65
4,15,4,5,250,339,-89
4,15,4,12,149,106,43
4,15,4,13,989,1272,-283
4,15,4,17,85,130,-45
4,15,4,19,157,249,-92
4,15,4,21,165,141,24
4,15,4,25,362,373,-11
4,15,4,27,112,108,4
4,15,6,19,60,0,60
4,15,6,29,229,83,146
4,15,6,37,1277,336,941
4,15,6,59,834,217,617
4,15,6,65,1272,419,853
4,15,6,67,88,0,88
4,15,6,71,1720,479,1241
4,15,6,73,571,211,360
4,15,6,77,66,0,66
4,15,6,79,64,0,64
4,15,6,83,56,0,56
4,15,6,99,82,0,82
4,15,6,111,210,0,210
4,15,8,1,64,73,-9
4,15,8,5,57,0,57
4,15,8,41,69,61,8
4,15,32,3,1699,1542,157
4,15,32,31,111,110,1
4,15,35,1,74,0,74
4,15,41,51,50,0,50
4,15,48,201,54,0,54
4,15,49,1,0,122,-122
4,15,49,21,0,369,-369
4,15,49,35,157,107,50
4,15,49,49,68,0,68
4,15,49,53,301,549,-248
4,15,53,11,65,0,65
4,15,53,33,110,53,57
4,15,53,53,128,57,71
4,15,53,61,95,0,95
4,17,4,1,1003,733,270
4,17,4,3,88,0,88
4,17,4,5,666,606,60
4,17,4,7,118,121,-3
4,17,4,9,0,112,-112
4,17,4,13,2869,2120,749
4,17,4,15,130,85,45
4,17,4,19,517,358,159
4,17,4,21,386,342,44
4,17,4,25,194,161,33
4,17,6,37,68,0,68
4,17,6,65,101,0,101
4,17,6,71,99,0,99
4,17,6,73,100,63,37
4,17,32,3,83,0,83
4,17,35,1,80,69,11
4,17,35,31,158,151,7
4,17,35,45,191,107,84
4,17,49,35,68,0,68
4,19,1,89,67,110,-43
4,19,2,20,202,117,85
4,19,2,90,75,0,75
4,19,4,1,116,132,-16
4,19,4,3,2163,1650,513
4,19,4,5,689,412,277
4,19,4,7,127,146,-19
4,19,4,9,228,217,11
4,19,4,11,89,69,20
4,19,4,13,6079,8078,-1999
4,19,4,15,249,157,92
4,19,4,17,358,517,-159
4,19,4,21,2074,2130,-56
4,19,4,23,1641,1180,461
4,19,4,25,574,527,47
4,19,4,27,556,338,218
4,19,5,7,55,0,55
4,19,5,119,69,75,-6
4,19,6,1,311,170,141
4,19,6,13,168,126,42
4,19,6,19,123,79,44
4,19,6,25,112,68,44
4,19,6,29,154,105,49
4,19,6,37,1557,931,626
4,19,6,53,117,77,40
4,19,6,59,637,361,276
4,19,6,61,99,85,14
4,19,6,65,670,337,333
4,19,6,67,223,186,37
4,19,6,71,430,280,150
4,19,6,73,1404,1083,321
4,19,6,75,130,141,-11
4,19,6,77,77,0,77
4,19,6,79,118,55,63
4,19,6,81,123,70,53
4,19,6,83,131,98,33
4,19,6,85,291,285,6
4,19,6,87,53,48,5
4,19,6,95,134,121,13
4,19,6,97,148,0,148
4,19,6,99,108,0,108
4,19,6,111,219,118,101
4,19,8,1,156,78,78
4,19,8,5,281,268,13
4,19,8,13,145,134,11
4,19,8,31,260,249,11
4,19,8,35,192,109,83
4,19,8,41,456,356,100
4,19,8,59,239,152,87
4,19,8,69,186,122,64
4,19,8,77,94,60,34
4,19,8,123,72,64,8
4,19,9,1,62,0,62
4,19,9,3,109,0,109
4,19,9,9,68,0,68
4,19,11,1,108,96,12
4,19,12,9,103,90,13
4,19,12,11,124,75,49
4,19,12,31,65,66,-1
4,19,12,33,75,0,75
4,19,12,57,70,144,-74
4,19,12,71,67,61,6
4,19,12,81,67,0,67
4,19,12,86,108,126,-18
4,19,12,91,149,177,-28
4,19,12,95,104,143,-39
4,19,12,99,130,70,60
4,19,12,101,50,0,50
4,19,12,103,93,88,5
4,19,12,105,0,68,-68
4,19,12,115,56,0,56
4,19,12,127,69,0,69
4,19,13,67,78,58,20
4,19,13,89,94,0,94
4,19,13,121,65,61,4
4,19,13,135,62,57,5
4,19,13,185,118,87,31
4,19,15,1,104,62,42
4,19,15,3,268,222,46
4,19,16,1,126,174,-48
4,19,16,55,61,0,61
4,19,17,19,56,0,56
4,19,17,31,506,408,98
4,19,17,43,160,0,160
4,19,17,89,98,55,43
4,19,17,97,143,76,67
4,19,17,143,158,0,158
4,19,17,163,71,0,71
4,19,17,197,125,0,125
4,19,17,201,76,0,76
4,19,18,3,54,0,54
4,19,18,89,83,0,83
4,19,18,97,94,77,17
4,19,19,113,74,0,74
4,19,19,153,61,0,61
4,19,20,91,72,93,-21
4,19,20,173,129,73,56
4,19,21,111,71,77,-6
4,19,24,3,55,87,-32
4,19,24,5,55,0,55
4,19,24,27,85,0,85
4,19,24,31,130,137,-7
4,19,24,510,64,0,64
4,19,25,17,175,114,61
4,19,25,25,69,77,-8
4,19,25,27,53,0,53
4,19,26,65,51,0,51
4,19,26,81,85,0,85
4,19,26,99,76,71,5
4,19,26,125,204,92,112
4,19,26,161,72,50,22
4,19,26,163,107,114,-7
4,19,27,37,56,58,-2
4,19,27,53,224,200,24
4,19,27,123,81,49,32
4,19,27,163,81,0,81
4,19,28,47,80,0,80
4,19,29,95,73,55,18
4,19,29,189,108,98,10
4,19,30,31,52,0,52
4,19,30,63,44,0,44
4,19,30,111,81,0,81
4,19,31,55,93,63,30
4,19,31,109,0,53,-53
4,19,31,153,103,0,103
4,19,32,3,734,746,-12
4,19,32,31,170,185,-15
4,19,33,11,54,67,-13
4,19,34,3,50,0,50
4,19,34,5,70,0,70
4,19,35,1,440,392,48
4,19,35,13,216,135,81
4,19,35,17,186,109,77
4,19,35,35,89,0,89
4,19,35,43,72,0,72
4,19,35,45,64,65,-1
4,19,35,49,131,106,25
4,19,36,29,71,48,23
4,19,36,47,109,83,26
4,19,36,55,63,60,3
4,19,36,59,68,0,68
4,19,36,61,136,109,27
4,19,36,81,80,0,80
4,19,36,103,67,0,67
4,19,36,119,58,0,58
4,19,37,51,53,73,-20
4,19,37,67,0,148,-148
4,19,37,119,91,72,19
4,19,37,183,86,71,15
4,19,39,35,95,72,23
4,19,39,49,138,133,5
4,19,39,61,71,0,71
4,19,39,113,73,120,-47
4,19,40,109,124,98,26
4,19,40,143,62,82,-20
4,19,41,5,129,57,72
4,19,41,17,140,63,77
4,19,41,29,86,60,26
4,19,41,39,126,94,32
4,19,41,47,82,84,-2
4,19,41,51,284,209,75
4,19,41,67,169,182,-13
4,19,42,3,109,75,34
4,19,42,91,63,0,63
4,19,42,101,61,84,-23
4,19,44,7,55,0,55
4,19,46,99,63,0,63
4,19,46,103,92,0,92
4,19,47,37,97,77,20
4,19,48,27,83,95,-12
4,19,48,29,329,379,-50
4,19,48,85,144,216,-72
4,19,48,113,237,243,-6
4,19,48,121,86,177,-91
4,19,48,141,361,247,114
4,19,48,157,67,0,67
4,19,48,201,376,232,144
4,19,48,215,73,0,73
4,19,48,373,66,0,66
4,19,48,439,222,376,-154
4,19,48,451,68,0,68
4,19,48,453,217,224,-7
4,19,48,485,128,65,63
4,19,48,491,66,116,-50
4,19,49,11,113,113,0
4,19,49,35,267,270,-3
4,19,49,49,189,130,59
4,19,49,57,63,100,-37
4,19,51,59,208,135,73
4,19,51,107,86,0,86
4,19,51,153,61,0,61
4,19,53,11,183,153,30
4,19,53,33,730,678,52
4,19,53,35,135,64,71
4,19,53,53,323,266,57
4,19,53,57,74,0,74
4,19,53,61,309,202,107
4,19,53,63,180,149,31
4,19,53,67,98,75,23
4,19,53,73,107,66,41
4,19,55,25,155,85,70
4,19,55,79,200,74,126
4,19,55,101,59,0,59
4,19,55,133,95,0,95
4,19,56,21,83,0,83
4,21,2,20,111,0,111
4,21,4,1,78,126,-48
4,21,4,3,218,219,-1
4,21,4,5,176,156,20
4,21,4,7,304,283,21
4,21,4,9,107,93,14
4,21,4,13,25257,19049,6208
4,21,4,15,141,165,-24
4,21,4,17,342,386,-44
4,21,4,19,2130,2074,56
4,21,4,25,329,387,-58
4,21,4,27,178,121,57
4,21,6,1,80,0,80
4,21,6,13,131,0,131
4,21,6,29,103,0,103
4,21,6,37,726,212,514
4,21,6,59,358,84,274
4,21,6,61,50,0,50
4,21,6,65,598,165,433
4,21,6,67,220,0,220
4,21,6,71,343,135,208
4,21,6,73,616,273,343
4,21,6,77,80,0,80
4,21,6,85,118,0,118
4,21,6,95,112,0,112
4,21,6,111,78,0,78
4,21,8,1,129,0,129
4,21,8,5,150,50,100
4,21,8,31,66,0,66
4,21,8,35,100,0,100
4,21,8,41,194,121,73
4,21,8,59,92,59,33
4,21,8,69,63,0,63
4,21,8,123,86,0,86
4,21,15,3,100,67,33
4,21,16,1,72,73,-1
4,21,17,31,227,95,132
4,21,17,43,74,0,74
4,21,17,89,94,0,94
4,21,17,97,86,0,86
4,21,17,111,67,0,67
4,21,17,113,57,0,57
4,21,17,197,97,0,97
4,21,19,153,76,0,76
4,21,20,91,65,0,65
4,21,26,125,94,62,32
4,21,26,163,88,0,88
4,21,27,37,70,0,70
4,21,27,53,146,64,82
4,21,27,123,52,0,52
4,21,32,3,319,297,22
4,21,32,31,103,0,103
4,21,35,1,132,84,48
4,21,35,43,71,0,71
4,21,35,45,111,0,111
4,21,36,103,49,0,49
4,21,38,17,63,0,63
4,21,41,5,93,0,93
4,21,41,17,93,0,93
4,21,41,51,67,0,67
4,21,41,67,123,71,52
4,21,48,29,93,97,-4
4,21,48,113,58,0,58
4,21,48,141,115,68,47
4,21,48,201,110,109,1
4,21,48,373,50,0,50
4,21,48,439,74,108,-34
4,21,48,491,0,52,-52
4,21,49,35,143,91,52
4,21,49,49,130,104,26
4,21,53,11,155,58,97
4,21,53,33,297,126,171
4,21,53,35,77,0,77
4,21,53,53,314,78,236
4,21,53,61,234,78,156
4,21,53,63,111,60,51
4,21,53,67,78,61,17
4,21,53,73,57,0,57
4,21,55,79,149,0,149
4,23,4,3,0,86,-86
4,23,4,13,460,392,68
4,23,4,19,1180,1641,-461
4,23,6,37,57,0,57
4,25,2,20,73,0,73
4,25,4,3,86,115,-29
4,25,4,5,1279,823,456
4,25,4,7,149,139,10
4,25,4,12,0,60,-60
4,25,4,13,5494,4721,773
4,25,4,15,373,362,11
4,25,4,17,161,194,-33
4,25,4,19,527,574,-47
4,25,4,21,387,329,58
4,25,4,27,117,108,9
4,25,6,1,88,0,88
4,25,6,13,106,0,106
4,25,6,19,59,0,59
4,25,6,29,93,0,93
4,25,6,37,1160,159,1001
4,25,6,53,64,0,64
4,25,6,59,804,155,649
4,25,6,61,62,0,62
4,25,6,65,650,184,466
4,25,6,67,75,0,75
4,25,6,71,460,127,333
4,25,6,73,760,247,513
4,25,6,79,151,0,151
4,25,6,83,98,0,98
4,25,6,85,136,0,136
4,25,6,97,86,0,86
4,25,6,111,261,79,182
4,25,8,31,0,52,-52
4,25,8,35,59,0,59
4,25,8,41,98,95,3
4,25,8,59,73,0,73
4,25,8,69,70,0,70
4,25,15,3,85,0,85
4,25,16,1,0,59,-59
4,25,17,31,117,48,69
4,25,32,3,379,286,93
4,25,32,31,48,71,-23
4,25,35,1,107,0,107
4,25,36,103,53,0,53
4,25,41,17,88,0,88
4,25,41,39,0,72,-72
4,25,41,51,50,50,0
4,25,41,67,55,0,55
4,25,48,201,78,0,78
4,25,49,35,71,92,-21
4,25,49,49,0,70,-70
4,25,49,53,59,0,59
4,25,53,33,162,90,72
4,25,53,53,108,65,43
4,25,53,61,89,0,89
4,27,4,3,0,67,-67
4,27,4,5,0,55,-55
4,27,4,13,1387,2384,-997
4,27,4,15,108,112,-4
4,27,4,19,338,556,-218
4,27,4,21,121,178,-57
4,27,4,25,108,117,-9
4,27,6,19,74,121,-47
4,27,6,25,903,446,457
4,27,6,29,74,88,-14
4,27,6,37,390,248,142
4,27,6,53,482,292,190
4,27,6,59,156,96,60
4,27,6,65,402,297,105
4,27,6,71,213,144,69
4,27,6,73,1053,743,310
4,27,6,85,0,52,-52
4,27,6,111,49,0,49
4,27,8,41,0,88,-88
4,27,15,3,82,0,82
4,27,32,3,180,176,4
4,27,32,31,55,0,55
4,27,37,49,178,0,178
4,27,37,133,164,95,69
4,27,41,5,55,0,55
4,27,45,13,130,0,130
4,27,48,29,0,86,-86
4,27,48,141,0,115,-115
4,27,53,11,50,0,50
4,27,53,33,90,54,36
4,27,53,53,114,68,46
4,27,53,61,72,0,72
4,27,53,63,54,0,54
5,1,5,69,98,116,-18
5,1,5,85,79,96,-17
5,1,5,95,80,0,80
5,1,5,117,83,0,83
5,1,5,119,106,122,-16
5,3,5,17,0,75,-75
5,3,5,43,88,116,-28
5,3,5,119,0,57,-57
5,3,22,67,65,0,65
5,5,5,7,0,97,-97
5,5,5,9,69,0,69
5,5,5,31,76,0,76
5,5,5,49,93,76,17
5,5,5,65,84,104,-20
5,5,5,89,506,398,108
5,5,5,119,63,58,5
5,5,5,143,58,92,-34
5,5,29,153,105,0,105
5,7,4,13,142,145,-3
5,7,4,19,0,55,-55
5,7,5,5,97,0,97
5,7,5,9,97,74,23
5,7,5,15,201,159,42
5,7,5,31,77,0,77
5,7,5,33,126,95,31
5,7,5,45,204,132,72
5,7,5,51,109,60,49
5,7,5,69,71,0,71
5,7,5,87,157,153,4
5,7,5,115,118,85,33
5,7,5,119,502,248,254
5,7,5,125,138,0,138
5,7,5,131,431,203,228
5,7,5,143,6911,5492,1419
5,7,5,145,76,0,76
5,7,6,1,53,68,-15
5,7,6,37,250,183,67
5,7,6,59,135,0,135
5,7,6,65,109,0,109
5,7,6,71,79,0,79
5,7,6,73,121,0,121
5,7,6,85,74,86,-12
5,7,8,5,58,0,58
5,7,8,31,0,53,-53
5,7,8,35,72,0,72
5,7,8,41,78,66,12
5,7,12,11,0,60,-60
5,7,12,57,67,86,-19
5,7,13,121,0,80,-80
5,7,17,31,186,173,13
5,7,20,91,140,135,5
5,7,20,173,114,0,114
5,7,27,53,80,94,-14
5,7,29,9,189,261,-72
5,7,29,77,175,144,31
5,7,29,95,122,98,24
5,7,29,97,227,124,103
5,7,29,119,331,522,-191
5,7,29,145,130,107,23
5,7,29,189,131,93,38
5,7,29,213,56,0,56
5,7,32,3,76,86,-10
5,7,37,119,0,73,-73
5,7,40,1,169,205,-36
5,7,40,41,454,426,28
5,7,40,109,181,111,70
5,7,40,135,0,61,-61
5,7,40,143,362,241,121
5,7,47,37,0,65,-65
5,7,47,157,115,0,115
5,7,48,29,0,126,-126
5,7,48,85,178,184,-6
5,7,48,113,238,208,30
5,7,48,121,140,165,-25
5,7,48,201,209,131,78
5,7,48,339,66,0,66
5,7,48,439,238,145,93
5,7,48,453,85,110,-25
5,7,53,33,124,193,-69
5,9,5,5,0,69,-69
5,9,5,7,74,97,-23
5,9,5,15,245,239,6
5,9,5,89,146,111,35
5,9,5,101,254,210,44
5,9,5,129,80,0,80
5,9,5,143,108,231,-123
5,9,29,77,0,65,-65
5,9,29,213,211,161,50
5,11,5,43,151,121,30
5,11,5,119,0,72,-72
5,13,5,103,96,0,96
5,15,5,7,159,201,-42
5,15,5,9,239,245,-6
5,15,5,87,0,109,-109
5,15,5,143,201,241,-40
5,15,29,9,0,77,-77
5,17,5,3,75,0,75
5,17,5,41,93,83,10
5,17,5,43,0,87,-87
5,17,5,119,0,90,-90
5,19,5,51,129,218,-89
5,19,5,59,165,218,-53
5,19,5,99,74,0,74
5,19,5,109,67,0,67
5,19,5,119,76,131,-55
5,19,5,125,56,71,-15
5,21,5,31,0,73,-73
5,21,5,55,260,390,-130
5,21,29,69,115,0,115
5,23,5,45,239,180,59
5,23,5,63,81,74,7
5,23,5,85,86,69,17
5,23,5,119,165,124,41
5,23,5,141,78,103,-25
5,23,5,145,307,260,47
5,25,5,69,130,145,-15
5,27,5,73,122,95,27
5,27,5,103,75,76,-1
5,27,5,119,0,87,-87
5,27,5,139,73,92,-19
5,27,22,119,0,71,-71
5,29,5,45,411,415,-4
5,29,5,105,152,115,37
5,29,5,115,193,176,17
5,29,5,119,98,88,10
5,29,5,141,0,71,-71
5,31,5,5,0,76,-76
5,31,5,7,0,77,-77
5,31,5,21,73,0,73
5,31,5,35,286,162,124
5,31,5,37,202,80,122
5,31,5,45,69,124,-55
5,31,5,55,837,920,-83
5,31,5,63,111,110,1
5,31,5,67,178,176,2
5,31,5,75,234,224,10
5,31,5,77,61,0,61
5,31,5,85,60,81,-21
5,31,5,93,750,338,412
5,31,5,107,101,0,101
5,31,5,111,724,587,137
5,31,5,119,204,329,-125
5,31,5,121,125,143,-18
5,31,5,123,236,93,143
5,31,5,125,76,97,-21
5,31,5,135,95,123,-28
5,31,5,143,59,123,-64
5,31,5,145,110,66,44
5,31,28,33,0,58,-58
5,31,29,69,80,0,80
5,31,29,155,113,0,113
5,31,47,157,243,264,-21
5,31,48,113,0,76,-76
5,31,48,201,71,0,71
5,31,48,439,0,57,-57
5,33,5,7,95,126,-31
5,33,5,47,183,178,5
5,33,5,83,0,74,-74
5,33,5,119,0,64,-64
5,33,5,131,2184,1965,219
5,33,5,143,267,254,13
5,33,40,79,112,180,-68
5,33,40,135,211,127,84
5,35,5,31,162,286,-124
5,35,5,37,91,98,-7
5,35,5,93,104,71,33
5,35,5,111,70,95,-25
5,35,5,119,85,124,-39
5,35,5,123,215,126,89
5,35,28,33,97,129,-32
5,35,47,157,838,1062,-224
5,37,5,31,80,202,-122
5,37,5,35,98,91,7
5,37,5,119,0,63,-63
5,37,5,123,229,184,45
5,39,5,103,68,83,-15
5,41,5,17,83,93,-10
5,41,5,43,127,117,10
5,41,5,69,74,65,9
5,41,5,79,0,92,-92
5,41,5,119,62,101,-39
5,43,5,3,116,88,28
5,43,5,11,121,151,-30
5,43,5,17,87,0,87
5,43,5,41,117,127,-10
5,43,5,119,0,154,-154
5,45,4,13,0,50,-50
5,45,5,7,132,204,-72
5,45,5,23,180,239,-59
5,45,5,29,415,411,4
5,45,5,31,124,69,55
5,45,5,51,101,146,-45
5,45,5,69,148,64,84
5,45,5,85,401,289,112
5,45,5,105,163,199,-36
5,45,5,115,265,183,82
5,45,5,119,2078,1912,166
5,45,5,125,273,353,-80
5,45,5,131,116,87,29
5,45,5,139,62,0,62
5,45,5,141,247,261,-14
5,45,5,143,190,198,-8
5,45,5,145,331,336,-5
5,45,47,157,66,58,8
5,45,48,85,0,72,-72
5,45,48,113,0,90,-90
5,45,48,201,67,0,67
5,45,48,439,0,88,-88
5,47,5,33,178,183,-5
5,47,5,71,137,130,7
5,47,5,83,165,162,3
5,47,5,131,289,254,35
5,49,5,5,76,93,-17
5,49,5,65,0,70,-70
5,49,5,135,170,136,34
5,49,29,149,81,0,81
5,51,4,13,51,0,51
5,51,5,7,60,109,-49
5,51,5,19,218,129,89
5,51,5,45,146,101,45
5,51,5,53,0,59,-59
5,51,5,59,645,600,45
5,51,5,69,104,60,44
5,51,5,85,0,63,-63
5,51,5,97,129,121,8
5,51,5,103,78,0,78
5,51,5,109,92,93,-1
5,51,5,115,61,0,61
5,51,5,119,588,598,-10
5,51,5,125,654,693,-39
5,51,5,131,0,93,-93
5,51,5,143,55,121,-66
5,51,47,157,73,0,73
5,51,48,37,67,0,67
5,51,48,85,61,0,61
5,51,48,113,54,0,54
5,51,48,121,60,0,60
5,51,48,201,71,0,71
5,51,48,439,95,78,17
5,53,5,51,59,0,59
5,53,5,59,74,100,-26
5,53,5,69,224,167,57
5,53,5,119,207,128,79
5,53,5,125,330,303,27
5,55,5,21,390,260,130
5,55,5,31,920,837,83
5,55,5,75,83,99,-16
5,55,5,93,97,66,31
5,55,5,111,66,0,66
5,55,5,121,104,91,13
5,55,29,69,196,79,117
5,55,47,157,94,126,-32
5,57,5,61,142,136,6
5,57,5,73,75,0,75
5,57,5,91,90,154,-64
5,57,5,99,188,212,-24
5,57,5,119,0,61,-61
5,57,48,37,77,134,-57
5,59,5,19,218,165,53
5,59,5,51,600,645,-45
5,59,5,53,100,74,26
5,59,5,119,113,108,5
5,59,5,125,331,309,22
5,61,5,57,136,142,-6
5,61,5,91,0,57,-57
5,61,5,109,129,76,53
5,61,5,133,94,77,17
5,61,48,37,0,82,-82
5,63,5,23,74,81,-7
5,63,5,31,110,111,-1
5,63,5,65,127,131,-4
5,63,5,67,135,105,30
5,63,5,119,97,86,11
5,63,5,135,271,248,23
5,63,5,137,109,0,109
5,63,5,145,191,183,8
5,65,5,5,104,84,20
5,65,5,49,70,0,70
5,65,5,63,131,127,4
5,65,5,135,139,102,37
5,67,5,31,176,178,-2
5,67,5,63,105,135,-30
5,67,5,145,282,137,145
5,69,5,1,116,98,18
5,69,5,7,0,71,-71
5,69,5,25,145,130,15
5,69,5,41,65,74,-9
5,69,5,45,64,148,-84
5,69,5,51,60,104,-44
5,69,5,53,167,224,-57
5,69,5,79,187,141,46
5,69,5,85,74,98,-24
5,69,5,119,620,1070,-450
5,69,5,125,134,210,-76
5,69,5,143,0,66,-66
5,69,47,157,0,73,-73
5,69,48,113,0,98,-98
5,69,48,201,0,71,-71
5,69,48,439,0,96,-96
5,71,5,47,130,137,-7
5,71,5,83,131,82,49
5,71,5,115,357,305,52
5,71,5,131,53,66,-13
5,71,5,143,61,86,-25
5,73,5,27,95,122,-27
5,73,5,57,0,75,-75
5,75,5,31,224,234,-10
5,75,5,55,99,83,16
5,75,5,121,180,217,-37
5,75,5,135,0,106,-106
5,77,5,31,0,61,-61
5,77,5,107,65,0,65
5,77,5,119,0,71,-71
5,77,5,123,99,111,-12
5,79,5,41,92,0,92
5,79,5,69,141,187,-46
5,81,5,91,172,189,-17
5,81,5,133,71,87,-16
5,81,48,37,159,155,4
5,83,5,33,74,0,74
5,83,5,47,162,165,-3
5,83,5,71,82,131,-49
5,83,5,115,68,108,-40
5,83,5,131,213,287,-74
5,85,5,1,96,79,17
5,85,5,23,69,86,-17
5,85,5,31,81,60,21
5,85,5,45,289,401,-112
5,85,5,51,63,0,63
5,85,5,69,98,74,24
5,85,5,117,153,103,50
5,85,5,119,2517,2045,472
5,85,5,125,251,235,16
5,85,5,143,61,65,-4
5,85,5,145,816,763,53
5,87,5,7,153,157,-4
5,87,5,15,109,0,109
5,87,5,143,593,622,-29
5,89,5,5,398,506,-108
5,89,5,9,111,146,-35
5,91,5,57,154,90,64
5,91,5,61,57,0,57
5,91,5,81,189,172,17
5,91,5,119,0,79,-79
5,91,48,37,1711,2016,-305
5,91,48,67,84,129,-45
5,91,48,113,0,109,-109
5,93,5,31,338,750,-412
5,93,5,35,71,104,-33
5,93,5,55,66,97,-31
5,93,5,111,90,90,0
5,93,5,119,0,97,-97
5,93,29,69,70,97,-27
5,93,29,155,165,101,64
5,93,47,157,89,124,-35
5,95,5,1,0,80,-80
5,95,5,119,0,126,-126
5,95,5,123,66,0,66
5,97,5,51,121,129,-8
5,97,5,109,118,83,35
5,99,5,19,0,74,-74
5,99,5,57,212,188,24
5,101,5,9,210,254,-44
5,103,5,13,0,96,-96
5,103,5,27,76,75,1
5,103,5,39,83,68,15
5,103,5,51,0,78,-78
5,103,5,119,68,76,-8
5,103,5,139,182,182,0
5,105,5,29,115,152,-37
5,105,5,45,199,163,36
5,105,5,119,101,88,13
5,107,5,31,0,101,-101
5,107,5,77,0,65,-65
5,107,5,119,75,129,-54
5,107,47,157,0,68,-68
5,109,5,19,0,67,-67
5,109,5,51,93,92,1
5,109,5,61,76,129,-53
5,109,5,97,83,118,-35
5,111,5,31,587,724,-137
5,111,5,35,95,70,25
5,111,5,55,0,66,-66
5,111,5,93,90,90,0
5,113,5,133,0,87,-87
5,115,5,7,85,118,-33
5,115,5,29,176,193,-17
5,115,5,45,183,265,-82
5,115,5,51,0,61,-61
5,115,5,71,305,357,-52
5,115,5,83,108,68,40
5,115,5,119,134,174,-40
5,115,5,131,75,78,-3
5,115,5,143,50,237,-187
5,115,5,149,683,591,92
5,117,5,1,0,83,-83
5,117,5,85,103,153,-50
5,117,5,119,74,60,14
5,117,5,145,77,97,-20
5,119,4,13,125,192,-67
5,119,4,19,75,69,6
5,119,5,1,122,106,16
5,119,5,3,57,0,57
5,119,5,5,58,63,-5
5,119,5,7,248,502,-254
5,119,5,11,72,0,72
5,119,5,17,90,0,90
5,119,5,19,131,76,55
5,119,5,23,124,165,-41
5,119,5,27,87,0,87
5,119,5,29,88,98,-10
5,119,5,31,329,204,125
5,119,5,33,64,0,64
5,119,5,35,124,85,39
5,119,5,37,63,0,63
5,119,5,41,101,62,39
5,119,5,43,154,0,154
5,119,5,45,1912,2078,-166
5,119,5,51,598,588,10
5,119,5,53,128,207,-79
5,119,5,57,61,0,61
5,119,5,59,108,113,-5
5,119,5,63,86,97,-11
5,119,5,69,1070,620,450
5,119,5,77,71,0,71
5,119,5,85,2045,2517,-472
5,119,5,91,79,0,79
5,119,5,93,97,0,97
5,119,5,95,126,0,126
5,119,5,103,76,68,8
5,119,5,105,88,101,-13
5,119,5,107,129,75,54
5,119,5,115,174,134,40
5,119,5,117,60,74,-14
5,119,5,123,90,62,28
5,119,5,125,3135,4402,-1267
5,119,5,131,187,229,-42
5,119,5,139,165,152,13
5,119,5,141,0,84,-84
5,119,5,143,388,649,-261
5,119,5,145,528,489,39
5,119,6,37,159,206,-47
5,119,6,59,0,65,-65
5,119,6,71,63,0,63
5,119,6,73,103,136,-33
5,119,8,31,0,89,-89
5,119,8,41,0,114,-114
5,119,11,1,0,71,-71
5,119,12,57,0,87,-87
5,119,12,86,62,0,62
5,119,12,91,0,90,-90
5,119,12,95,0,59,-59
5,119,12,113,0,71,-71
5,119,13,89,0,82,-82
5,119,13,121,61,89,-28
5,119,13,135,0,60,-60
5,119,17,31,169,158,11
5,119,20,173,64,0,64
5,119,22,17,56,0,56
5,119,22,71,0,53,-53
5,119,22,73,108,0,108
5,119,28,33,61,0,61
5,119,29,77,54,0,54
5,119,29,95,62,58,4
5,119,29,189,72,103,-31
5,119,32,3,89,109,-20
5,119,37,183,0,68,-68
5,119,40,109,99,105,-6
5,119,40,143,109,167,-58
5,119,47,37,90,149,-59
5,119,47,157,409,363,46
5,119,48,27,76,95,-19
5,119,48,29,93,201,-108
5,119,48,37,94,87,7
5,119,48,85,163,273,-110
5,119,48,113,435,590,-155
5,119,48,121,138,203,-65
5,119,48,201,220,273,-53
5,119,48,439,310,389,-79
5,119,48,453,108,133,-25
5,119,51,59,59,82,-23
5,119,53,33,67,74,-7
5,119,53,53,0,59,-59
5,121,5,31,143,125,18
5,121,5,55,91,104,-13
5,121,5,75,217,180,37
5,121,5,135,0,65,-65
5,121,5,143,116,0,116
5,123,5,31,93,236,-143
5,123,5,35,126,215,-89
5,123,5,37,184,229,-45
5,123,5,77,111,99,12
5,123,5,95,0,66,-66
5,123,5,119,62,90,-28
5,123,47,157,93,96,-3
5,125,5,7,0,138,-138
5,125,5,19,71,56,15
5,125,5,31,97,76,21
5,125,5,45,353,273,80
5,125,5,51,693,654,39
5,125,5,53,303,330,-27
5,125,5,59,309,331,-22
5,125,5,69,210,134,76
5,125,5,85,235,251,-16
5,125,5,119,4402,3135,1267
5,125,5,131,0,65,-65
5,125,5,143,84,124,-40
5,125,5,145,75,103,-28
5,125,48,85,0,68,-68
5,125,48,113,89,61,28
5,125,48,201,69,0,69
5,125,48,439,69,75,-6
5,127,5,131,200,268,-68
5,129,5,9,0,80,-80
5,131,5,7,203,431,-228
5,131,5,33,1965,2184,-219
5,131,5,45,87,116,-29
5,131,5,47,254,289,-35
5,131,5,51,93,0,93
5,131,5,71,66,53,13
5,131,5,83,287,213,74
5,131,5,115,78,75,3
5,131,5,119,229,187,42
5,131,5,125,65,0,65
5,131,5,127,268,200,68
5,131,5,143,390,520,-130
5,131,6,37,75,0,75
5,131,40,79,674,596,78
5,131,40,109,96,115,-19
5,131,40,135,540,548,-8
5,131,40,143,134,175,-41
5,131,48,113,0,67,-67
5,131,48,201,83,62,21
5,131,48,439,92,96,-4
5,133,5,61,77,94,-17
5,133,5,81,87,71,16
5,133,5,113,87,0,87
5,133,40,89,0,84,-84
5,135,5,31,123,95,28
5,135,5,49,136,170,-34
5,135,5,63,248,271,-23
5,135,5,65,102,139,-37
5,135,5,75,106,0,106
5,135,5,121,65,0,65
5,137,5,63,0,109,-109
5,139,5,27,92,73,19
5,139,5,45,0,62,-62
5,139,5,103,182,182,0
5,139,5,119,152,165,-13
5,139,5,143,0,54,-54
5,139,22,111,130,88,42
5,141,5,23,103,78,25
5,141,5,29,71,0,71
5,141,5,45,261,247,14
5,141,5,119,84,0,84
5,143,4,13,120,79,41
5,143,5,5,92,58,34
5,143,5,7,5492,6911,-1419
5,143,5,9,231,108,123
5,143,5,15,241,201,40
5,143,5,31,123,59,64
5,143,5,33,254,267,-13
5,143,5,45,198,190,8
5,143,5,51,121,55,66
5,143,5,69,66,0,66
5,143,5,71,86,61,25
5,143,5,85,65,61,4
5,143,5,87,622,593,29
5,143,5,115,237,50,187
5,143,5,119,649,388,261
5,143,5,121,0,116,-116
5,143,5,125,124,84,40
5,143,5,131,520,390,130
5,143,5,139,54,0,54
5,143,6,37,159,93,66
5,143,6,59,93,0,93
5,143,8,41,87,0,87
5,143,17,31,78,100,-22
5,143,20,91,49,72,-23
5,143,29,9,47,63,-16
5,143,29,77,169,85,84
5,143,29,95,75,66,9
5,143,29,97,123,82,41
5,143,29,119,69,89,-20
5,143,40,1,118,116,2
5,143,40,41,104,88,16
5,143,40,47,99,71,28
5,143,40,109,89,95,-6
5,143,40,143,207,205,2
5,143,47,37,58,55,3
5,143,47,157,87,70,17
5,143,48,29,66,0,66
5,143,48,85,110,90,20
5,143,48,113,204,190,14
5,143,48,121,66,92,-26
5,143,48,201,128,83,45
5,143,48,439,146,87,59
5,143,48,453,76,78,-2
5,143,53,33,76,90,-14
5,145,5,7,0,76,-76
5,145,5,23,260,307,-47
5,145,5,31,66,110,-44
5,145,5,45,336,331,5
5,145,5,63,183,191,-8
5,145,5,67,137,282,-145
5,145,5,85,763,816,-53
5,145,5,117,97,77,20
5,145,5,119,489,528,-39
5,145,5,125,103,75,28
5,145,5,147,113,93,20
5,147,5,145,93,113,-20
5,149,5,115,591,683,-92
6,1,1,73,55,0,55
6,1,2,20,73,52,21
6,1,4,13,829,1461,-632
6,1,4,19,170,311,-141
6,1,4,21,0,80,-80
6,1,4,25,0,88,-88
6,1,5,7,68,53,15
6,1,6,5,50,153,-103
6,1,6,7,323,354,-31
6,1,6,9,85,375,-290
6,1,6,13,15254,23789,-8535
6,1,6,17,218,847,-629
6,1,6,19,513,759,-246
6,1,6,23,136,190,-54
6,1,6,29,294,446,-152
6,1,6,31,68,0,68
6,1,6,33,48,118,-70
6,1,6,37,5414,4892,522
6,1,6,39,58,212,-154
6,1,6,41,863,1241,-378
6,1,6,45,116,186,-70
6,1,6,47,355,447,-92
6,1,6,53,429,480,-51
6,1,6,55,308,328,-20
6,1,6,57,160,463,-303
6,1,6,59,1729,1749,-20
6,1,6,61,399,1432,-1033
6,1,6,63,0,54,-54
6,1,6,65,644,894,-250
6,1,6,67,2542,4728,-2186
6,1,6,69,55,103,-48
6,1,6,71,430,592,-162
6,1,6,73,2066,2225,-159
6,1,6,75,14474,8853,5621
6,1,6,77,4415,10955,-6540
6,1,6,79,229,302,-73
6,1,6,81,9750,6222,3528
6,1,6,83,340,279,61
6,1,6,85,20617,12888,7729
6,1,6,87,614,669,-55
6,1,6,89,92,211,-119
6,1,6,93,0,61,-61
6,1,6,95,1866,3273,-1407
6,1,6,97,1022,1150,-128
6,1,6,99,1238,3099,-1861
6,1,6,101,90,95,-5
6,1,6,103,0,71,-71
6,1,6,107,160,304,-144
6,1,6,109,62,298,-236
6,1,6,111,413,369,44
6,1,6,113,600,584,16
6,1,6,115,0,108,-108
6,1,8,1,50,71,-21
6,1,8,5,136,182,-46
6,1,8,13,180,203,-23
6,1,8,31,215,362,-147
6,1,8,35,95,146,-51
6,1,8,41,104,173,-69
6,1,8,59,70,164,-94
6,1,8,69,66,112,-46
6,1,9,1,106,99,7
6,1,9,3,103,59,44
6,1,9,9,114,89,25
6,1,11,1,529,366,163
6,1,12,1,56,0,56
6,1,12,9,0,69,-69
6,1,12,11,196,188,8
6,1,12,31,132,75,57
6,1,12,57,178,150,28
6,1,12,86,264,204,60
6,1,12,95,103,143,-40
6,1,12,99,127,116,11
6,1,12,103,81,94,-13
6,1,12,117,0,72,-72
6,1,13,67,105,139,-34
6,1,13,89,118,150,-32
6,1,13,117,0,69,-69
6,1,13,121,316,297,19
6,1,13,135,84,120,-36
6,1,15,1,47,88,-41
6,1,15,3,485,347,138
6,1,15,9,85,127,-42
6,1,16,1,78,494,-416
6,1,16,27,0,99,-99
6,1,16,55,0,72,-72
6,1,17,19,131,0,131
6,1,17,31,1227,755,472
6,1,17,43,129,150,-21
6,1,17,97,151,94,57
6,1,17,197,58,0,58
6,1,18,97,103,60,43
6,1,18,157,72,0,72
6,1,20,91,79,78,1
6,1,21,111,61,72,-11
6,1,22,71,101,98,3
6,1,23,5,0,56,-56
6,1,24,3,82,0,82
6,1,24,5,70,0,70
6,1,24,27,0,64,-64
6,1,24,31,312,255,57
6,1,24,33,106,70,36
6,1,24,510,133,110,23
6,1,25,9,71,0,71
6,1,25,15,52,63,-11
6,1,25,17,752,595,157
6,1,25,21,140,100,40
6,1,25,25,268,214,54
6,1,25,27,96,83,13
6,1,26,81,63,0,63
6,1,26,125,192,135,57
6,1,26,161,178,133,45
6,1,26,163,157,119,38
6,1,27,37,0,65,-65
6,1,27,53,297,337,-40
6,1,27,123,89,90,-1
6,1,29,189,128,99,29
6,1,29,510,75,0,75
6,1,31,55,60,94,-34
6,1,32,3,626,1528,-902
6,1,32,5,0,125,-125
6,1,32,19,0,61,-61
6,1,32,31,295,892,-597
6,1,33,11,58,0,58
6,1,34,3,170,103,67
6,1,34,13,96,60,36
6,1,34,17,281,221,60
6,1,34,21,120,86,34
6,1,34,23,259,165,94
6,1,34,25,69,0,69
6,1,34,27,78,74,4
6,1,34,31,55,0,55
6,1,34,35,105,0,105
6,1,35,1,116,147,-31
6,1,35,49,0,102,-102
6,1,36,5,71,60,11
6,1,36,29,81,69,12
6,1,36,47,1000,709,291
6,1,36,55,107,92,15
6,1,36,59,97,75,22
6,1,36,61,744,842,-98
6,1,36,67,47,0,47
6,1,36,81,363,218,145
6,1,36,103,113,60,53
6,1,36,109,58,0,58
6,1,36,119,122,97,25
6,1,37,63,81,132,-51
6,1,37,81,0,64,-64
6,1,37,119,198,316,-118
6,1,37,135,0,77,-77
6,1,37,183,210,308,-98
6,1,39,35,126,103,23
6,1,39,49,216,174,42
6,1,39,61,124,84,40
6,1,40,109,53,0,53
6,1,40,143,78,74,4
6,1,41,3,0,65,-65
6,1,41,5,90,275,-185
6,1,41,17,62,211,-149
6,1,41,29,63,224,-161
6,1,41,33,0,61,-61
6,1,41,39,90,236,-146
6,1,41,47,0,76,-76
6,1,41,51,479,958,-479
6,1,41,67,209,454,-245
6,1,42,3,212,185,27
6,1,42,29,57,85,-28
6,1,42,91,116,108,8
6,1,42,101,227,215,12
6,1,44,7,78,52,26
6,1,47,37,97,141,-44
6,1,47,157,89,101,-12
6,1,48,29,173,242,-69
6,1,48,41,90,0,90
6,1,48,85,295,573,-278
6,1,48,113,428,574,-146
6,1,48,121,118,217,-99
6,1,48,141,100,91,9
6,1,48,157,103,189,-86
6,1,48,201,638,477,161
6,1,48,209,0,70,-70
6,1,48,339,0,87,-87
6,1,48,439,199,307,-108
6,1,48,453,474,863,-389
6,1,48,491,91,392,-301
6,1,49,35,252,371,-119
6,1,49,49,93,154,-61
6,1,49,53,0,62,-62
6,1,51,13,130,81,49
6,1,51,59,341,293,48
6,1,51,107,137,97,40
6,1,51,153,103,61,42
6,1,51,510,53,0,53
6,1,51,810,66,56,10
6,1,53,11,70,280,-210
6,1,53,33,1280,2077,-797
6,1,53,35,65,157,-92
6,1,53,53,186,340,-154
6,1,53,61,186,277,-91
6,1,53,63,0,134,-134
6,1,53,67,65,141,-76
6,1,53,73,0,82,-82
6,1,55,25,127,96,31
6,1,55,79,121,60,61
6,5,6,1,153,50,103
6,5,6,9,278,230,48
6,5,6,13,140,0,140
6,5,6,17,230,161,69
6,5,6,61,91,68,23
6,5,6,67,801,466,335
6,5,6,77,261,190,71
6,5,6,85,106,0,106
6,5,6,99,81,0,81
6,5,6,113,67,0,67
6,7,4,13,90,142,-52
6,7,6,1,354,323,31
6,7,6,11,78,108,-30
6,7,6,13,377,320,57
6,7,6,15,0,61,-61
6,7,6,17,112,220,-108
6,7,6,19,99,95,4
6,7,6,21,525,921,-396
6,7,6,23,140,167,-27
6,7,6,29,130,113,17
6,7,6,33,61,86,-25
6,7,6,35,0,107,-107
6,7,6,37,394,356,38
6,7,6,41,63,71,-8
6,7,6,45,115,148,-33
6,7,6,53,120,103,17
6,7,6,55,63,71,-8
6,7,6,57,178,270,-92
6,7,6,59,201,190,11
6,7,6,61,318,678,-360
6,7,6,63,116,222,-106
6,7,6,65,188,169,19
6,7,6,67,907,1311,-404
6,7,6,71,171,91,80
6,7,6,73,265,324,-59
6,7,6,75,75,138,-63
6,7,6,77,168,277,-109
6,7,6,79,119,124,-5
6,7,6,81,205,110,95
6,7,6,83,56,50,6
6,7,6,85,384,297,87
6,7,6,87,138,91,47
6,7,6,89,401,750,-349
6,7,6,93,80,64,16
6,7,6,95,204,202,2
6,7,6,97,251,240,11
6,7,6,99,105,125,-20
6,7,6,101,684,812,-128
6,7,6,103,524,984,-460
6,7,6,107,0,61,-61
6,7,6,111,138,95,43
6,7,6,113,164,212,-48
6,7,6,115,386,405,-19
6,7,16,1,0,114,-114
6,7,16,27,0,84,-84
6,7,32,3,62,112,-50
6,7,32,31,104,308,-204
6,7,41,5,0,57,-57
6,7,41,29,66,88,-22
6,7,41,33,0,70,-70
6,7,41,39,67,101,-34
6,7,41,51,0,89,-89
6,7,53,11,0,63,-63
6,7,53,33,64,110,-46
6,7,53,53,0,56,-56
6,9,6,1,375,85,290
6,9,6,5,230,278,-48
6,9,6,13,333,114,219
6,9,6,17,0,63,-63
6,9,6,37,46,0,46
6,9,6,61,0,71,-71
6,9,6,67,313,249,64
6,9,6,73,0,58,-58
6,9,6,77,912,471,441
6,9,6,81,97,0,97
6,9,6,85,201,84,117
6,9,6,87,52,0,52
6,9,6,95,84,0,84
6,9,6,97,54,0,54
6,9,6,99,330,159,171
6,9,6,109,183,286,-103
6,11,6,7,108,78,30
6,11,6,21,78,81,-3
6,11,6,67,121,152,-31
6,11,6,95,87,0,87
6,11,6,101,127,158,-31
6,11,6,113,197,149,48
6,13,2,20,0,77,-77
6,13,4,13,508,1318,-810
6,13,4,19,126,168,-42
6,13,4,21,0,131,-131
6,13,4,25,0,106,-106
6,13,6,1,23789,15254,8535
6,13,6,5,0,140,-140
6,13,6,7,320,377,-57
6,13,6,9,114,333,-219
6,13,6,17,205,666,-461
6,13,6,19,332,510,-178
6,13,6,23,113,110,3
6,13,6,29,243,274,-31
6,13,6,33,108,121,-13
6,13,6,37,2722,2286,436
6,13,6,39,0,115,-115
6,13,6,41,1268,1003,265
6,13,6,45,63,150,-87
6,13,6,47,171,215,-44
6,13,6,53,307,328,-21
6,13,6,55,477,591,-114
6,13,6,57,100,446,-346
6,13,6,59,1070,1148,-78
6,13,6,61,371,1355,-984
6,13,6,65,493,669,-176
6,13,6,67,1911,3784,-1873
6,13,6,71,345,355,-10
6,13,6,73,1321,1392,-71
6,13,6,75,7514,4170,3344
6,13,6,77,2023,3295,-1272
6,13,6,79,144,240,-96
6,13,6,81,5052,2392,2660
6,13,6,83,171,218,-47
6,13,6,85,4808,2784,2024
6,13,6,87,300,286,14
6,13,6,89,160,275,-115
6,13,6,93,0,55,-55
6,13,6,95,3878,6636,-2758
6,13,6,97,843,1014,-171
6,13,6,99,495,959,-464
6,13,6,101,75,83,-8
6,13,6,103,0,110,-110
6,13,6,107,91,173,-82
6,13,6,109,92,168,-76
6,13,6,111,248,241,7
6,13,6,113,417,505,-88
6,13,6,115,0,98,-98
6,13,8,5,84,130,-46
6,13,8,13,67,167,-100
6,13,8,31,107,231,-124
6,13,8,35,0,156,-156
6,13,8,41,92,192,-100
6,13,8,59,0,91,-91
6,13,9,1,111,72,39
6,13,9,3,87,0,87
6,13,11,1,122,100,22
6,13,12,11,150,107,43
6,13,12,31,0,63,-63
6,13,12,57,0,102,-102
6,13,12,86,131,123,8
6,13,12,95,85,70,15
6,13,12,99,85,90,-5
6,13,12,103,0,72,-72
6,13,13,67,70,88,-18
6,13,13,89,0,92,-92
6,13,13,121,123,178,-55
6,13,13,135,71,66,5
6,13,15,1,0,88,-88
6,13,15,3,295,254,41
6,13,15,9,53,110,-57
6,13,16,1,57,401,-344
6,13,16,27,0,124,-124
6,13,16,55,0,86,-86
6,13,17,31,509,329,180
6,13,17,43,67,70,-3
6,13,17,97,97,67,30
6,13,22,103,0,89,-89
6,13,24,5,51,0,51
6,13,24,31,93,73,20
6,13,25,17,187,206,-19
6,13,25,21,62,0,62
6,13,25,25,122,70,52
6,13,26,125,82,84,-2
6,13,26,161,0,52,-52
6,13,26,163,67,63,4
6,13,27,53,155,115,40
6,13,29,189,85,56,29
6,13,31,55,0,67,-67
6,13,32,3,437,1223,-786
6,13,32,5,0,120,-120
6,13,32,19,0,120,-120
6,13,32,31,213,932,-719
6,13,32,510,0,55,-55
6,13,34,3,92,0,92
6,13,34,17,111,0,111
6,13,34,23,67,72,-5
6,13,35,1,68,102,-34
6,13,36,47,236,102,134
6,13,36,61,327,302,25
6,13,36,81,136,50,86
6,13,36,103,53,0,53
6,13,36,119,86,0,86
6,13,37,119,90,175,-85
6,13,37,183,88,189,-101
6,13,39,35,70,0,70
6,13,39,49,85,87,-2
6,13,41,5,78,174,-96
6,13,41,17,0,207,-207
6,13,41,29,54,162,-108
6,13,41,39,99,167,-68
6,13,41,47,0,68,-68
6,13,41,51,163,312,-149
6,13,41,67,154,251,-97
6,13,42,3,84,116,-32
6,13,42,101,96,56,40
6,13,47,37,63,56,7
6,13,47,157,85,0,85
6,13,47,187,0,69,-69
6,13,48,29,89,189,-100
6,13,48,85,116,243,-127
6,13,48,113,223,211,12
6,13,48,121,78,138,-60
6,13,48,141,47,74,-27
6,13,48,157,180,322,-142
6,13,48,201,808,921,-113
6,13,48,339,128,187,-59
6,13,48,439,144,276,-132
6,13,48,453,180,466,-286
6,13,48,491,0,198,-198
6,13,49,35,104,294,-190
6,13,49,49,107,176,-69
6,13,51,13,58,47,11
6,13,51,59,160,157,3
6,13,51,107,0,99,-99
6,13,51,810,0,55,-55
6,13,53,11,0,220,-220
6,13,53,33,550,881,-331
6,13,53,35,0,89,-89
6,13,53,53,108,243,-135
6,13,53,61,75,177,-102
6,13,53,63,0,127,-127
6,13,53,67,0,104,-104
6,13,53,73,0,85,-85
6,13,55,25,73,0,73
6,15,6,7,61,0,61
6,15,6,23,102,100,2
6,15,6,67,93,59,34
6,15,41,15,78,125,-47
6,15,41,29,0,84,-84
6,17,4,13,129,190,-61
6,17,6,1,847,218,629
6,17,6,5,161,230,-69
6,17,6,7,220,112,108
6,17,6,9,63,0,63
6,17,6,13,666,205,461
6,17,6,19,95,0,95
6,17,6,23,73,58,15
6,17,6,29,0,55,-55
6,17,6,37,462,260,202
6,17,6,41,104,0,104
6,17,6,53,86,64,22
6,17,6,57,177,165,12
6,17,6,59,272,174,98
6,17,6,61,1082,1016,66
6,17,6,65,187,144,43
6,17,6,67,5407,3900,1507
6,17,6,71,122,100,22
6,17,6,73,303,318,-15
6,17,6,75,248,100,148
6,17,6,77,259,160,99
6,17,6,79,133,81,52
6,17,6,81,480,116,364
6,17,6,83,68,47,21
6,17,6,85,1251,189,1062
6,17,6,87,237,58,179
6,17,6,89,65,80,-15
6,17,6,95,303,120,183
6,17,6,97,326,113,213
6,17,6,99,117,52,65
6,17,6,111,104,0,104
6,17,6,113,186,159,27
6,17,6,115,0,77,-77
6,17,16,1,0,119,-119
6,17,16,55,0,63,-63
6,17,32,3,115,152,-37
6,17,32,5,366,541,-175
6,17,32,19,0,103,-103
6,17,32,31,205,381,-176
6,17,32,510,66,246,-180
6,17,53,33,119,119,0
6,19,4,13,387,510,-123
6,19,4,15,0,60,-60
6,19,4,19,79,123,-44
6,19,4,25,0,59,-59
6,19,4,27,121,74,47
6,19,6,1,759,513,246
6,19,6,7,95,99,-4
6,19,6,13,510,332,178
6,19,6,17,0,95,-95
6,19,6,23,73,61,12
6,19,6,25,86,89,-3
6,19,6,29,913,906,7
6,19,6,31,1673,1857,-184
6,19,6,35,0,65,-65
6,19,6,37,2401,1756,645
6,19,6,39,3438,3773,-335
6,19,6,41,72,0,72
6,19,6,43,0,81,-81
6,19,6,47,1145,646,499
6,19,6,53,743,551,192
6,19,6,55,0,53,-53
6,19,6,57,0,56,-56
6,19,6,59,718,604,114
6,19,6,61,181,248,-67
6,19,6,65,636,513,123
6,19,6,67,958,1097,-139
6,19,6,71,581,449,132
6,19,6,73,1008,981,27
6,19,6,75,262,220,42
6,19,6,77,633,538,95
6,19,6,79,432,733,-301
6,19,6,81,264,212,52
6,19,6,83,285,243,42
6,19,6,85,1352,748,604
6,19,6,87,233,147,86
6,19,6,89,71,66,5
6,19,6,95,220,173,47
6,19,6,97,190,178,12
6,19,6,99,679,601,78
6,19,6,101,79,0,79
6,19,6,107,3328,3190,138
6,19,6,111,383,287,96
6,19,6,113,104,152,-48
6,19,8,41,71,132,-61
6,19,8,69,0,62,-62
6,19,12,57,63,0,63
6,19,15,3,129,135,-6
6,19,16,1,0,188,-188
6,19,16,27,0,69,-69
6,19,16,55,0,117,-117
6,19,17,31,139,100,39
6,19,27,53,76,110,-34
6,19,27,123,0,98,-98
6,19,32,3,412,745,-333
6,19,32,31,167,202,-35
6,19,36,81,62,55,7
6,19,40,143,0,111,-111
6,19,41,5,0,57,-57
6,19,41,29,55,0,55
6,19,41,39,0,77,-77
6,19,41,47,0,60,-60
6,19,41,51,72,134,-62
6,19,41,67,0,90,-90
6,19,48,29,96,128,-32
6,19,48,113,109,160,-51
6,19,48,121,0,71,-71
6,19,48,141,92,75,17
6,19,48,201,146,91,55
6,19,48,439,95,169,-74
6,19,48,453,82,113,-31
6,19,49,35,111,102,9
6,19,49,49,0,61,-61
6,19,53,11,0,94,-94
6,19,53,33,138,248,-110
6,19,53,35,0,63,-63
6,19,53,53,146,162,-16
6,19,53,61,0,80,-80
6,19,53,63,0,67,-67
6,19,53,67,0,64,-64
6,19,53,77,0,68,-68
6,21,6,7,921,525,396
6,21,6,11,81,78,3
6,21,6,103,215,356,-141
6,23,4,13,0,62,-62
6,23,6,1,190,136,54
6,23,6,7,167,140,27
6,23,6,13,110,113,-3
6,23,6,15,100,102,-2
6,23,6,17,58,73,-15
6,23,6,19,61,73,-12
6,23,6,29,81,53,28
6,23,6,33,86,0,86
6,23,6,37,332,293,39
6,23,6,41,59,0,59
6,23,6,45,99,147,-48
6,23,6,53,0,48,-48
6,23,6,59,152,133,19
6,23,6,61,76,112,-36
6,23,6,65,144,133,11
6,23,6,67,237,278,-41
6,23,6,71,91,107,-16
6,23,6,73,272,230,42
6,23,6,75,48,72,-24
6,23,6,77,61,0,61
6,23,6,79,51,76,-25
6,23,6,81,62,60,2
6,23,6,83,58,0,58
6,23,6,85,151,82,69
6,23,6,87,85,59,26
6,23,6,89,257,342,-85
6,23,6,93,0,86,-86
6,23,6,95,65,62,3
6,23,6,97,196,193,3
6,23,6,99,96,72,24
6,23,6,103,58,0,58
6,23,6,105,78,91,-13
6,23,6,111,68,0,68
6,23,6,113,55,0,55
6,23,16,1,0,83,-83
6,23,32,3,0,95,-95
6,23,32,31,0,63,-63
6,23,41,17,0,70,-70
6,23,41,29,0,149,-149
6,23,41,33,0,54,-54
6,23,41,39,0,84,-84
6,23,41,51,59,133,-74
6,23,53,33,62,56,6
6,25,4,13,319,503,-184
6,25,4,19,68,112,-44
6,25,4,27,446,903,-457
6,25,6,19,89,86,3
6,25,6,29,110,141,-31
6,25,6,37,530,391,139
6,25,6,53,128,138,-10
6,25,6,59,151,197,-46
6,25,6,65,1468,1297,171
6,25,6,67,70,0,70
6,25,6,71,361,320,41
6,25,6,73,1410,1708,-298
6,25,6,83,0,78,-78
6,25,6,111,81,0,81
6,25,32,3,141,186,-45
6,27,6,29,70,82,-12
6,27,6,37,197,73,124
6,27,6,51,198,143,55
6,27,6,59,74,0,74
6,27,6,65,75,0,75
6,27,6,71,58,0,58
6,27,6,73,52,63,-11
6,27,32,31,0,72,-72
6,29,2,20,61,0,61
6,29,4,5,0,56,-56
6,29,4,13,430,738,-308
6,29,4,15,83,229,-146
6,29,4,19,105,154,-49
6,29,4,21,0,103,-103
6,29,4,25,0,93,-93
6,29,4,27,88,74,14
6,29,6,1,446,294,152
6,29,6,7,113,130,-17
6,29,6,13,274,243,31
6,29,6,17,55,0,55
6,29,6,19,906,913,-7
6,29,6,23,53,81,-28
6,29,6,25,141,110,31
6,29,6,27,82,70,12
6,29,6,31,331,306,25
6,29,6,37,11435,5445,5990
6,29,6,39,106,108,-2
6,29,6,47,97,112,-15
6,29,6,53,537,247,290
6,29,6,59,1253,894,359
6,29,6,61,60,182,-122
6,29,6,65,1007,911,96
6,29,6,67,449,539,-90
6,29,6,71,1352,1065,287
6,29,6,73,1271,1124,147
6,29,6,75,87,107,-20
6,29,6,77,254,277,-23
6,29,6,79,542,868,-326
6,29,6,81,106,129,-23
6,29,6,83,541,486,55
6,29,6,85,337,300,37
6,29,6,87,115,87,28
6,29,6,89,0,70,-70
6,29,6,95,130,130,0
6,29,6,97,157,121,36
6,29,6,99,235,219,16
6,29,6,107,1950,1778,172
6,29,6,111,1555,912,643
6,29,6,113,74,101,-27
6,29,8,5,0,64,-64
6,29,8,31,0,60,-60
6,29,8,41,106,151,-45
6,29,8,59,0,59,-59
6,29,12,86,76,0,76
6,29,12,91,0,140,-140
6,29,12,95,0,66,-66
6,29,15,3,143,117,26
6,29,16,1,0,154,-154
6,29,16,27,0,70,-70
6,29,16,55,0,101,-101
6,29,17,31,104,64,40
6,29,32,3,674,1102,-428
6,29,32,23,0,72,-72
6,29,32,31,110,226,-116
6,29,35,1,72,0,72
6,29,36,81,70,0,70
6,29,38,105,0,94,-94
6,29,40,109,73,87,-14
6,29,41,17,0,66,-66
6,29,41,39,0,116,-116
6,29,41,47,0,74,-74
6,29,41,51,51,102,-51
6,29,41,67,0,97,-97
6,29,48,27,54,0,54
6,29,48,29,148,205,-57
6,29,48,85,0,83,-83
6,29,48,113,0,130,-130
6,29,48,135,0,78,-78
6,29,48,141,0,100,-100
6,29,48,201,168,370,-202
6,29,48,329,0,270,-270
6,29,48,339,0,78,-78
6,29,48,439,119,216,-97
6,29,48,453,212,102,110
6,29,48,491,0,74,-74
6,29,49,11,0,92,-92
6,29,49,35,84,151,-67
6,29,49,49,0,93,-93
6,29,49,53,0,75,-75
6,29,51,810,69,61,8
6,29,53,11,0,89,-89
6,29,53,29,0,74,-74
6,29,53,33,180,204,-24
6,29,53,35,0,128,-128
6,29,53,53,109,161,-52
6,29,53,61,66,116,-50
6,29,53,63,0,79,-79
6,31,4,13,65,80,-15
6,31,6,1,0,68,-68
6,31,6,19,1857,1673,184
6,31,6,29,306,331,-25
6,31,6,37,369,274,95
6,31,6,39,0,72,-72
6,31,6,53,123,71,52
6,31,6,59,112,82,30
6,31,6,65,177,102,75
6,31,6,67,132,120,12
6,31,6,71,136,109,27
6,31,6,73,582,536,46
6,31,6,77,0,74,-74
6,31,6,79,111,203,-92
6,31,6,85,80,62,18
6,31,6,99,83,67,16
6,31,6,107,1158,1330,-172
6,31,6,111,87,83,4
6,31,12,33,112,74,38
6,31,12,91,76,0,76
6,31,15,3,77,0,77
6,31,32,1,0,79,-79
6,31,32,3,79,80,-1
6,31,51,710,106,0,106
6,31,51,810,270,182,88
6,31,53,29,246,297,-51
6,31,53,35,73,0,73
6,33,6,1,118,48,70
6,33,6,7,86,61,25
6,33,6,13,121,108,13
6,33,6,23,0,86,-86
6,33,6,37,94,0,94
6,33,6,41,79,0,79
6,33,6,45,488,249,239
6,33,6,55,244,150,94
6,33,6,61,0,59,-59
6,33,6,67,188,183,5
6,33,6,73,60,0,60
6,33,6,75,65,0,65
6,33,6,81,67,0,67
6,33,6,85,90,69,21
6,33,6,89,0,81,-81
6,33,6,95,98,82,16
6,33,6,97,1258,459,799
6,35,6,7,107,0,107
6,35,6,19,65,0,65
6,35,6,63,69,70,-1
6,35,6,67,89,76,13
6,35,6,73,73,0,73
6,35,6,89,90,94,-4
6,35,32,31,217,255,-38
6,37,1,3,0,71,-71
6,37,1,73,161,176,-15
6,37,1,89,113,160,-47
6,37,1,97,70,74,-4
6,37,1,101,79,55,24
6,37,2,20,249,204,45
6,37,2,90,115,102,13
6,37,4,3,93,148,-55
6,37,4,5,154,252,-98
6,37,4,7,0,61,-61
6,37,4,13,5000,9943,-4943
6,37,4,15,336,1277,-941
6,37,4,17,0,68,-68
6,37,4,19,931,1557,-626
6,37,4,21,212,726,-514
6,37,4,23,0,57,-57
6,37,4,25,159,1160,-1001
6,37,4,27,248,390,-142
6,37,5,7,183,250,-67
6,37,5,119,206,159,47
6,37,5,131,0,75,-75
6,37,5,143,93,159,-66
6,37,6,1,4892,5414,-522
6,37,6,7,356,394,-38
6,37,6,9,0,46,-46
6,37,6,13,2286,2722,-436
6,37,6,17,260,462,-202
6,37,6,19,1756,2401,-645
6,37,6,23,293,332,-39
6,37,6,25,391,530,-139
6,37,6,27,73,197,-124
6,37,6,29,5445,11435,-5990
6,37,6,31,274,369,-95
6,37,6,33,0,94,-94
6,37,6,39,170,364,-194
6,37,6,41,714,774,-60
6,37,6,43,0,58,-58
6,37,6,45,110,144,-34
6,37,6,47,355,551,-196
6,37,6,51,98,126,-28
6,37,6,53,898,929,-31
6,37,6,55,238,284,-46
6,37,6,57,117,314,-197
6,37,6,59,44070,57868,-13798
6,37,6,61,636,907,-271
6,37,6,65,16847,35011,-18164
6,37,6,67,2660,3423,-763
6,37,6,69,0,82,-82
6,37,6,71,31563,60817,-29254
6,37,6,73,12506,15817,-3311
6,37,6,75,5537,4650,887
6,37,6,77,816,1137,-321
6,37,6,79,998,1661,-663
6,37,6,81,2350,2762,-412
6,37,6,83,2465,2673,-208
6,37,6,85,4903,6184,-1281
6,37,6,87,626,606,20
6,37,6,89,200,348,-148
6,37,6,93,0,102,-102
6,37,6,95,675,822,-147
6,37,6,97,840,969,-129
6,37,6,99,597,775,-178
6,37,6,101,72,107,-35
6,37,6,103,0,88,-88
6,37,6,107,862,1553,-691
6,37,6,109,65,103,-38
6,37,6,111,11519,18161,-6642
6,37,6,113,446,511,-65
6,37,6,115,73,105,-32
6,37,8,1,267,488,-221
6,37,8,5,673,941,-268
6,37,8,13,404,535,-131
6,37,8,14,53,131,-78
6,37,8,31,1117,1446,-329
6,37,8,35,254,531,-277
6,37,8,37,62,98,-36
6,37,8,41,751,1092,-341
6,37,8,45,0,92,-92
6,37,8,59,387,610,-223
6,37,8,67,0,53,-53
6,37,8,69,208,340,-132
6,37,8,77,0,107,-107
6,37,8,85,0,65,-65
6,37,8,97,80,0,80
6,37,8,101,0,60,-60
6,37,8,123,121,178,-57
6,37,9,1,693,523,170
6,37,9,3,421,326,95
6,37,9,5,65,0,65
6,37,9,7,79,0,79
6,37,9,9,459,306,153
6,37,9,11,101,89,12
6,37,9,13,42,0,42
6,37,10,3,229,158,71
6,37,11,1,1384,962,422
6,37,12,1,131,117,14
6,37,12,9,238,391,-153
6,37,12,11,1234,989,245
6,37,12,17,0,50,-50
6,37,12,19,64,64,0
6,37,12,21,154,150,4
6,37,12,31,316,355,-39
6,37,12,33,116,170,-54
6,37,12,35,0,68,-68
6,37,12,57,544,679,-135
6,37,12,61,0,59,-59
6,37,12,69,50,84,-34
6,37,12,71,187,246,-59
6,37,12,73,155,77,78
6,37,12,81,121,116,5
6,37,12,83,71,80,-9
6,37,12,86,1751,1455,296
6,37,12,91,98,165,-67
6,37,12,95,1206,870,336
6,37,12,97,141,174,-33
6,37,12,99,659,760,-101
6,37,12,101,99,167,-68
6,37,12,103,460,547,-87
6,37,12,105,98,154,-56
6,37,12,109,99,145,-46
6,37,12,111,64,104,-40
6,37,12,113,0,77,-77
6,37,12,115,146,197,-51
6,37,12,117,195,265,-70
6,37,12,119,0,45,-45
6,37,12,127,153,191,-38
6,37,13,51,187,200,-13
6,37,13,57,0,102,-102
6,37,13,59,50,66,-16
6,37,13,63,92,155,-63
6,37,13,67,510,633,-123
6,37,13,77,0,60,-60
6,37,13,89,667,703,-36
6,37,13,97,0,104,-104
6,37,13,113,84,241,-157
6,37,13,117,67,162,-95
6,37,13,121,1157,1356,-199
6,37,13,135,400,765,-365
6,37,13,139,0,59,-59
6,37,13,151,67,134,-67
6,37,13,179,0,62,-62
6,37,13,215,59,72,-13
6,37,13,223,0,73,-73
6,37,13,245,0,56,-56
6,37,15,1,235,283,-48
6,37,15,3,1879,1854,25
6,37,15,7,92,132,-40
6,37,15,9,239,381,-142
6,37,16,1,235,1203,-968
6,37,16,13,0,83,-83
6,37,16,19,0,88,-88
6,37,16,27,64,356,-292
6,37,16,55,109,329,-220
6,37,16,65,0,60,-60
6,37,16,83,0,65,-65
6,37,17,19,184,117,67
6,37,17,31,5435,3357,2078
6,37,17,43,632,439,193
6,37,17,89,228,173,55
6,37,17,97,489,376,113
6,37,17,111,88,81,7
6,37,17,113,55,54,1
6,37,17,143,56,58,-2
6,37,17,163,90,96,-6
6,37,17,167,43,0,43
6,37,17,197,210,183,27
6,37,17,201,69,0,69
6,37,18,3,85,135,-50
6,37,18,39,0,77,-77
6,37,18,57,126,220,-94
6,37,18,63,0,60,-60
6,37,18,89,121,146,-25
6,37,18,97,494,470,24
6,37,18,105,61,54,7
6,37,18,127,56,0,56
6,37,18,141,93,122,-29
6,37,18,157,101,72,29
6,37,18,163,0,56,-56
6,37,19,103,121,100,21
6,37,19,113,45,0,45
6,37,19,153,115,196,-81
6,37,20,45,64,90,-26
6,37,20,61,75,69,6
6,37,20,91,309,409,-100
6,37,20,161,54,82,-28
6,37,20,173,178,271,-93
6,37,20,209,58,82,-24
6,37,21,47,71,62,9
6,37,21,67,141,116,25
6,37,21,111,274,252,22
6,37,22,15,0,65,-65
6,37,22,17,89,85,4
6,37,22,33,170,120,50
6,37,22,51,137,190,-53
6,37,22,55,81,64,17
6,37,22,71,427,313,114
6,37,22,103,61,104,-43
6,37,22,115,63,0,63
6,37,23,5,108,176,-68
6,37,23,31,54,81,-27
6,37,24,3,277,246,31
6,37,24,5,295,235,60
6,37,24,17,0,59,-59
6,37,24,21,94,66,28
6,37,24,25,76,0,76
6,37,24,27,201,199,2
6,37,24,31,1040,727,313
6,37,24,33,477,374,103
6,37,24,37,64,0,64
6,37,24,510,384,302,82
6,37,25,1,101,104,-3
6,37,25,3,0,63,-63
6,37,25,5,153,106,47
6,37,25,9,310,226,84
6,37,25,13,112,87,25
6,37,25,15,74,50,24
6,37,25,17,1543,1124,419
6,37,25,21,531,373,158
6,37,25,23,155,145,10
6,37,25,25,1328,726,602
6,37,25,27,271,159,112
6,37,26,49,80,68,12
6,37,26,65,132,84,48
6,37,26,77,75,86,-11
6,37,26,81,225,247,-22
6,37,26,99,176,159,17
6,37,26,125,756,627,129
6,37,26,139,90,69,21
6,37,26,161,357,306,51
6,37,26,163,463,469,-6
6,37,27,3,47,111,-64
6,37,27,37,143,189,-46
6,37,27,53,979,923,56
6,37,27,109,0,63,-63
6,37,27,123,262,247,15
6,37,27,139,52,0,52
6,37,27,163,66,101,-35
6,37,28,33,61,0,61
6,37,28,47,63,0,63
6,37,28,49,74,87,-13
6,37,29,19,56,80,-24
6,37,29,47,51,69,-18
6,37,29,77,90,138,-48
6,37,29,95,406,417,-11
6,37,29,97,0,67,-67
6,37,29,165,0,55,-55
6,37,29,183,127,146,-19
6,37,29,189,544,588,-44
6,37,29,510,286,234,52
6,37,30,29,0,74,-74
6,37,30,31,93,156,-63
6,37,30,63,58,125,-67
6,37,30,111,44,91,-47
6,37,31,55,282,275,7
6,37,31,109,84,114,-30
6,37,31,153,0,76,-76
6,37,32,3,7814,19278,-11464
6,37,32,5,56,239,-183
6,37,32,19,0,159,-159
6,37,32,23,0,140,-140
6,37,32,31,611,1268,-657
6,37,32,510,81,156,-75
6,37,33,9,46,69,-23
6,37,33,11,174,127,47
6,37,33,15,94,120,-26
6,37,33,17,50,0,50
6,37,34,1,114,51,63
6,37,34,3,786,505,281
6,37,34,5,197,87,110
6,37,34,7,148,157,-9
6,37,34,13,393,294,99
6,37,34,15,64,0,64
6,37,34,17,931,479,452
6,37,34,21,193,159,34
6,37,34,23,461,346,115
6,37,34,25,338,183,155
6,37,34,27,315,173,142
6,37,34,29,201,137,64
6,37,34,31,232,81,151
6,37,34,35,232,119,113
6,37,34,37,50,0,50
6,37,34,39,258,150,108
6,37,35,1,647,727,-80
6,37,35,13,116,234,-118
6,37,35,43,66,163,-97
6,37,35,49,205,299,-94
6,37,35,61,0,61,-61
6,37,36,1,106,86,20
6,37,36,5,415,224,191
6,37,36,7,53,0,53
6,37,36,27,110,93,17
6,37,36,29,283,234,49
6,37,36,45,98,142,-44
6,37,36,47,5102,2340,2762
6,37,36,55,291,154,137
6,37,36,59,855,518,337
6,37,36,61,6923,4194,2729
6,37,36,65,50,0,50
6,37,36,67,165,130,35
6,37,36,71,130,111,19
6,37,36,81,2154,1063,1091
6,37,36,83,44,0,44
6,37,36,85,165,91,74
6,37,36,87,141,115,26
6,37,36,91,86,63,23
6,37,36,103,656,407,249
6,37,36,109,97,70,27
6,37,36,111,70,61,9
6,37,36,119,704,387,317
6,37,37,21,92,157,-65
6,37,37,25,0,108,-108
6,37,37,37,0,55,-55
6,37,37,49,0,62,-62
6,37,37,51,195,279,-84
6,37,37,63,172,302,-130
6,37,37,67,126,143,-17
6,37,37,81,174,216,-42
6,37,37,89,0,61,-61
6,37,37,97,0,86,-86
6,37,37,119,642,859,-217
6,37,37,129,85,77,8
6,37,37,133,216,217,-1
6,37,37,135,129,186,-57
6,37,37,179,53,92,-39
6,37,37,183,470,666,-196
6,37,38,17,61,0,61
6,37,38,101,80,57,23
6,37,39,17,69,74,-5
6,37,39,35,625,596,29
6,37,39,41,70,74,-4
6,37,39,49,664,628,36
6,37,39,57,90,113,-23
6,37,39,61,477,308,169
6,37,39,85,70,63,7
6,37,39,93,48,81,-33
6,37,39,95,104,115,-11
6,37,39,99,0,62,-62
6,37,39,113,147,172,-25
6,37,39,133,57,0,57
6,37,39,151,52,65,-13
6,37,39,153,111,211,-100
6,37,39,165,66,141,-75
6,37,40,17,0,60,-60
6,37,40,27,104,148,-44
6,37,40,31,66,73,-7
6,37,40,109,457,425,32
6,37,40,143,277,394,-117
6,37,41,3,75,143,-68
6,37,41,5,294,697,-403
6,37,41,7,0,68,-68
6,37,41,11,0,81,-81
6,37,41,15,0,77,-77
6,37,41,17,130,504,-374
6,37,41,19,0,137,-137
6,37,41,29,249,503,-254
6,37,41,33,72,205,-133
6,37,41,35,0,78,-78
6,37,41,39,300,619,-319
6,37,41,41,0,99,-99
6,37,41,43,0,135,-135
6,37,41,47,164,422,-258
6,37,41,51,1371,2016,-645
6,37,41,53,0,90,-90
6,37,41,67,608,1322,-714
6,37,41,71,0,106,-106
6,37,42,3,644,624,20
6,37,42,11,74,55,19
6,37,42,17,218,220,-2
6,37,42,27,82,63,19
6,37,42,29,217,177,40
6,37,42,41,0,63,-63
6,37,42,43,85,69,16
6,37,42,45,225,173,52
6,37,42,49,55,0,55
6,37,42,69,51,55,-4
6,37,42,71,86,102,-16
6,37,42,77,74,56,18
6,37,42,91,354,285,69
6,37,42,95,77,79,-2
6,37,42,101,964,646,318
6,37,42,129,0,55,-55
6,37,42,133,60,71,-11
6,37,44,3,51,0,51
6,37,44,5,53,0,53
6,37,44,7,331,194,137
6,37,45,13,87,153,-66
6,37,45,15,91,99,-8
6,37,45,19,181,225,-44
6,37,45,45,84,191,-107
6,37,45,51,61,98,-37
6,37,45,63,49,64,-15
6,37,45,79,142,152,-10
6,37,45,91,0,95,-95
6,37,46,99,70,83,-13
6,37,46,103,0,55,-55
6,37,47,37,760,1041,-281
6,37,47,65,80,109,-29
6,37,47,93,143,241,-98
6,37,47,119,0,68,-68
6,37,47,125,103,195,-92
6,37,47,149,70,188,-118
6,37,47,157,425,396,29
6,37,47,165,0,117,-117
6,37,47,187,113,496,-383
6,37,47,189,0,118,-118
6,37,48,27,277,464,-187
6,37,48,29,944,1517,-573
6,37,48,39,151,144,7
6,37,48,41,97,112,-15
6,37,48,61,68,72,-4
6,37,48,85,784,2925,-2141
6,37,48,91,0,142,-142
6,37,48,99,0,71,-71
6,37,48,113,1990,2517,-527
6,37,48,121,534,1344,-810
6,37,48,135,0,87,-87
6,37,48,139,0,75,-75
6,37,48,141,780,1100,-320
6,37,48,157,391,540,-149
6,37,48,167,106,149,-43
6,37,48,187,0,115,-115
6,37,48,201,2653,3155,-502
6,37,48,209,72,181,-109
6,37,48,215,130,152,-22
6,37,48,245,97,95,2
6,37,48,251,0,68,-68
6,37,48,257,0,75,-75
6,37,48,303,76,128,-52
6,37,48,309,114,155,-41
6,37,48,329,64,92,-28
6,37,48,339,161,434,-273
6,37,48,355,80,83,-3
6,37,48,367,0,126,-126
6,37,48,373,0,59,-59
6,37,48,375,59,80,-21
6,37,48,397,0,109,-109
6,37,48,423,62,113,-51
6,37,48,439,1164,2023,-859
6,37,48,441,75,83,-8
6,37,48,451,56,0,56
6,37,48,453,1872,2615,-743
6,37,48,479,69,56,13
6,37,48,485,0,77,-77
6,37,48,491,317,992,-675
6,37,49,5,85,97,-12
6,37,49,11,148,400,-252
6,37,49,21,0,161,-161
6,37,49,35,1056,1625,-569
6,37,49,43,49,98,-49
6,37,49,49,473,850,-377
6,37,49,51,0,71,-71
6,37,49,53,142,399,-257
6,37,49,57,149,255,-106
6,37,50,7,97,89,8
6,37,51,3,76,77,-1
6,37,51,13,529,418,111
6,37,51,41,101,100,1
6,37,51,59,1056,1001,55
6,37,51,87,166,161,5
6,37,51,107,303,317,-14
6,37,51,121,49,0,49
6,37,51,153,236,208,28
6,37,51,179,71,76,-5
6,37,51,510,306,250,56
6,37,51,540,43,0,43
6,37,51,550,105,75,30
6,37,51,650,0,74,-74
6,37,51,700,81,80,1
6,37,51,710,182,166,16
6,37,51,760,143,145,-2
6,37,51,810,226,325,-99
6,37,53,5,92,180,-88
6,37,53,7,0,74,-74
6,37,53,9,0,137,-137
6,37,53,11,284,867,-583
6,37,53,15,0,86,-86
6,37,53,21,0,148,-148
6,37,53,25,0,70,-70
6,37,53,29,89,191,-102
6,37,53,33,3999,5607,-1608
6,37,53,35,257,433,-176
6,37,53,41,0,68,-68
6,37,53,45,0,72,-72
6,37,53,53,828,1403,-575
6,37,53,57,85,175,-90
6,37,53,61,652,967,-315
6,37,53,63,241,549,-308
6,37,53,67,216,402,-186
6,37,53,73,150,293,-143
6,37,53,77,135,201,-66
6,37,55,9,65,0,65
6,37,55,25,329,280,49
6,37,55,79,438,271,167
6,37,55,133,100,81,19
6,37,55,139,43,0,43
6,37,56,21,48,63,-15
6,37,56,39,0,65,-65
6,39,4,13,0,90,-90
6,39,6,1,212,58,154
6,39,6,13,115,0,115
6,39,6,19,3773,3438,335
6,39,6,29,108,106,2
6,39,6,31,72,0,72
6,39,6,37,364,170,194
6,39,6,43,126,95,31
6,39,6,47,739,539,200
6,39,6,53,211,151,60
6,39,6,59,131,84,47
6,39,6,65,125,90,35
6,39,6,67,159,141,18
6,39,6,71,77,71,6
6,39,6,73,105,139,-34
6,39,6,77,128,124,4
6,39,6,79,77,74,3
6,39,6,83,61,66,-5
6,39,6,85,469,122,347
6,39,6,95,79,0,79
6,39,6,99,200,167,33
6,39,6,107,156,126,30
6,39,6,111,80,0,80
6,39,32,3,0,64,-64
6,39,53,33,0,58,-58
6,41,4,13,92,186,-94
6,41,6,1,1241,863,378
6,41,6,7,71,63,8
6,41,6,13,1003,1268,-265
6,41,6,17,0,104,-104
6,41,6,19,0,72,-72
6,41,6,23,0,59,-59
6,41,6,33,0,79,-79
6,41,6,37,774,714,60
6,41,6,45,57,72,-15
6,41,6,53,57,81,-24
6,41,6,55,144,234,-90
6,41,6,57,49,143,-94
6,41,6,59,226,272,-46
6,41,6,61,97,186,-89
6,41,6,65,79,144,-65
6,41,6,67,282,405,-123
6,41,6,73,343,379,-36
6,41,6,75,4776,2086,2690
6,41,6,77,0,86,-86
6,41,6,79,0,63,-63
6,41,6,81,772,510,262
6,41,6,83,65,79,-14
6,41,6,85,494,397,97
6,41,6,87,111,119,-8
6,41,6,95,451,654,-203
6,41,6,97,2042,2881,-839
6,41,6,99,86,0,86
6,41,6,111,58,72,-14
6,41,6,113,67,95,-28
6,41,8,13,0,89,-89
6,41,8,31,50,129,-79
6,41,9,1,82,0,82
6,41,11,1,64,66,-2
6,41,12,99,0,77,-77
6,41,15,3,0,55,-55
6,41,16,1,0,68,-68
6,41,17,31,162,122,40
6,41,25,17,91,71,20
6,41,32,3,76,124,-48
6,41,32,31,0,194,-194
6,41,36,47,139,71,68
6,41,36,61,151,174,-23
6,41,41,5,0,65,-65
6,41,41,17,0,84,-84
6,41,41,29,0,73,-73
6,41,41,39,0,50,-50
6,41,41,51,55,177,-122
6,41,48,453,49,175,-126
6,41,53,33,151,261,-110
6,43,6,19,81,0,81
6,43,6,37,58,0,58
6,43,6,39,95,126,-31
6,43,6,47,156,137,19
6,43,6,85,73,0,73
6,43,6,99,165,101,64
6,43,6,109,70,101,-31
6,45,4,13,0,68,-68
6,45,6,1,186,116,70
6,45,6,7,148,115,33
6,45,6,13,150,63,87
6,45,6,23,147,99,48
6,45,6,33,249,488,-239
6,45,6,37,144,110,34
6,45,6,41,72,57,15
6,45,6,59,54,0,54
6,45,6,61,0,73,-73
6,45,6,65,65,69,-4
6,45,6,67,198,176,22
6,45,6,73,60,86,-26
6,45,6,75,119,0,119
6,45,6,77,59,0,59
6,45,6,81,84,0,84
6,45,6,85,118,66,52
6,45,6,87,68,59,9
6,45,6,89,0,73,-73
6,45,6,95,63,0,63
6,45,6,97,966,652,314
6,45,32,31,0,72,-72
6,47,4,13,148,157,-9
6,47,6,1,447,355,92
6,47,6,13,215,171,44
6,47,6,19,646,1145,-499
6,47,6,29,112,97,15
6,47,6,37,551,355,196
6,47,6,39,539,739,-200
6,47,6,43,137,156,-19
6,47,6,53,418,272,146
6,47,6,59,127,92,35
6,47,6,65,124,168,-44
6,47,6,67,393,542,-149
6,47,6,69,325,170,155
6,47,6,71,106,112,-6
6,47,6,73,169,228,-59
6,47,6,75,87,73,14
6,47,6,77,594,470,124
6,47,6,79,0,68,-68
6,47,6,81,259,107,152
6,47,6,85,3194,1260,1934
6,47,6,87,318,116,202
6,47,6,95,67,67,0
6,47,6,97,0,79,-79
6,47,6,99,3603,2742,861
6,47,6,107,109,132,-23
6,47,6,109,76,80,-4
6,47,8,41,0,65,-65
6,47,32,3,102,132,-30
6,47,32,31,0,56,-56
6,49,6,89,0,84,-84
6,49,41,35,0,78,-78
6,51,6,27,143,198,-55
6,51,6,37,126,98,28
6,51,6,59,91,0,91
6,51,6,71,92,0,92
6,51,6,73,139,89,50
6,53,4,13,201,374,-173
6,53,4,19,77,117,-40
6,53,4,25,0,64,-64
6,53,4,27,292,482,-190
6,53,6,1,480,429,51
6,53,6,7,103,120,-17
6,53,6,13,328,307,21
6,53,6,17,64,86,-22
6,53,6,19,551,743,-192
6,53,6,23,48,0,48
6,53,6,25,138,128,10
6,53,6,29,247,537,-290
6,53,6,31,71,123,-52
6,53,6,37,929,898,31
6,53,6,39,151,211,-60
6,53,6,41,81,57,24
6,53,6,47,272,418,-146
6,53,6,55,76,56,20
6,53,6,59,383,346,37
6,53,6,61,100,179,-79
6,53,6,65,345,373,-28
6,53,6,67,447,754,-307
6,53,6,69,522,674,-152
6,53,6,71,228,161,67
6,53,6,73,728,857,-129
6,53,6,75,272,278,-6
6,53,6,77,246,252,-6
6,53,6,79,330,559,-229
6,53,6,81,358,247,111
6,53,6,83,301,210,91
6,53,6,85,2073,1558,515
6,53,6,87,2645,2033,612
6,53,6,89,0,103,-103
6,53,6,95,144,145,-1
6,53,6,97,151,187,-36
6,53,6,99,237,281,-44
6,53,6,107,161,314,-153
6,53,6,111,565,374,191
6,53,6,113,88,100,-12
6,53,8,41,111,157,-46
6,53,12,57,84,0,84
6,53,12,91,0,81,-81
6,53,13,73,0,124,-124
6,53,13,245,0,195,-195
6,53,15,3,263,371,-108
6,53,16,1,0,87,-87
6,53,17,31,56,92,-36
6,53,24,3,116,236,-120
6,53,31,153,0,93,-93
6,53,32,3,220,447,-227
6,53,32,31,99,156,-57
6,53,35,9,0,61,-61
6,53,36,47,54,0,54
6,53,37,51,79,103,-24
6,53,37,133,75,65,10
6,53,41,29,55,0,55
6,53,41,39,0,66,-66
6,53,41,51,48,100,-52
6,53,41,67,0,77,-77
6,53,47,37,0,50,-50
6,53,48,29,109,203,-94
6,53,48,113,0,62,-62
6,53,48,201,60,95,-35
6,53,48,439,0,69,-69
6,53,48,451,0,182,-182
6,53,48,453,0,126,-126
6,53,49,35,0,113,-113
6,53,51,13,0,63,-63
6,53,51,59,130,164,-34
6,53,51,153,0,80,-80
6,53,51,810,98,0,98
6,53,53,11,0,54,-54
6,53,53,33,102,191,-89
6,53,53,35,0,85,-85
6,53,53,53,108,142,-34
6,53,53,61,0,74,-74
6,53,53,63,0,56,-56
6,55,4,13,69,123,-54
6,55,6,1,328,308,20
6,55,6,7,71,63,8
6,55,6,13,591,477,114
6,55,6,19,53,0,53
6,55,6,33,150,244,-94
6,55,6,37,284,238,46
6,55,6,41,234,144,90
6,55,6,53,56,76,-20
6,55,6,57,0,62,-62
6,55,6,59,125,95,30
6,55,6,61,82,180,-98
6,55,6,65,95,84,11
6,55,6,67,262,361,-99
6,55,6,73,169,166,3
6,55,6,75,373,242,131
6,55,6,77,76,85,-9
6,55,6,81,268,111,157
6,55,6,85,233,133,100
6,55,6,89,0,72,-72
6,55,6,95,2184,2660,-476
6,55,6,97,937,746,191
6,55,6,99,71,0,71
6,55,6,111,0,58,-58
6,55,6,113,98,141,-43
6,55,16,1,0,69,-69
6,55,32,3,52,65,-13
6,55,32,31,0,84,-84
6,55,41,51,0,47,-47
6,55,53,33,0,57,-57
6,57,4,13,59,100,-41
6,57,6,1,463,160,303
6,57,6,7,270,178,92
6,57,6,13,446,100,346
6,57,6,17,165,177,-12
6,57,6,19,56,0,56
6,57,6,37,314,117,197
6,57,6,41,143,49,94
6,57,6,55,62,0,62
6,57,6,59,119,87,32
6,57,6,61,1532,1628,-96
6,57,6,63,0,53,-53
6,57,6,65,89,56,33
6,57,6,67,686,500,186
6,57,6,73,144,102,42
6,57,6,75,219,94,125
6,57,6,77,79,0,79
6,57,6,79,49,0,49
6,57,6,81,213,49,164
6,57,6,83,54,59,-5
6,57,6,85,438,107,331
6,57,6,87,116,59,57
6,57,6,95,95,0,95
6,57,6,97,257,92,165
6,57,6,101,58,84,-26
6,57,6,111,80,0,80
6,57,6,113,80,48,32
6,57,6,115,263,220,43
6,57,32,31,359,728,-369
6,59,1,73,91,0,91
6,59,1,89,0,89,-89
6,59,2,20,114,84,30
6,59,2,90,0,48,-48
6,59,4,5,68,168,-100
6,59,4,7,0,59,-59
6,59,4,13,2475,5289,-2814
6,59,4,15,217,834,-617
6,59,4,19,361,637,-276
6,59,4,21,84,358,-274
6,59,4,25,155,804,-649
6,59,4,27,96,156,-60
6,59,5,7,0,135,-135
6,59,5,119,65,0,65
6,59,5,143,0,93,-93
6,59,6,1,1749,1729,20
6,59,6,7,190,201,-11
6,59,6,13,1148,1070,78
6,59,6,17,174,272,-98
6,59,6,19,604,718,-114
6,59,6,23,133,152,-19
6,59,6,25,197,151,46
6,59,6,27,0,74,-74
6,59,6,29,894,1253,-359
6,59,6,31,82,112,-30
6,59,6,37,57868,44070,13798
6,59,6,39,84,131,-47
6,59,6,41,272,226,46
6,59,6,45,0,54,-54
6,59,6,47,92,127,-35
6,59,6,51,0,91,-91
6,59,6,53,346,383,-37
6,59,6,55,95,125,-30
6,59,6,57,87,119,-32
6,59,6,61,436,511,-75
6,59,6,65,16029,27754,-11725
6,59,6,67,1013,1107,-94
6,59,6,71,9011,10546,-1535
6,59,6,73,8401,9958,-1557
6,59,6,75,1209,1454,-245
6,59,6,77,437,330,107
6,59,6,79,377,726,-349
6,59,6,81,895,744,151
6,59,6,83,759,726,33
6,59,6,85,2436,2388,48
6,59,6,87,197,231,-34
6,59,6,89,199,215,-16
6,59,6,95,264,261,3
6,59,6,97,360,388,-28
6,59,6,99,251,217,34
6,59,6,107,264,432,-168
6,59,6,111,1405,1333,72
6,59,6,113,215,196,19
6,59,8,1,133,204,-71
6,59,8,5,283,424,-141
6,59,8,13,139,229,-90
6,59,8,14,0,74,-74
6,59,8,31,340,447,-107
6,59,8,35,235,551,-316
6,59,8,41,296,655,-359
6,59,8,59,189,321,-132
6,59,8,67,0,56,-56
6,59,8,69,114,232,-118
6,59,8,77,0,75,-75
6,59,8,123,0,115,-115
6,59,9,1,272,144,128
6,59,9,3,158,73,85
6,59,9,9,128,64,64
6,59,9,11,57,0,57
6,59,10,3,82,0,82
6,59,11,1,260,238,22
6,59,12,9,88,139,-51
6,59,12,11,355,356,-1
6,59,12,21,0,88,-88
6,59,12,31,140,161,-21
6,59,12,33,0,51,-51
6,59,12,57,162,317,-155
6,59,12,69,0,61,-61
6,59,12,71,85,108,-23
6,59,12,81,75,82,-7
6,59,12,86,313,283,30
6,59,12,95,457,299,158
6,59,12,97,69,69,0
6,59,12,99,272,257,15
6,59,12,101,0,70,-70
6,59,12,103,146,152,-6
6,59,12,105,72,65,7
6,59,12,109,84,121,-37
6,59,12,115,63,103,-40
6,59,12,117,81,87,-6
6,59,12,127,0,69,-69
6,59,13,51,82,0,82
6,59,13,57,0,70,-70
6,59,13,67,160,223,-63
6,59,13,89,161,104,57
6,59,13,117,0,82,-82
6,59,13,121,367,343,24
6,59,13,135,161,369,-208
6,59,15,1,145,230,-85
6,59,15,3,858,717,141
6,59,15,7,71,112,-41
6,59,15,9,169,228,-59
6,59,16,1,196,1161,-965
6,59,16,27,0,151,-151
6,59,16,55,59,295,-236
6,59,16,83,0,65,-65
6,59,17,19,59,52,7
6,59,17,31,1298,943,355
6,59,17,43,333,155,178
6,59,17,89,83,68,15
6,59,17,97,238,89,149
6,59,17,197,151,91,60
6,59,18,3,0,64,-64
6,59,18,57,98,108,-10
6,59,18,97,164,109,55
6,59,18,141,50,0,50
6,59,19,153,0,77,-77
6,59,20,91,191,204,-13
6,59,20,173,87,94,-7
6,59,21,67,0,73,-73
6,59,21,111,109,96,13
6,59,22,33,60,0,60
6,59,22,51,0,60,-60
6,59,22,71,77,89,-12
6,59,24,3,103,100,3
6,59,24,5,116,60,56
6,59,24,27,97,80,17
6,59,24,31,275,215,60
6,59,24,33,75,50,25
6,59,24,510,84,54,30
6,59,25,9,84,88,-4
6,59,25,17,487,337,150
6,59,25,21,170,103,67
6,59,25,23,0,78,-78
6,59,25,25,309,216,93
6,59,25,27,96,94,2
6,59,26,77,60,0,60
6,59,26,81,89,90,-1
6,59,26,99,87,70,17
6,59,26,125,304,256,48
6,59,26,161,117,87,30
6,59,26,163,231,193,38
6,59,27,37,74,70,4
6,59,27,53,432,322,110
6,59,27,123,101,125,-24
6,59,29,77,0,70,-70
6,59,29,95,125,106,19
6,59,29,183,64,76,-12
6,59,29,189,222,175,47
6,59,29,510,53,49,4
6,59,30,29,0,64,-64
6,59,30,31,0,118,-118
6,59,30,63,0,77,-77
6,59,30,81,0,51,-51
6,59,31,55,123,107,16
6,59,31,109,0,69,-69
6,59,32,3,2190,4963,-2773
6,59,32,5,0,130,-130
6,59,32,23,0,62,-62
6,59,32,31,247,589,-342
6,59,32,510,0,77,-77
6,59,34,3,339,173,166
6,59,34,5,50,0,50
6,59,34,7,74,0,74
6,59,34,13,146,0,146
6,59,34,17,216,150,66
6,59,34,21,65,0,65
6,59,34,23,183,112,71
6,59,34,25,47,64,-17
6,59,34,27,121,0,121
6,59,34,29,47,0,47
6,59,34,35,86,0,86
6,59,34,39,72,0,72
6,59,35,1,220,242,-22
6,59,35,13,0,73,-73
6,59,35,43,0,58,-58
6,59,35,49,0,94,-94
6,59,36,29,79,75,4
6,59,36,45,62,0,62
6,59,36,47,483,398,85
6,59,36,55,106,74,32
6,59,36,59,218,92,126
6,59,36,61,778,848,-70
6,59,36,67,57,53,4
6,59,36,71,51,0,51
6,59,36,81,409,264,145
6,59,36,91,82,0,82
6,59,36,103,180,120,60
6,59,36,119,180,91,89
6,59,37,21,0,56,-56
6,59,37,51,0,107,-107
6,59,37,63,67,86,-19
6,59,37,67,0,90,-90
6,59,37,81,69,76,-7
6,59,37,119,231,364,-133
6,59,37,129,0,84,-84
6,59,37,133,124,167,-43
6,59,37,183,199,338,-139
6,59,39,35,212,127,85
6,59,39,49,217,201,16
6,59,39,61,118,88,30
6,59,39,113,60,59,1
6,59,39,153,63,54,9
6,59,40,27,74,0,74
6,59,40,109,125,186,-61
6,59,40,143,125,150,-25
6,59,41,5,177,299,-122
6,59,41,17,79,420,-341
6,59,41,19,0,58,-58
6,59,41,29,109,176,-67
6,59,41,33,0,101,-101
6,59,41,39,192,341,-149
6,59,41,47,69,149,-80
6,59,41,51,371,720,-349
6,59,41,53,0,69,-69
6,59,41,67,279,724,-445
6,59,42,3,155,114,41
6,59,42,17,65,93,-28
6,59,42,29,103,87,16
6,59,42,45,66,60,6
6,59,42,91,137,120,17
6,59,42,101,217,139,78
6,59,44,7,62,74,-12
6,59,45,13,0,85,-85
6,59,45,19,0,89,-89
6,59,45,35,0,69,-69
6,59,45,45,0,82,-82
6,59,45,63,0,61,-61
6,59,45,79,57,0,57
6,59,45,83,0,60,-60
6,59,47,37,158,307,-149
6,59,47,93,0,99,-99
6,59,47,125,0,77,-77
6,59,47,149,0,101,-101
6,59,47,157,122,107,15
6,59,47,165,0,81,-81
6,59,47,187,60,361,-301
6,59,47,189,0,77,-77
6,59,48,27,91,108,-17
6,59,48,29,361,613,-252
6,59,48,85,404,1381,-977
6,59,48,91,0,102,-102
6,59,48,113,605,1036,-431
6,59,48,121,272,720,-448
6,59,48,141,175,222,-47
6,59,48,157,181,318,-137
6,59,48,167,0,112,-112
6,59,48,187,0,81,-81
6,59,48,201,889,987,-98
6,59,48,209,0,112,-112
6,59,48,309,0,95,-95
6,59,48,339,90,225,-135
6,59,48,397,0,64,-64
6,59,48,439,458,948,-490
6,59,48,453,551,1067,-516
6,59,48,491,200,601,-401
6,59,49,11,90,173,-83
6,59,49,21,0,90,-90
6,59,49,35,589,1005,-416
6,59,49,43,0,95,-95
6,59,49,49,320,628,-308
6,59,49,53,56,339,-283
6,59,49,57,0,109,-109
6,59,51,13,115,155,-40
6,59,51,41,0,58,-58
6,59,51,59,548,360,188
6,59,51,107,164,138,26
6,59,51,153,123,110,13
6,59,51,510,88,93,-5
6,59,51,810,150,141,9
6,59,53,5,0,83,-83
6,59,53,9,0,62,-62
6,59,53,11,150,432,-282
6,59,53,29,62,104,-42
6,59,53,33,1579,2172,-593
6,59,53,35,109,201,-92
6,59,53,53,395,605,-210
6,59,53,57,0,57,-57
6,59,53,61,417,535,-118
6,59,53,63,115,284,-169
6,59,53,67,61,189,-128
6,59,53,73,58,141,-83
6,59,53,77,0,75,-75
6,59,55,25,119,134,-15
6,59,55,79,92,98,-6
6,59,55,133,61,0,61
6,61,4,13,280,545,-265
6,61,4,19,85,99,-14
6,61,4,21,0,50,-50
6,61,4,25,0,62,-62
6,61,6,1,1432,399,1033
6,61,6,5,68,91,-23
6,61,6,7,678,318,360
6,61,6,9,71,0,71
6,61,6,13,1355,371,984
6,61,6,17,1016,1082,-66
6,61,6,19,248,181,67
6,61,6,23,112,76,36
6,61,6,29,182,60,122
6,61,6,33,59,0,59
6,61,6,37,907,636,271
6,61,6,41,186,97,89
6,61,6,45,73,0,73
6,61,6,53,179,100,79
6,61,6,55,180,82,98
6,61,6,57,1628,1532,96
6,61,6,59,511,436,75
6,61,6,63,0,60,-60
6,61,6,65,369,261,108
6,61,6,67,13557,10165,3392
6,61,6,71,201,122,79
6,61,6,73,593,545,48
6,61,6,75,407,201,206
6,61,6,77,421,300,121
6,61,6,79,158,139,19
6,61,6,81,1082,236,846
6,61,6,83,106,111,-5
6,61,6,85,2558,507,2051
6,61,6,87,239,107,132
6,61,6,89,170,112,58
6,61,6,95,538,331,207
6,61,6,97,624,210,414
6,61,6,99,232,154,78
6,61,6,101,375,335,40
6,61,6,107,89,0,89
6,61,6,111,197,82,115
6,61,6,113,642,381,261
6,61,6,115,611,954,-343
6,61,8,35,0,64,-64
6,61,8,41,90,79,11
6,61,15,3,173,76,97
6,61,16,1,59,347,-288
6,61,16,27,0,94,-94
6,61,16,55,0,75,-75
6,61,17,31,85,69,16
6,61,32,3,202,263,-61
6,61,32,5,0,92,-92
6,61,32,19,0,62,-62
6,61,32,31,505,883,-378
6,61,32,510,0,60,-60
6,61,36,61,0,51,-51
6,61,41,17,0,91,-91
6,61,41,29,0,104,-104
6,61,41,39,0,76,-76
6,61,41,51,0,123,-123
6,61,41,67,72,70,2
6,61,48,29,127,80,47
6,61,48,85,0,83,-83
6,61,48,113,0,64,-64
6,61,48,201,73,75,-2
6,61,48,439,0,101,-101
6,61,48,491,0,74,-74
6,61,49,35,79,66,13
6,61,49,49,74,132,-58
6,61,53,11,66,76,-10
6,61,53,33,178,215,-37
6,61,53,53,80,120,-40
6,61,53,61,0,79,-79
6,61,53,63,0,54,-54
6,63,6,1,54,0,54
6,63,6,7,222,116,106
6,63,6,35,70,69,1
6,63,6,57,53,0,53
6,63,6,61,60,0,60
6,63,6,67,75,0,75
6,63,32,31,180,184,-4
6,65,1,89,0,81,-81
6,65,2,20,118,94,24
6,65,4,3,78,81,-3
6,65,4,5,78,135,-57
6,65,4,7,0,63,-63
6,65,4,12,83,103,-20
6,65,4,13,1906,4403,-2497
6,65,4,15,419,1272,-853
6,65,4,17,0,101,-101
6,65,4,19,337,670,-333
6,65,4,21,165,598,-433
6,65,4,25,184,650,-466
6,65,4,27,297,402,-105
6,65,5,7,0,109,-109
6,65,6,1,894,644,250
6,65,6,7,169,188,-19
6,65,6,13,669,493,176
6,65,6,17,144,187,-43
6,65,6,19,513,636,-123
6,65,6,23,133,144,-11
6,65,6,25,1297,1468,-171
6,65,6,27,0,75,-75
6,65,6,29,911,1007,-96
6,65,6,31,102,177,-75
6,65,6,37,35011,16847,18164
6,65,6,39,90,125,-35
6,65,6,41,144,79,65
6,65,6,45,69,65,4
6,65,6,47,168,124,44
6,65,6,53,373,345,28
6,65,6,55,84,95,-11
6,65,6,57,56,89,-33
6,65,6,59,27754,16029,11725
6,65,6,61,261,369,-108
6,65,6,67,688,748,-60
6,65,6,71,36031,29621,6410
6,65,6,73,19610,14427,5183
6,65,6,75,573,351,222
6,65,6,77,372,376,-4
6,65,6,79,352,334,18
6,65,6,81,401,236,165
6,65,6,83,447,419,28
6,65,6,85,1065,602,463
6,65,6,87,159,133,26
6,65,6,89,85,169,-84
6,65,6,93,0,64,-64
6,65,6,95,300,221,79
6,65,6,97,355,243,112
6,65,6,99,233,262,-29
6,65,6,107,291,301,-10
6,65,6,111,1156,849,307
6,65,6,113,115,117,-2
6,65,6,115,0,55,-55
6,65,8,1,113,143,-30
6,65,8,5,184,248,-64
6,65,8,13,58,62,-4
6,65,8,31,136,202,-66
6,65,8,35,142,161,-19
6,65,8,41,357,580,-223
6,65,8,59,119,147,-28
6,65,8,69,81,168,-87
6,65,8,123,60,88,-28
6,65,9,1,75,0,75
6,65,9,9,67,0,67
6,65,11,1,88,80,8
6,65,12,9,0,107,-107
6,65,12,11,196,130,66
6,65,12,31,96,173,-77
6,65,12,33,51,0,51
6,65,12,57,121,175,-54
6,65,12,69,0,77,-77
6,65,12,71,58,72,-14
6,65,12,86,139,242,-103
6,65,12,91,59,0,59
6,65,12,95,167,144,23
6,65,12,99,97,126,-29
6,65,12,103,85,74,11
6,65,12,105,0,61,-61
6,65,12,115,0,69,-69
6,65,12,127,0,65,-65
6,65,13,67,106,144,-38
6,65,13,89,0,85,-85
6,65,13,117,0,64,-64
6,65,13,121,120,129,-9
6,65,13,135,120,144,-24
6,65,15,1,103,130,-27
6,65,15,3,654,464,190
6,65,15,7,0,71,-71
6,65,15,9,63,108,-45
6,65,16,1,184,754,-570
6,65,16,17,0,68,-68
6,65,16,27,62,318,-256
6,65,16,55,87,336,-249
6,65,17,31,632,373,259
6,65,17,43,75,103,-28
6,65,17,97,191,95,96
6,65,17,197,68,94,-26
6,65,18,97,100,114,-14
6,65,19,153,70,62,8
6,65,20,91,62,104,-42
6,65,20,173,77,0,77
6,65,21,111,0,72,-72
6,65,24,3,119,127,-8
6,65,24,5,58,0,58
6,65,24,31,86,84,2
6,65,24,33,68,75,-7
6,65,25,9,49,0,49
6,65,25,17,95,79,16
6,65,25,21,55,0,55
6,65,25,25,62,64,-2
6,65,25,27,49,0,49
6,65,26,125,116,108,8
6,65,26,163,155,139,16
6,65,27,37,0,61,-61
6,65,27,53,184,104,80
6,65,29,77,0,67,-67
6,65,29,95,89,112,-23
6,65,29,189,72,82,-10
6,65,29,510,51,0,51
6,65,30,29,0,83,-83
6,65,30,31,0,58,-58
6,65,30,63,0,59,-59
6,65,31,55,0,78,-78
6,65,32,3,2274,3994,-1720
6,65,32,5,0,111,-111
6,65,32,19,0,85,-85
6,65,32,23,0,107,-107
6,65,32,31,303,402,-99
6,65,32,510,0,67,-67
6,65,34,3,68,0,68
6,65,34,13,63,0,63
6,65,34,17,49,56,-7
6,65,34,23,0,60,-60
6,65,35,1,161,223,-62
6,65,35,13,0,86,-86
6,65,35,43,0,77,-77
6,65,36,45,57,69,-12
6,65,36,47,138,83,55
6,65,36,55,0,70,-70
6,65,36,59,75,0,75
6,65,36,61,198,156,42
6,65,36,81,114,60,54
6,65,36,103,89,71,18
6,65,36,119,78,52,26
6,65,37,49,0,78,-78
6,65,37,51,56,129,-73
6,65,37,119,105,140,-35
6,65,37,133,281,281,0
6,65,37,183,72,134,-62
6,65,39,35,80,77,3
6,65,39,49,157,85,72
6,65,40,27,0,73,-73
6,65,40,109,113,151,-38
6,65,40,143,73,131,-58
6,65,41,5,145,217,-72
6,65,41,17,126,237,-111
6,65,41,19,0,89,-89
6,65,41,29,78,170,-92
6,65,41,33,57,85,-28
6,65,41,35,0,66,-66
6,65,41,39,139,224,-85
6,65,41,43,0,93,-93
6,65,41,47,120,126,-6
6,65,41,51,316,293,23
6,65,41,67,257,379,-122
6,65,42,3,69,61,8
6,65,42,17,58,0,58
6,65,42,91,0,68,-68
6,65,42,101,54,0,54
6,65,45,13,82,77,5
6,65,46,103,0,87,-87
6,65,47,37,66,152,-86
6,65,47,65,0,61,-61
6,65,47,93,0,98,-98
6,65,47,125,0,133,-133
6,65,47,149,0,85,-85
6,65,47,157,77,85,-8
6,65,47,165,0,90,-90
6,65,47,187,0,91,-91
6,65,48,27,107,218,-111
6,65,48,29,276,524,-248
6,65,48,85,179,351,-172
6,65,48,91,0,97,-97
6,65,48,113,369,373,-4
6,65,48,121,134,357,-223
6,65,48,139,0,115,-115
6,65,48,141,247,331,-84
6,65,48,157,80,82,-2
6,65,48,187,0,89,-89
6,65,48,201,378,568,-190
6,65,48,209,0,89,-89
6,65,48,309,0,152,-152
6,65,48,339,73,183,-110
6,65,48,367,0,77,-77
6,65,48,397,0,94,-94
6,65,48,423,0,96,-96
6,65,48,439,358,643,-285
6,65,48,453,462,372,90
6,65,48,491,71,328,-257
6,65,49,11,91,147,-56
6,65,49,21,0,146,-146
6,65,49,35,282,553,-271
6,65,49,49,211,482,-271
6,65,49,53,97,414,-317
6,65,49,57,53,81,-28
6,65,51,13,49,0,49
6,65,51,59,188,117,71
6,65,51,107,0,88,-88
6,65,51,153,119,87,32
6,65,51,179,0,82,-82
6,65,51,710,82,60,22
6,65,51,810,105,152,-47
6,65,53,5,0,68,-68
6,65,53,9,0,67,-67
6,65,53,11,190,292,-102
6,65,53,29,67,146,-79
6,65,53,33,932,878,54
6,65,53,35,194,194,0
6,65,53,53,475,560,-85
6,65,53,57,56,65,-9
6,65,53,61,298,363,-65
6,65,53,63,113,299,-186
6,65,53,67,111,167,-56
6,65,53,73,84,108,-24
6,65,53,77,68,99,-31
6,67,1,89,0,132,-132
6,67,2,20,173,90,83
6,67,4,13,821,1303,-482
6,67,4,15,0,88,-88
6,67,4,19,186,223,-37
6,67,4,21,0,220,-220
6,67,4,25,0,75,-75
6,67,6,1,4728,2542,2186
6,67,6,5,466,801,-335
6,67,6,7,1311,907,404
6,67,6,9,249,313,-64
6,67,6,11,152,121,31
6,67,6,13,3784,1911,1873
6,67,6,15,59,93,-34
6,67,6,17,3900,5407,-1507
6,67,6,19,1097,958,139
6,67,6,23,278,237,41
6,67,6,25,0,70,-70
6,67,6,29,539,449,90
6,67,6,31,120,132,-12
6,67,6,33,183,188,-5
6,67,6,35,76,89,-13
6,67,6,37,3423,2660,763
6,67,6,39,141,159,-18
6,67,6,41,405,282,123
6,67,6,45,176,198,-22
6,67,6,47,542,393,149
6,67,6,53,754,447,307
6,67,6,55,361,262,99
6,67,6,57,500,686,-186
6,67,6,59,1107,1013,94
6,67,6,61,10165,13557,-3392
6,67,6,63,0,75,-75
6,67,6,65,748,688,60
6,67,6,69,103,0,103
6,67,6,71,727,595,132
6,67,6,73,1700,1628,72
6,67,6,75,1732,1180,552
6,67,6,77,4254,3745,509
6,67,6,79,287,260,27
6,67,6,81,2265,817,1448
6,67,6,83,346,217,129
6,67,6,85,5034,2090,2944
6,67,6,87,465,298,167
6,67,6,89,502,508,-6
6,67,6,93,140,82,58
6,67,6,95,3911,2400,1511
6,67,6,97,1269,587,682
6,67,6,99,1235,777,458
6,67,6,101,793,1025,-232
6,67,6,103,166,182,-16
6,67,6,107,272,289,-17
6,67,6,109,149,88,61
6,67,6,111,376,273,103
6,67,6,113,6273,5226,1047
6,67,6,115,1002,1725,-723
6,67,8,1,0,76,-76
6,67,8,5,103,118,-15
6,67,8,13,58,0,58
6,67,8,31,117,160,-43
6,67,8,35,57,67,-10
6,67,8,41,170,234,-64
6,67,8,59,73,60,13
6,67,8,69,57,0,57
6,67,10,3,65,0,65
6,67,11,1,138,107,31
6,67,12,11,100,53,47
6,67,12,31,0,86,-86
6,67,12,57,125,86,39
6,67,12,86,75,97,-22
6,67,12,95,137,81,56
6,67,12,99,0,85,-85
6,67,12,103,84,74,10
6,67,12,115,0,78,-78
6,67,13,67,61,69,-8
6,67,13,89,77,76,1
6,67,13,121,135,81,54
6,67,13,135,82,78,4
6,67,15,1,114,89,25
6,67,15,3,412,354,58
6,67,15,9,57,97,-40
6,67,16,1,131,499,-368
6,67,16,19,0,71,-71
6,67,16,27,0,255,-255
6,67,16,55,0,185,-185
6,67,16,83,0,68,-68
6,67,17,31,348,250,98
6,67,17,43,114,76,38
6,67,18,97,66,0,66
6,67,20,91,78,0,78
6,67,24,3,56,0,56
6,67,24,5,78,0,78
6,67,24,31,116,0,116
6,67,25,17,157,82,75
6,67,25,25,62,63,-1
6,67,26,125,84,57,27
6,67,26,161,59,0,59
6,67,26,163,64,0,64
6,67,27,53,180,102,78
6,67,27,123,100,110,-10
6,67,29,95,0,79,-79
6,67,29,189,60,87,-27
6,67,31,55,63,0,63
6,67,32,3,728,1382,-654
6,67,32,5,70,139,-69
6,67,32,19,77,168,-91
6,67,32,31,736,1136,-400
6,67,32,510,0,118,-118
6,67,34,23,64,0,64
6,67,35,1,103,99,4
6,67,36,29,85,0,85
6,67,36,47,244,129,115
6,67,36,59,76,0,76
6,67,36,61,154,120,34
6,67,36,81,187,74,113
6,67,37,51,65,75,-10
6,67,37,119,107,120,-13
6,67,37,133,0,63,-63
6,67,37,183,115,116,-1
6,67,39,35,75,74,1
6,67,39,49,102,109,-7
6,67,40,109,88,91,-3
6,67,40,143,78,96,-18
6,67,41,5,103,128,-25
6,67,41,11,0,80,-80
6,67,41,17,0,124,-124
6,67,41,19,0,112,-112
6,67,41,29,139,185,-46
6,67,41,33,0,76,-76
6,67,41,35,0,54,-54
6,67,41,39,80,216,-136
6,67,41,41,0,54,-54
6,67,41,47,87,163,-76
6,67,41,51,273,350,-77
6,67,41,67,250,337,-87
6,67,42,3,60,0,60
6,67,42,101,112,67,45
6,67,45,83,0,83,-83
6,67,47,37,87,59,28
6,67,47,125,0,57,-57
6,67,47,157,68,0,68
6,67,48,27,83,149,-66
6,67,48,29,187,287,-100
6,67,48,85,101,186,-85
6,67,48,113,231,259,-28
6,67,48,121,61,129,-68
6,67,48,141,104,117,-13
6,67,48,201,380,393,-13
6,67,48,339,0,83,-83
6,67,48,439,220,358,-138
6,67,48,453,218,223,-5
6,67,48,491,79,153,-74
6,67,49,11,64,80,-16
6,67,49,35,264,270,-6
6,67,49,49,118,215,-97
6,67,49,53,0,91,-91
6,67,49,57,0,66,-66
6,67,51,59,96,96,0
6,67,51,710,0,51,-51
6,67,51,810,0,68,-68
6,67,53,5,0,69,-69
6,67,53,11,96,270,-174
6,67,53,33,706,740,-34
6,67,53,35,76,95,-19
6,67,53,53,313,365,-52
6,67,53,61,189,223,-34
6,67,53,63,134,198,-64
6,67,53,67,93,108,-15
6,67,53,73,0,53,-53
6,67,55,25,65,0,65
6,67,55,79,72,64,8
6,69,6,1,103,55,48
6,69,6,37,82,0,82
6,69,6,47,170,325,-155
6,69,6,53,674,522,152
6,69,6,67,0,103,-103
6,69,6,73,0,48,-48
6,69,6,77,0,80,-80
6,69,6,81,101,0,101
6,69,6,85,3520,1357,2163
6,69,6,87,405,305,100
6,69,6,99,88,123,-35
6,71,2,20,143,124,19
6,71,2,90,91,105,-14
6,71,4,3,0,87,-87
6,71,4,5,0,131,-131
6,71,4,12,65,89,-24
6,71,4,13,1427,3159,-1732
6,71,4,15,479,1720,-1241
6,71,4,17,0,99,-99
6,71,4,19,280,430,-150
6,71,4,21,135,343,-208
6,71,4,25,127,460,-333
6,71,4,27,144,213,-69
6,71,5,7,0,79,-79
6,71,5,119,0,63,-63
6,71,6,1,592,430,162
6,71,6,7,91,171,-80
6,71,6,13,355,345,10
6,71,6,17,100,122,-22
6,71,6,19,449,581,-132
6,71,6,23,107,91,16
6,71,6,25,320,361,-41
6,71,6,27,0,58,-58
6,71,6,29,1065,1352,-287
6,71,6,31,109,136,-27
6,71,6,37,60817,31563,29254
6,71,6,39,71,77,-6
6,71,6,47,112,106,6
6,71,6,51,0,92,-92
6,71,6,53,161,228,-67
6,71,6,59,10546,9011,1535
6,71,6,61,122,201,-79
6,71,6,65,29621,36031,-6410
6,71,6,67,595,727,-132
6,71,6,73,3961,4598,-637
6,71,6,75,202,265,-63
6,71,6,77,343,281,62
6,71,6,79,172,315,-143
6,71,6,81,208,196,12
6,71,6,83,324,346,-22
6,71,6,85,587,501,86
6,71,6,87,90,83,7
6,71,6,89,86,79,7
6,71,6,95,171,253,-82
6,71,6,97,135,134,1
6,71,6,99,227,220,7
6,71,6,107,356,363,-7
6,71,6,111,846,786,60
6,71,6,113,81,101,-20
6,71,8,1,104,156,-52
6,71,8,5,182,202,-20
6,71,8,31,104,158,-54
6,71,8,35,0,89,-89
6,71,8,41,437,501,-64
6,71,8,59,77,97,-20
6,71,8,69,0,127,-127
6,71,8,123,0,110,-110
6,71,9,3,0,64,-64
6,71,11,1,58,68,-10
6,71,12,9,0,86,-86
6,71,12,11,155,125,30
6,71,12,31,66,106,-40
6,71,12,57,88,129,-41
6,71,12,86,138,159,-21
6,71,12,95,111,140,-29
6,71,12,99,53,70,-17
6,71,12,103,88,70,18
6,71,12,105,0,67,-67
6,71,13,51,67,0,67
6,71,13,67,0,84,-84
6,71,13,89,88,66,22
6,71,13,121,101,107,-6
6,71,13,135,114,128,-14
6,71,13,179,0,136,-136
6,71,13,215,95,150,-55
6,71,15,1,78,100,-22
6,71,15,3,621,619,2
6,71,15,9,0,72,-72
6,71,16,1,89,475,-386
6,71,16,27,0,201,-201
6,71,16,55,0,249,-249
6,71,16,83,0,67,-67
6,71,17,31,353,295,58
6,71,17,43,101,62,39
6,71,17,97,63,0,63
6,71,17,197,73,0,73
6,71,18,97,131,121,10
6,71,20,61,98,120,-22
6,71,20,91,69,85,-16
6,71,20,103,0,110,-110
6,71,20,173,0,61,-61
6,71,21,111,0,63,-63
6,71,24,3,61,92,-31
6,71,24,31,109,101,8
6,71,24,33,76,64,12
6,71,25,17,80,86,-6
6,71,25,25,0,60,-60
6,71,26,81,0,69,-69
6,71,26,125,51,83,-32
6,71,26,163,105,71,34
6,71,27,53,75,101,-26
6,71,29,95,0,77,-77
6,71,29,189,62,0,62
6,71,31,55,68,0,68
6,71,32,3,2537,4787,-2250
6,71,32,5,0,68,-68
6,71,32,19,0,86,-86
6,71,32,23,0,109,-109
6,71,32,31,205,314,-109
6,71,32,510,0,64,-64
6,71,34,23,64,0,64
6,71,35,1,109,173,-64
6,71,35,13,0,117,-117
6,71,36,5,56,0,56
6,71,36,45,144,87,57
6,71,36,47,123,115,8
6,71,36,59,64,0,64
6,71,36,61,82,98,-16
6,71,36,81,180,94,86
6,71,36,103,79,0,79
6,71,37,49,75,119,-44
6,71,37,51,165,171,-6
6,71,37,81,0,64,-64
6,71,37,119,81,124,-43
6,71,37,133,399,625,-226
6,71,37,183,75,122,-47
6,71,39,35,79,88,-9
6,71,39,49,88,124,-36
6,71,39,113,0,65,-65
6,71,40,31,71,90,-19
6,71,40,109,72,150,-78
6,71,40,143,96,94,2
6,71,41,5,60,136,-76
6,71,41,17,0,145,-145
6,71,41,19,0,76,-76
6,71,41,29,0,155,-155
6,71,41,39,71,178,-107
6,71,41,43,0,63,-63
6,71,41,47,63,162,-99
6,71,41,51,173,207,-34
6,71,41,67,130,210,-80
6,71,42,3,78,59,19
6,71,42,101,90,59,31
6,71,45,13,88,69,19
6,71,45,45,0,77,-77
6,71,45,79,0,71,-71
6,71,47,37,71,77,-6
6,71,47,125,121,170,-49
6,71,47,157,86,128,-42
6,71,47,165,0,58,-58
6,71,48,27,304,372,-68
6,71,48,29,250,554,-304
6,71,48,85,107,328,-221
6,71,48,91,0,73,-73
6,71,48,99,0,88,-88
6,71,48,113,302,461,-159
6,71,48,121,62,227,-165
6,71,48,141,405,490,-85
6,71,48,157,67,117,-50
6,71,48,201,533,701,-168
6,71,48,209,0,55,-55
6,71,48,309,0,81,-81
6,71,48,339,92,87,5
6,71,48,439,432,716,-284
6,71,48,453,236,235,1
6,71,48,491,80,245,-165
6,71,49,11,0,148,-148
6,71,49,21,0,116,-116
6,71,49,35,252,502,-250
6,71,49,49,139,328,-189
6,71,49,53,54,239,-185
6,71,49,57,0,97,-97
6,71,51,59,130,173,-43
6,71,51,153,154,153,1
6,71,51,179,86,95,-9
6,71,51,710,74,79,-5
6,71,51,810,123,94,29
6,71,53,11,112,158,-46
6,71,53,29,63,73,-10
6,71,53,33,421,602,-181
6,71,53,35,123,217,-94
6,71,53,53,385,567,-182
6,71,53,61,198,260,-62
6,71,53,63,96,226,-130
6,71,53,67,75,157,-82
6,71,53,73,0,63,-63
6,71,55,79,62,0,62
6,73,1,3,62,100,-38
6,73,1,73,95,67,28
6,73,1,89,65,196,-131
6,73,1,97,120,87,33
6,73,1,117,0,63,-63
6,73,2,20,198,178,20
6,73,2,90,69,69,0
6,73,4,3,160,234,-74
6,73,4,5,147,193,-46
6,73,4,7,0,78,-78
6,73,4,13,4109,7086,-2977
6,73,4,15,211,571,-360
6,73,4,17,63,100,-37
6,73,4,19,1083,1404,-321
6,73,4,21,273,616,-343
6,73,4,25,247,760,-513
6,73,4,27,743,1053,-310
6,73,5,7,0,121,-121
6,73,5,119,136,103,33
6,73,6,1,2225,2066,159
6,73,6,7,324,265,59
6,73,6,9,58,0,58
6,73,6,13,1392,1321,71
6,73,6,17,318,303,15
6,73,6,19,981,1008,-27
6,73,6,23,230,272,-42
6,73,6,25,1708,1410,298
6,73,6,27,63,52,11
6,73,6,29,1124,1271,-147
6,73,6,31,536,582,-46
6,73,6,33,0,60,-60
6,73,6,35,0,73,-73
6,73,6,37,15817,12506,3311
6,73,6,39,139,105,34
6,73,6,41,379,343,36
6,73,6,45,86,60,26
6,73,6,47,228,169,59
6,73,6,51,89,139,-50
6,73,6,53,857,728,129
6,73,6,55,166,169,-3
6,73,6,57,102,144,-42
6,73,6,59,9958,8401,1557
6,73,6,61,545,593,-48
6,73,6,65,14427,19610,-5183
6,73,6,67,1628,1700,-72
6,73,6,69,48,0,48
6,73,6,71,4598,3961,637
6,73,6,75,1674,1639,35
6,73,6,77,598,616,-18
6,73,6,79,645,566,79
6,73,6,81,1393,1219,174
6,73,6,83,1086,820,266
6,73,6,85,3356,3098,258
6,73,6,87,420,365,55
6,73,6,89,206,241,-35
6,73,6,93,0,78,-78
6,73,6,95,466,485,-19
6,73,6,97,641,498,143
6,73,6,99,558,400,158
6,73,6,101,85,0,85
6,73,6,107,423,424,-1
6,73,6,111,1946,1628,318
6,73,6,113,240,259,-19
6,73,6,115,74,62,12
6,73,8,1,238,317,-79
6,73,8,5,494,538,-44
6,73,8,13,280,328,-48
6,73,8,14,59,70,-11
6,73,8,31,490,691,-201
6,73,8,35,245,438,-193
6,73,8,37,0,63,-63
6,73,8,41,562,961,-399
6,73,8,59,297,400,-103
6,73,8,67,46,69,-23
6,73,8,69,268,354,-86
6,73,8,77,62,123,-61
6,73,8,101,69,92,-23
6,73,8,117,53,0,53
6,73,8,123,56,161,-105
6,73,9,1,318,155,163
6,73,9,3,234,208,26
6,73,9,7,48,0,48
6,73,9,9,246,189,57
6,73,9,11,266,187,79
6,73,10,3,73,107,-34
6,73,10,5,52,0,52
6,73,11,1,561,418,143
6,73,12,1,98,0,98
6,73,12,5,123,106,17
6,73,12,9,163,322,-159
6,73,12,11,565,471,94
6,73,12,15,0,83,-83
6,73,12,19,225,263,-38
6,73,12,21,120,108,12
6,73,12,31,977,1270,-293
6,73,12,33,739,487,252
6,73,12,57,495,608,-113
6,73,12,61,0,61,-61
6,73,12,69,0,117,-117
6,73,12,71,157,192,-35
6,73,12,73,89,69,20
6,73,12,81,60,104,-44
6,73,12,83,54,105,-51
6,73,12,86,643,532,111
6,73,12,87,90,90,0
6,73,12,89,0,97,-97
6,73,12,91,163,201,-38
6,73,12,95,447,442,5
6,73,12,97,55,88,-33
6,73,12,99,355,475,-120
6,73,12,101,136,148,-12
6,73,12,103,271,375,-104
6,73,12,105,111,127,-16
6,73,12,109,85,327,-242
6,73,12,111,77,83,-6
6,73,12,113,386,252,134
6,73,12,115,113,142,-29
6,73,12,117,137,180,-43
6,73,12,127,129,161,-32
6,73,13,39,188,112,76
6,73,13,51,102,122,-20
6,73,13,63,62,77,-15
6,73,13,67,254,223,31
6,73,13,73,71,83,-12
6,73,13,89,199,237,-38
6,73,13,117,0,76,-76
6,73,13,121,378,354,24
6,73,13,135,176,196,-20
6,73,13,139,0,53,-53
6,73,13,151,0,85,-85
6,73,13,179,0,57,-57
6,73,13,215,0,58,-58
6,73,13,245,92,65,27
6,73,15,1,157,224,-67
6,73,15,3,2996,2389,607
6,73,15,7,123,168,-45
6,73,15,9,202,265,-63
6,73,16,1,225,1008,-783
6,73,16,5,0,70,-70
6,73,16,17,0,105,-105
6,73,16,19,0,56,-56
6,73,16,27,92,313,-221
6,73,16,55,92,419,-327
6,73,17,19,114,54,60
6,73,17,31,2172,1294,878
6,73,17,43,349,245,104
6,73,17,89,158,157,1
6,73,17,97,884,734,150
6,73,17,111,104,0,104
6,73,17,143,73,0,73
6,73,17,163,0,86,-86
6,73,17,197,178,141,37
6,73,17,201,96,0,96
6,73,18,3,79,112,-33
6,73,18,57,126,150,-24
6,73,18,89,102,97,5
6,73,18,97,271,266,5
6,73,18,105,77,54,23
6,73,18,141,62,61,1
6,73,18,157,115,61,54
6,73,19,103,78,0,78
6,73,19,113,55,0,55
6,73,19,153,108,113,-5
6,73,19,169,57,0,57
6,73,20,45,65,0,65
6,73,20,91,232,286,-54
6,73,20,173,145,181,-36
6,73,21,67,66,73,-7
6,73,21,111,209,158,51
6,73,22,33,96,64,32
6,73,22,51,101,98,3
6,73,22,71,131,164,-33
6,73,22,75,0,102,-102
6,73,22,103,104,150,-46
6,73,23,5,178,122,56
6,73,23,23,64,0,64
6,73,23,31,113,80,33
6,73,24,3,511,463,48
6,73,24,5,247,152,95
6,73,24,17,104,74,30
6,73,24,21,103,87,16
6,73,24,25,91,0,91
6,73,24,27,106,135,-29
6,73,24,31,749,444,305
6,73,24,33,312,226,86
6,73,24,37,228,292,-64
6,73,24,510,193,130,63
6,73,25,1,84,56,28
6,73,25,5,117,60,57
6,73,25,9,199,164,35
6,73,25,13,99,66,33
6,73,25,15,62,50,12
6,73,25,17,939,660,279
6,73,25,21,243,192,51
6,73,25,23,145,104,41
6,73,25,25,559,327,232
6,73,25,27,229,186,43
6,73,26,49,50,0,50
6,73,26,65,93,74,19
6,73,26,77,55,57,-2
6,73,26,81,135,172,-37
6,73,26,99,250,364,-114
6,73,26,125,388,369,19
6,73,26,139,0,63,-63
6,73,26,161,184,166,18
6,73,26,163,325,368,-43
6,73,27,3,79,85,-6
6,73,27,37,114,162,-48
6,73,27,53,566,567,-1
6,73,27,109,0,85,-85
6,73,27,123,147,194,-47
6,73,27,139,70,68,2
6,73,27,163,62,97,-35
6,73,28,47,186,240,-54
6,73,28,59,96,144,-48
6,73,28,75,48,0,48
6,73,29,19,48,0,48
6,73,29,47,0,67,-67
6,73,29,77,90,126,-36
6,73,29,95,245,287,-42
6,73,29,169,96,97,-1
6,73,29,183,91,103,-12
6,73,29,189,251,292,-41
6,73,29,510,155,120,35
6,73,30,29,59,144,-85
6,73,30,31,65,133,-68
6,73,30,63,63,110,-47
6,73,30,111,74,109,-35
6,73,31,55,179,206,-27
6,73,31,109,156,253,-97
6,73,31,153,127,109,18
6,73,32,1,134,93,41
6,73,32,3,2901,5147,-2246
6,73,32,5,52,122,-70
6,73,32,19,71,101,-30
6,73,32,23,0,85,-85
6,73,32,31,402,839,-437
6,73,32,510,60,98,-38
6,73,33,11,147,111,36
6,73,33,15,137,119,18
6,73,33,17,87,0,87
6,73,34,1,54,0,54
6,73,34,3,307,196,111
6,73,34,5,154,128,26
6,73,34,7,136,74,62
6,73,34,13,204,88,116
6,73,34,17,265,155,110
6,73,34,21,154,84,70
6,73,34,23,234,158,76
6,73,34,25,197,120,77
6,73,34,27,174,137,37
6,73,34,29,145,102,43
6,73,34,31,74,82,-8
6,73,34,35,115,106,9
6,73,34,37,49,0,49
6,73,34,39,107,102,5
6,73,35,1,475,467,8
6,73,35,13,87,148,-61
6,73,35,43,97,117,-20
6,73,35,49,79,139,-60
6,73,36,1,83,0,83
6,73,36,5,149,134,15
6,73,36,27,75,64,11
6,73,36,29,212,139,73
6,73,36,45,78,68,10
6,73,36,47,663,500,163
6,73,36,55,216,161,55
6,73,36,59,314,178,136
6,73,36,61,948,765,183
6,73,36,67,123,97,26
6,73,36,71,116,62,54
6,73,36,81,543,271,272
6,73,36,85,70,0,70
6,73,36,87,51,0,51
6,73,36,91,173,73,100
6,73,36,103,388,224,164
6,73,36,111,52,0,52
6,73,36,119,236,192,44
6,73,37,19,0,81,-81
6,73,37,21,61,80,-19
6,73,37,49,279,250,29
6,73,37,51,140,224,-84
6,73,37,63,122,174,-52
6,73,37,67,91,127,-36
6,73,37,81,141,155,-14
6,73,37,97,0,69,-69
6,73,37,119,304,402,-98
6,73,37,129,106,128,-22
6,73,37,133,1618,1510,108
6,73,37,135,54,79,-25
6,73,37,141,0,77,-77
6,73,37,183,317,473,-156
6,73,38,17,65,0,65
6,73,39,17,64,70,-6
6,73,39,35,368,293,75
6,73,39,49,374,422,-48
6,73,39,61,184,244,-60
6,73,39,95,100,99,1
6,73,39,113,114,142,-28
6,73,39,153,131,118,13
6,73,39,165,66,65,1
6,73,40,27,87,135,-48
6,73,40,31,107,70,37
6,73,40,109,230,266,-36
6,73,40,143,195,244,-49
6,73,41,3,82,116,-34
6,73,41,5,222,367,-145
6,73,41,7,0,55,-55
6,73,41,17,134,476,-342
6,73,41,19,53,87,-34
6,73,41,29,121,277,-156
6,73,41,33,63,114,-51
6,73,41,35,0,87,-87
6,73,41,39,208,399,-191
6,73,41,41,0,78,-78
6,73,41,43,0,69,-69
6,73,41,47,148,259,-111
6,73,41,51,668,1041,-373
6,73,41,53,0,58,-58
6,73,41,67,509,644,-135
6,73,41,71,0,77,-77
6,73,42,3,314,296,18
6,73,42,17,165,87,78
6,73,42,19,59,0,59
6,73,42,29,109,101,8
6,73,42,41,65,110,-45
6,73,42,43,65,0,65
6,73,42,45,161,82,79
6,73,42,49,0,53,-53
6,73,42,71,74,0,74
6,73,42,77,86,0,86
6,73,42,79,69,0,69
6,73,42,91,268,222,46
6,73,42,95,58,60,-2
6,73,42,101,344,307,37
6,73,42,133,81,109,-28
6,73,44,5,283,258,25
6,73,44,7,150,88,62
6,73,45,13,442,478,-36
6,73,45,15,223,241,-18
6,73,45,19,231,243,-12
6,73,45,35,67,93,-26
6,73,45,45,92,173,-81
6,73,45,51,48,91,-43
6,73,45,63,0,75,-75
6,73,45,79,79,99,-20
6,73,45,83,51,69,-18
6,73,45,91,0,111,-111
6,73,46,99,0,102,-102
6,73,46,103,0,70,-70
6,73,47,37,288,390,-102
6,73,47,65,61,112,-51
6,73,47,93,102,157,-55
6,73,47,125,66,171,-105
6,73,47,149,57,118,-61
6,73,47,157,422,361,61
6,73,47,165,0,121,-121
6,73,47,187,0,247,-247
6,73,47,189,0,70,-70
6,73,48,27,211,367,-156
6,73,48,29,1009,1492,-483
6,73,48,39,93,121,-28
6,73,48,41,77,105,-28
6,73,48,61,94,112,-18
6,73,48,85,408,780,-372
6,73,48,91,0,209,-209
6,73,48,99,0,73,-73
6,73,48,113,858,1178,-320
6,73,48,121,333,401,-68
6,73,48,139,0,81,-81
6,73,48,141,500,660,-160
6,73,48,157,223,252,-29
6,73,48,167,100,119,-19
6,73,48,187,0,104,-104
6,73,48,201,1351,1425,-74
6,73,48,209,65,125,-60
6,73,48,215,144,150,-6
6,73,48,251,0,83,-83
6,73,48,273,74,0,74
6,73,48,303,94,96,-2
6,73,48,309,0,189,-189
6,73,48,329,53,60,-7
6,73,48,339,213,277,-64
6,73,48,355,268,249,19
6,73,48,367,0,126,-126
6,73,48,373,0,80,-80
6,73,48,397,0,75,-75
6,73,48,423,0,106,-106
6,73,48,439,780,1218,-438
6,73,48,451,66,63,3
6,73,48,453,740,1260,-520
6,73,48,479,67,56,11
6,73,48,491,257,749,-492
6,73,49,5,0,74,-74
6,73,49,11,156,211,-55
6,73,49,21,0,92,-92
6,73,49,35,770,881,-111
6,73,49,43,78,93,-15
6,73,49,49,392,468,-76
6,73,49,53,83,267,-184
6,73,49,57,74,151,-77
6,73,50,7,68,0,68
6,73,51,13,361,331,30
6,73,51,41,88,94,-6
6,73,51,59,1019,867,152
6,73,51,87,87,82,5
6,73,51,99,62,0,62
6,73,51,107,260,280,-20
6,73,51,153,651,641,10
6,73,51,177,56,92,-36
6,73,51,179,307,400,-93
6,73,51,510,218,222,-4
6,73,51,550,374,494,-120
6,73,51,650,116,134,-18
6,73,51,700,134,111,23
6,73,51,710,723,611,112
6,73,51,740,172,100,72
6,73,51,760,63,55,8
6,73,51,800,104,145,-41
6,73,51,810,1265,1556,-291
6,73,53,5,82,112,-30
6,73,53,9,55,120,-65
6,73,53,11,293,529,-236
6,73,53,15,0,80,-80
6,73,53,27,0,57,-57
6,73,53,29,423,524,-101
6,73,53,31,0,64,-64
6,73,53,33,2168,2572,-404
6,73,53,35,922,1088,-166
6,73,53,45,0,86,-86
6,73,53,53,575,943,-368
6,73,53,57,103,136,-33
6,73,53,61,676,784,-108
6,73,53,63,198,460,-262
6,73,53,67,195,277,-82
6,73,53,73,151,272,-121
6,73,53,77,83,116,-33
6,73,55,9,0,57,-57
6,73,55,25,257,178,79
6,73,55,59,57,0,57
6,73,55,79,252,193,59
6,73,55,127,48,0,48
6,73,55,133,124,104,20
6,75,4,13,515,511,4
6,75,4,19,141,130,11
6,75,6,1,8853,14474,-5621
6,75,6,7,138,75,63
6,75,6,13,4170,7514,-3344
6,75,6,17,100,248,-148
6,75,6,19,220,262,-42
6,75,6,23,72,48,24
6,75,6,29,107,87,20
6,75,6,33,0,65,-65
6,75,6,37,4650,5537,-887
6,75,6,41,2086,4776,-2690
6,75,6,45,0,119,-119
6,75,6,47,73,87,-14
6,75,6,53,278,272,6
6,75,6,55,242,373,-131
6,75,6,57,94,219,-125
6,75,6,59,1454,1209,245
6,75,6,61,201,407,-206
6,75,6,65,351,573,-222
6,75,6,67,1180,1732,-552
6,75,6,71,265,202,63
6,75,6,73,1639,1674,-35
6,75,6,77,472,549,-77
6,75,6,79,195,169,26
6,75,6,81,10363,13725,-3362
6,75,6,83,353,219,134
6,75,6,85,7571,5687,1884
6,75,6,87,374,470,-96
6,75,6,89,55,85,-30
6,75,6,95,807,1236,-429
6,75,6,97,986,1543,-557
6,75,6,99,193,229,-36
6,75,6,107,51,63,-12
6,75,6,111,237,225,12
6,75,6,113,302,255,47
6,75,8,5,68,93,-25
6,75,8,13,133,214,-81
6,75,8,31,336,771,-435
6,75,8,35,0,52,-52
6,75,8,41,0,64,-64
6,75,8,59,54,103,-49
6,75,8,69,44,0,44
6,75,9,1,236,149,87
6,75,9,3,78,0,78
6,75,9,9,129,76,53
6,75,11,1,915,438,477
6,75,12,1,43,0,43
6,75,12,11,172,124,48
6,75,12,21,0,48,-48
6,75,12,57,97,65,32
6,75,12,71,42,0,42
6,75,12,86,312,257,55
6,75,12,95,91,106,-15
6,75,12,99,134,110,24
6,75,12,103,74,100,-26
6,75,13,67,75,45,30
6,75,13,89,117,109,8
6,75,13,121,352,238,114
6,75,13,135,65,0,65
6,75,15,1,0,85,-85
6,75,15,3,289,301,-12
6,75,15,9,0,72,-72
6,75,16,1,0,75,-75
6,75,17,19,69,0,69
6,75,17,31,1767,1142,625
6,75,17,43,133,60,73
6,75,17,97,71,63,8
6,75,18,97,64,51,13
6,75,18,157,45,0,45
6,75,20,91,51,0,51
6,75,21,111,42,0,42
6,75,22,71,78,95,-17
6,75,23,5,0,58,-58
6,75,24,3,50,46,4
6,75,24,5,50,0,50
6,75,24,27,55,0,55
6,75,24,31,294,187,107
6,75,24,510,139,78,61
6,75,25,9,85,67,18
6,75,25,15,46,0,46
6,75,25,17,869,539,330
6,75,25,21,186,141,45
6,75,25,25,761,478,283
6,75,25,27,47,0,47
6,75,26,81,47,0,47
6,75,26,125,146,114,32
6,75,26,161,221,115,106
6,75,26,163,88,124,-36
6,75,27,53,248,249,-1
6,75,27,123,54,0,54
6,75,29,95,56,0,56
6,75,29,189,92,55,37
6,75,29,510,93,56,37
6,75,32,3,300,628,-328
6,75,32,31,196,295,-99
6,75,33,9,68,0,68
6,75,34,3,141,95,46
6,75,34,7,50,0,50
6,75,34,13,97,77,20
6,75,34,17,345,180,165
6,75,34,21,98,48,50
6,75,34,23,122,55,67
6,75,34,25,57,0,57
6,75,34,27,82,54,28
6,75,34,35,54,0,54
6,75,34,39,54,0,54
6,75,35,1,69,77,-8
6,75,35,49,0,91,-91
6,75,36,5,68,0,68
6,75,36,29,59,0,59
6,75,36,47,1396,1370,26
6,75,36,55,78,0,78
6,75,36,59,162,65,97
6,75,36,61,3148,3030,118
6,75,36,81,421,259,162
6,75,36,103,114,64,50
6,75,36,109,43,0,43
6,75,36,119,163,139,24
6,75,37,63,147,93,54
6,75,37,119,192,153,39
6,75,37,135,54,59,-5
6,75,37,183,197,111,86
6,75,39,35,94,95,-1
6,75,39,49,186,86,100
6,75,39,61,87,71,16
6,75,41,5,0,123,-123
6,75,41,17,0,83,-83
6,75,41,39,0,79,-79
6,75,41,51,497,1056,-559
6,75,41,67,117,133,-16
6,75,42,3,267,126,141
6,75,42,17,43,0,43
6,75,42,29,46,60,-14
6,75,42,45,57,0,57
6,75,42,91,56,50,6
6,75,42,101,408,333,75
6,75,44,7,71,0,71
6,75,45,19,60,63,-3
6,75,47,37,97,190,-93
6,75,47,157,52,0,52
6,75,48,29,98,81,17
6,75,48,85,109,126,-17
6,75,48,113,294,374,-80
6,75,48,157,55,0,55
6,75,48,201,385,317,68
6,75,48,439,88,99,-11
6,75,48,453,492,847,-355
6,75,49,35,186,192,-6
6,75,49,43,0,67,-67
6,75,49,49,70,0,70
6,75,51,13,196,92,104
6,75,51,59,279,141,138
6,75,51,510,44,45,-1
6,75,53,11,0,123,-123
6,75,53,33,1365,2057,-692
6,75,53,53,0,108,-108
6,75,53,61,67,102,-35
6,75,53,63,0,63,-63
6,75,53,73,0,55,-55
6,75,55,25,114,73,41
6,75,55,79,83,56,27
6,77,4,13,263,622,-359
6,77,4,15,0,66,-66
6,77,4,19,0,77,-77
6,77,4,21,0,80,-80
6,77,6,1,10955,4415,6540
6,77,6,5,190,261,-71
6,77,6,7,277,168,109
6,77,6,9,471,912,-441
6,77,6,13,3295,2023,1272
6,77,6,17,160,259,-99
6,77,6,19,538,633,-95
6,77,6,23,0,61,-61
6,77,6,29,277,254,23
6,77,6,31,74,0,74
6,77,6,37,1137,816,321
6,77,6,39,124,128,-4
6,77,6,41,86,0,86
6,77,6,45,0,59,-59
6,77,6,47,470,594,-124
6,77,6,53,252,246,6
6,77,6,55,85,76,9
6,77,6,57,0,79,-79
6,77,6,59,330,437,-107
6,77,6,61,300,421,-121
6,77,6,65,376,372,4
6,77,6,67,3745,4254,-509
6,77,6,69,80,0,80
6,77,6,71,281,343,-62
6,77,6,73,616,598,18
6,77,6,75,549,472,77
6,77,6,79,60,133,-73
6,77,6,81,1496,506,990
6,77,6,83,119,70,49
6,77,6,85,6619,2227,4392
6,77,6,87,200,184,16
6,77,6,89,82,155,-73
6,77,6,95,718,548,170
6,77,6,97,245,167,78
6,77,6,99,4596,5997,-1401
6,77,6,101,58,87,-29
6,77,6,107,201,195,6
6,77,6,109,128,196,-68
6,77,6,111,107,70,37
6,77,6,113,204,239,-35
6,77,6,115,74,101,-27
6,77,8,41,0,72,-72
6,77,15,3,155,112,43
6,77,16,1,0,209,-209
6,77,16,27,0,80,-80
6,77,17,31,86,67,19
6,77,32,3,319,601,-282
6,77,32,19,0,129,-129
6,77,32,31,238,289,-51
6,77,36,47,0,54,-54
6,77,41,39,0,57,-57
6,77,41,51,71,83,-12
6,77,41,67,0,117,-117
6,77,48,27,0,60,-60
6,77,48,29,63,108,-45
6,77,48,113,89,0,89
6,77,48,141,77,0,77
6,77,48,201,105,117,-12
6,77,48,439,84,92,-8
6,77,48,453,0,66,-66
6,77,48,491,0,93,-93
6,77,49,35,71,97,-26
6,77,53,11,0,96,-96
6,77,53,33,157,191,-34
6,77,53,35,0,62,-62
6,77,53,53,79,141,-62
6,77,53,61,80,120,-40
6,77,53,63,0,70,-70
6,79,4,13,238,387,-149
6,79,4,15,0,64,-64
6,79,4,19,55,118,-63
6,79,4,25,0,151,-151
6,79,6,1,302,229,73
6,79,6,7,124,119,5
6,79,6,13,240,144,96
6,79,6,17,81,133,-52
6,79,6,19,733,432,301
6,79,6,23,76,51,25
6,79,6,29,868,542,326
6,79,6,31,203,111,92
6,79,6,37,1661,998,663
6,79,6,39,74,77,-3
6,79,6,41,63,0,63
6,79,6,47,68,0,68
6,79,6,53,559,330,229
6,79,6,57,0,49,-49
6,79,6,59,726,377,349
6,79,6,61,139,158,-19
6,79,6,65,334,352,-18
6,79,6,67,260,287,-27
6,79,6,71,315,172,143
6,79,6,73,566,645,-79
6,79,6,75,169,195,-26
6,79,6,77,133,60,73
6,79,6,81,250,137,113
6,79,6,83,2345,2471,-126
6,79,6,85,688,334,354
6,79,6,87,195,170,25
6,79,6,89,0,53,-53
6,79,6,95,59,61,-2
6,79,6,97,168,129,39
6,79,6,99,146,52,94
6,79,6,107,518,314,204
6,79,6,111,506,331,175
6,79,6,113,59,60,-1
6,79,8,41,0,69,-69
6,79,16,1,0,128,-128
6,79,16,55,0,75,-75
6,79,32,3,161,322,-161
6,79,32,31,51,96,-45
6,79,41,17,52,73,-21
6,79,41,29,0,60,-60
6,79,41,39,0,88,-88
6,79,41,51,86,149,-63
6,79,41,67,53,68,-15
6,79,48,453,0,75,-75
6,79,49,35,0,57,-57
6,79,49,49,0,75,-75
6,79,53,33,151,140,11
6,79,53,53,0,59,-59
6,81,4,13,351,629,-278
6,81,4,19,70,123,-53
6,81,6,1,6222,9750,-3528
6,81,6,7,110,205,-95
6,81,6,9,0,97,-97
6,81,6,13,2392,5052,-2660
6,81,6,17,116,480,-364
6,81,6,19,212,264,-52
6,81,6,23,60,62,-2
6,81,6,29,129,106,23
6,81,6,33,0,67,-67
6,81,6,37,2762,2350,412
6,81,6,41,510,772,-262
6,81,6,45,0,84,-84
6,81,6,47,107,259,-152
6,81,6,53,247,358,-111
6,81,6,55,111,268,-157
6,81,6,57,49,213,-164
6,81,6,59,744,895,-151
6,81,6,61,236,1082,-846
6,81,6,65,236,401,-165
6,81,6,67,817,2265,-1448
6,81,6,69,0,101,-101
6,81,6,71,196,208,-12
6,81,6,73,1219,1393,-174
6,81,6,75,13725,10363,3362
6,81,6,77,506,1496,-990
6,81,6,79,137,250,-113
6,81,6,83,198,170,28
6,81,6,85,12230,11329,901
6,81,6,87,348,575,-227
6,81,6,89,0,106,-106
6,81,6,95,574,1281,-707
6,81,6,97,455,796,-341
6,81,6,99,330,951,-621
6,81,6,107,66,49,17
6,81,6,109,0,130,-130
6,81,6,111,182,176,6
6,81,6,113,214,236,-22
6,81,8,5,0,74,-74
6,81,8,13,53,149,-96
6,81,8,31,82,216,-134
6,81,8,35,0,74,-74
6,81,8,41,0,78,-78
6,81,8,59,0,123,-123
6,81,9,1,124,107,17
6,81,9,9,79,0,79
6,81,11,1,199,113,86
6,81,12,11,77,100,-23
6,81,12,31,0,48,-48
6,81,12,57,70,62,8
6,81,12,86,217,115,102
6,81,12,95,69,110,-41
6,81,12,99,55,80,-25
6,81,13,67,56,0,56
6,81,13,89,64,0,64
6,81,13,121,174,80,94
6,81,15,1,0,96,-96
6,81,15,3,250,188,62
6,81,16,1,58,130,-72
6,81,17,19,65,0,65
6,81,17,31,660,350,310
6,81,17,43,65,65,0
6,81,17,97,89,0,89
6,81,18,97,54,0,54
6,81,18,105,44,0,44
6,81,20,91,62,0,62
6,81,24,31,155,99,56
6,81,24,510,55,0,55
6,81,25,17,416,327,89
6,81,25,21,96,111,-15
6,81,25,25,198,96,102
6,81,26,125,64,56,8
6,81,26,161,124,61,63
6,81,27,53,124,78,46
6,81,29,189,78,0,78
6,81,32,3,331,801,-470
6,81,32,31,150,417,-267
6,81,34,3,97,0,97
6,81,34,13,65,0,65
6,81,34,17,189,72,117
6,81,34,21,57,0,57
6,81,34,23,70,0,70
6,81,36,47,286,186,100
6,81,36,59,63,0,63
6,81,36,61,660,493,167
6,81,36,81,198,58,140
6,81,36,103,61,0,61
6,81,36,119,85,65,20
6,81,37,63,100,51,49
6,81,37,119,50,97,-47
6,81,37,183,113,148,-35
6,81,39,35,44,0,44
6,81,39,49,73,55,18
6,81,41,5,0,124,-124
6,81,41,17,0,161,-161
6,81,41,29,0,113,-113
6,81,41,39,50,101,-51
6,81,41,47,0,65,-65
6,81,41,51,145,372,-227
6,81,41,67,93,200,-107
6,81,42,3,148,66,82
6,81,42,91,76,0,76
6,81,42,101,92,49,43
6,81,44,7,55,0,55
6,81,47,37,67,66,1
6,81,48,29,54,102,-48
6,81,48,85,77,103,-26
6,81,48,113,234,191,43
6,81,48,121,0,72,-72
6,81,48,201,223,238,-15
6,81,48,439,103,92,11
6,81,48,453,227,474,-247
6,81,48,491,0,154,-154
6,81,49,35,152,208,-56
6,81,49,49,58,91,-33
6,81,51,13,84,0,84
6,81,51,59,182,135,47
6,81,53,11,0,147,-147
6,81,53,33,712,1190,-478
6,81,53,35,0,71,-71
6,81,53,53,0,113,-113
6,81,53,61,61,132,-71
6,81,53,67,0,71,-71
6,81,55,25,81,0,81
6,81,55,79,50,0,50
6,83,4,13,278,464,-186
6,83,4,15,0,56,-56
6,83,4,19,98,131,-33
6,83,4,25,0,98,-98
6,83,6,1,279,340,-61
6,83,6,7,50,56,-6
6,83,6,13,218,171,47
6,83,6,17,47,68,-21
6,83,6,19,243,285,-42
6,83,6,23,0,58,-58
6,83,6,25,78,0,78
6,83,6,29,486,541,-55
6,83,6,37,2673,2465,208
6,83,6,39,66,61,5
6,83,6,41,79,65,14
6,83,6,53,210,301,-91
6,83,6,57,59,54,5
6,83,6,59,726,759,-33
6,83,6,61,111,106,5
6,83,6,65,419,447,-28
6,83,6,67,217,346,-129
6,83,6,71,346,324,22
6,83,6,73,820,1086,-266
6,83,6,75,219,353,-134
6,83,6,77,70,119,-49
6,83,6,79,2471,2345,126
6,83,6,81,170,198,-28
6,83,6,85,457,460,-3
6,83,6,87,136,164,-28
6,83,6,95,79,0,79
6,83,6,97,132,126,6
6,83,6,99,56,79,-23
6,83,6,107,110,181,-71
6,83,6,111,2074,2573,-499
6,83,6,113,58,69,-11
6,83,8,5,0,61,-61
6,83,8,13,66,78,-12
6,83,8,31,53,115,-62
6,83,8,41,185,376,-191
6,83,8,69,0,80,-80
6,83,11,1,59,63,-4
6,83,15,1,0,52,-52
6,83,15,3,143,130,13
6,83,15,9,0,56,-56
6,83,16,1,0,85,-85
6,83,17,31,174,113,61
6,83,25,17,93,79,14
6,83,30,13,0,89,-89
6,83,32,3,224,551,-327
6,83,32,31,68,95,-27
6,83,35,1,0,67,-67
6,83,36,47,69,71,-2
6,83,36,61,130,75,55
6,83,38,101,0,60,-60
6,83,41,17,0,108,-108
6,83,41,29,0,53,-53
6,83,41,39,0,55,-55
6,83,41,51,86,203,-117
6,83,41,67,0,122,-122
6,83,47,37,0,55,-55
6,83,48,29,94,214,-120
6,83,48,113,63,101,-38
6,83,48,201,113,83,30
6,83,48,439,0,74,-74
6,83,48,453,69,154,-85
6,83,49,35,0,75,-75
6,83,51,59,58,75,-17
6,83,53,11,0,63,-63
6,83,53,33,210,343,-133
6,83,53,53,0,70,-70
6,83,53,61,0,119,-119
6,83,53,63,0,54,-54
6,83,56,21,0,87,-87
6,85,1,89,63,0,63
6,85,2,20,67,0,67
6,85,4,13,1458,2130,-672
6,85,4,19,285,291,-6
6,85,4,21,0,118,-118
6,85,4,25,0,136,-136
6,85,4,27,52,0,52
6,85,5,7,86,74,12
6,85,6,1,12888,20617,-7729
6,85,6,5,0,106,-106
6,85,6,7,297,384,-87
6,85,6,9,84,201,-117
6,85,6,13,2784,4808,-2024
6,85,6,17,189,1251,-1062
6,85,6,19,748,1352,-604
6,85,6,23,82,151,-69
6,85,6,29,300,337,-37
6,85,6,31,62,80,-18
6,85,6,33,69,90,-21
6,85,6,37,6184,4903,1281
6,85,6,39,122,469,-347
6,85,6,41,397,494,-97
6,85,6,43,0,73,-73
6,85,6,45,66,118,-52
6,85,6,47,1260,3194,-1934
6,85,6,53,1558,2073,-515
6,85,6,55,133,233,-100
6,85,6,57,107,438,-331
6,85,6,59,2388,2436,-48
6,85,6,61,507,2558,-2051
6,85,6,65,602,1065,-463
6,85,6,67,2090,5034,-2944
6,85,6,69,1357,3520,-2163
6,85,6,71,501,587,-86
6,85,6,73,3098,3356,-258
6,85,6,75,5687,7571,-1884
6,85,6,77,2227,6619,-4392
6,85,6,79,334,688,-354
6,85,6,81,11329,12230,-901
6,85,6,83,460,457,3
6,85,6,87,2170,3543,-1373
6,85,6,89,94,250,-156
6,85,6,95,633,938,-305
6,85,6,97,602,757,-155
6,85,6,99,1355,3275,-1920
6,85,6,101,74,140,-66
6,85,6,103,0,110,-110
6,85,6,107,210,320,-110
6,85,6,109,77,239,-162
6,85,6,111,511,411,100
6,85,6,113,486,475,11
6,85,6,115,0,80,-80
6,85,8,1,50,147,-97
6,85,8,5,104,269,-165
6,85,8,13,226,412,-186
6,85,8,14,0,93,-93
6,85,8,31,160,323,-163
6,85,8,35,109,299,-190
6,85,8,41,203,278,-75
6,85,8,59,73,221,-148
6,85,8,69,82,156,-74
6,85,8,123,0,70,-70
6,85,9,1,194,109,85
6,85,9,3,111,0,111
6,85,9,9,184,86,98
6,85,10,3,102,50,52
6,85,11,1,320,257,63
6,85,12,1,149,0,149
6,85,12,9,69,104,-35
6,85,12,11,223,296,-73
6,85,12,21,0,54,-54
6,85,12,31,74,86,-12
6,85,12,57,169,139,30
6,85,12,71,74,59,15
6,85,12,86,294,233,61
6,85,12,95,184,218,-34
6,85,12,99,183,169,14
6,85,12,103,82,141,-59
6,85,12,115,0,72,-72
6,85,12,117,61,0,61
6,85,13,67,178,139,39
6,85,13,89,202,144,58
6,85,13,121,491,332,159
6,85,13,135,110,168,-58
6,85,15,1,47,103,-56
6,85,15,3,383,420,-37
6,85,15,9,0,154,-154
6,85,16,1,190,657,-467
6,85,16,27,0,158,-158
6,85,16,55,0,107,-107
6,85,17,19,321,46,275
6,85,17,31,1492,844,648
6,85,17,43,224,182,42
6,85,17,97,185,152,33
6,85,18,57,62,0,62
6,85,18,97,95,83,12
6,85,18,105,115,0,115
6,85,18,141,65,0,65
6,85,18,157,199,0,199
6,85,19,169,44,0,44
6,85,20,91,118,60,58
6,85,20,173,53,0,53
6,85,21,67,49,0,49
6,85,21,111,71,0,71
6,85,22,71,77,49,28
6,85,24,3,61,0,61
6,85,24,5,121,0,121
6,85,24,27,85,72,13
6,85,24,31,357,222,135
6,85,24,33,171,0,171
6,85,24,510,151,77,74
6,85,25,9,131,83,48
6,85,25,15,76,0,76
6,85,25,17,1240,689,551
6,85,25,21,209,92,117
6,85,25,25,535,248,287
6,85,25,27,146,89,57
6,85,26,65,86,0,86
6,85,26,81,52,0,52
6,85,26,99,77,0,77
6,85,26,125,448,254,194
6,85,26,161,412,152,260
6,85,26,163,202,99,103
6,85,27,37,0,57,-57
6,85,27,53,433,229,204
6,85,27,123,98,72,26
6,85,29,95,74,84,-10
6,85,29,189,169,101,68
6,85,29,510,79,58,21
6,85,31,55,143,79,64
6,85,32,3,769,1885,-1116
6,85,32,5,0,156,-156
6,85,32,19,0,110,-110
6,85,32,31,320,1088,-768
6,85,32,510,0,82,-82
6,85,33,9,45,0,45
6,85,33,11,61,0,61
6,85,34,3,225,109,116
6,85,34,13,126,61,65
6,85,34,17,580,294,286
6,85,34,21,130,114,16
6,85,34,23,360,185,175
6,85,34,25,94,0,94
6,85,34,27,104,62,42
6,85,34,35,182,67,115
6,85,34,39,62,0,62
6,85,35,1,126,177,-51
6,85,36,1,56,0,56
6,85,36,5,65,0,65
6,85,36,29,102,45,57
6,85,36,47,582,378,204
6,85,36,55,213,0,213
6,85,36,59,178,74,104
6,85,36,61,1156,1021,135
6,85,36,67,95,0,95
6,85,36,81,397,203,194
6,85,36,91,117,0,117
6,85,36,103,179,0,179
6,85,36,109,136,0,136
6,85,36,119,206,145,61
6,85,37,63,206,102,104
6,85,37,81,57,0,57
6,85,37,119,252,235,17
6,85,37,133,0,61,-61
6,85,37,135,59,64,-5
6,85,37,183,564,546,18
6,85,39,35,189,99,90
6,85,39,49,281,123,158
6,85,39,61,133,74,59
6,85,39,113,0,59,-59
6,85,40,109,0,73,-73
6,85,40,143,57,0,57
6,85,41,3,99,61,38
6,85,41,5,144,380,-236
6,85,41,17,47,298,-251
6,85,41,19,0,56,-56
6,85,41,29,61,279,-218
6,85,41,33,0,92,-92
6,85,41,39,108,253,-145
6,85,41,43,0,57,-57
6,85,41,47,0,116,-116
6,85,41,51,407,727,-320
6,85,41,67,699,939,-240
6,85,41,71,0,59,-59
6,85,42,3,635,231,404
6,85,42,27,100,0,100
6,85,42,29,79,59,20
6,85,42,45,0,69,-69
6,85,42,91,145,93,52
6,85,42,101,370,159,211
6,85,44,7,154,59,95
6,85,45,45,67,0,67
6,85,47,37,98,157,-59
6,85,47,93,56,0,56
6,85,47,157,97,92,5
6,85,48,27,0,65,-65
6,85,48,29,285,274,11
6,85,48,41,152,0,152
6,85,48,85,544,733,-189
6,85,48,113,575,587,-12
6,85,48,121,167,264,-97
6,85,48,141,91,77,14
6,85,48,157,148,169,-21
6,85,48,201,826,782,44
6,85,48,209,0,84,-84
6,85,48,339,0,77,-77
6,85,48,439,268,315,-47
6,85,48,453,856,1591,-735
6,85,48,491,265,825,-560
6,85,49,11,0,96,-96
6,85,49,35,340,451,-111
6,85,49,49,222,257,-35
6,85,51,13,148,114,34
6,85,51,59,434,295,139
6,85,51,87,57,0,57
6,85,51,107,144,114,30
6,85,51,121,118,0,118
6,85,51,510,70,0,70
6,85,53,11,139,476,-337
6,85,53,33,2320,3592,-1272
6,85,53,35,0,140,-140
6,85,53,53,148,304,-156
6,85,53,61,209,378,-169
6,85,53,63,93,138,-45
6,85,53,67,0,80,-80
6,85,53,73,0,90,-90
6,85,55,25,328,98,230
6,85,55,79,128,70,58
6,87,4,13,109,204,-95
6,87,4,19,48,53,-5
6,87,6,1,669,614,55
6,87,6,7,91,138,-47
6,87,6,9,0,52,-52
6,87,6,13,286,300,-14
6,87,6,17,58,237,-179
6,87,6,19,147,233,-86
6,87,6,23,59,85,-26
6,87,6,29,87,115,-28
6,87,6,37,606,626,-20
6,87,6,41,119,111,8
6,87,6,45,59,68,-9
6,87,6,47,116,318,-202
6,87,6,53,2033,2645,-612
6,87,6,57,59,116,-57
6,87,6,59,231,197,34
6,87,6,61,107,239,-132
6,87,6,65,133,159,-26
6,87,6,67,298,465,-167
6,87,6,69,305,405,-100
6,87,6,71,83,90,-7
6,87,6,73,365,420,-55
6,87,6,75,470,374,96
6,87,6,77,184,200,-16
6,87,6,79,170,195,-25
6,87,6,81,575,348,227
6,87,6,83,164,136,28
6,87,6,85,3543,2170,1373
6,87,6,89,0,66,-66
6,87,6,95,81,73,8
6,87,6,97,191,180,11
6,87,6,99,159,143,16
6,87,6,107,0,68,-68
6,87,6,109,0,68,-68
6,87,6,111,178,155,23
6,87,6,113,98,101,-3
6,87,8,13,0,65,-65
6,87,15,3,69,0,69
6,87,15,9,0,74,-74
6,87,16,1,0,86,-86
6,87,17,31,94,0,94
6,87,32,3,67,157,-90
6,87,32,31,0,185,-185
6,87,36,47,53,52,1
6,87,36,61,76,43,33
6,87,41,17,0,97,-97
6,87,41,29,0,98,-98
6,87,41,39,0,77,-77
6,87,41,51,93,182,-89
6,87,41,67,0,82,-82
6,87,48,453,0,81,-81
6,87,53,11,0,65,-65
6,87,53,33,154,199,-45
6,87,53,53,0,58,-58
6,87,53,73,0,61,-61
6,89,4,13,91,158,-67
6,89,6,1,211,92,119
6,89,6,7,750,401,349
6,89,6,13,275,160,115
6,89,6,17,80,65,15
6,89,6,19,66,71,-5
6,89,6,23,342,257,85
6,89,6,29,70,0,70
6,89,6,33,81,0,81
6,89,6,35,94,90,4
6,89,6,37,348,200,148
6,89,6,45,73,0,73
6,89,6,49,84,0,84
6,89,6,53,103,0,103
6,89,6,55,72,0,72
6,89,6,59,215,199,16
6,89,6,61,112,170,-58
6,89,6,65,169,85,84
6,89,6,67,508,502,6
6,89,6,71,79,86,-7
6,89,6,73,241,206,35
6,89,6,75,85,55,30
6,89,6,77,155,82,73
6,89,6,79,53,0,53
6,89,6,81,106,0,106
6,89,6,85,250,94,156
6,89,6,87,66,0,66
6,89,6,93,251,333,-82
6,89,6,95,186,94,92
6,89,6,97,268,102,166
6,89,6,99,114,0,114
6,89,6,101,73,0,73
6,89,6,103,1010,1203,-193
6,89,6,105,145,164,-19
6,89,6,111,85,73,12
6,89,6,113,92,53,39
6,89,16,1,0,166,-166
6,89,16,27,0,76,-76
6,89,16,55,0,58,-58
6,89,32,3,76,73,3
6,89,32,31,83,167,-84
6,89,41,11,0,69,-69
6,89,41,17,0,61,-61
6,89,41,19,0,52,-52
6,89,41,29,85,144,-59
6,89,41,33,0,67,-67
6,89,41,35,60,95,-35
6,89,41,39,82,102,-20
6,89,41,51,0,69,-69
6,89,41,67,53,45,8
6,89,53,11,0,64,-64
6,89,53,33,0,85,-85
6,91,32,31,0,77,-77
6,93,6,1,61,0,61
6,93,6,7,64,80,-16
6,93,6,13,55,0,55
6,93,6,23,86,0,86
6,93,6,37,102,0,102
6,93,6,65,64,0,64
6,93,6,67,82,140,-58
6,93,6,73,78,0,78
6,93,6,89,333,251,82
6,93,6,97,92,0,92
6,93,41,29,145,231,-86
6,93,41,35,134,179,-45
6,95,2,20,105,86,19
6,95,4,13,236,428,-192
6,95,4,19,121,134,-13
6,95,4,21,0,112,-112
6,95,6,1,3273,1866,1407
6,95,6,7,202,204,-2
6,95,6,9,0,84,-84
6,95,6,11,0,87,-87
6,95,6,13,6636,3878,2758
6,95,6,17,120,303,-183
6,95,6,19,173,220,-47
6,95,6,23,62,65,-3
6,95,6,29,130,130,0
6,95,6,33,82,98,-16
6,95,6,37,822,675,147
6,95,6,39,0,79,-79
6,95,6,41,654,451,203
6,95,6,45,0,63,-63
6,95,6,47,67,67,0
6,95,6,53,145,144,1
6,95,6,55,2660,2184,476
6,95,6,57,0,95,-95
6,95,6,59,261,264,-3
6,95,6,61,331,538,-207
6,95,6,65,221,300,-79
6,95,6,67,2400,3911,-1511
6,95,6,71,253,171,82
6,95,6,73,485,466,19
6,95,6,75,1236,807,429
6,95,6,77,548,718,-170
6,95,6,79,61,59,2
6,95,6,81,1281,574,707
6,95,6,83,0,79,-79
6,95,6,85,938,633,305
6,95,6,87,73,81,-8
6,95,6,89,94,186,-92
6,95,6,97,1090,603,487
6,95,6,99,224,221,3
6,95,6,101,104,113,-9
6,95,6,103,0,102,-102
6,95,6,107,88,61,27
6,95,6,111,103,70,33
6,95,6,113,1222,1338,-116
6,95,6,115,79,124,-45
6,95,8,5,0,53,-53
6,95,8,41,73,131,-58
6,95,12,11,57,0,57
6,95,12,57,75,0,75
6,95,12,91,0,60,-60
6,95,15,3,149,160,-11
6,95,16,1,0,119,-119
6,95,16,55,0,62,-62
6,95,17,31,91,52,39
6,95,17,163,0,104,-104
6,95,28,47,65,0,65
6,95,32,3,348,589,-241
6,95,32,31,96,343,-247
6,95,34,5,0,76,-76
6,95,41,17,0,58,-58
6,95,41,29,0,78,-78
6,95,41,51,0,63,-63
6,95,41,67,0,76,-76
6,95,48,29,284,244,40
6,95,48,85,0,63,-63
6,95,48,113,0,73,-73
6,95,48,141,0,59,-59
6,95,48,201,131,135,-4
6,95,48,439,67,112,-45
6,95,48,453,0,79,-79
6,95,49,35,0,84,-84
6,95,51,59,0,71,-71
6,95,53,11,0,58,-58
6,95,53,33,73,185,-112
6,95,53,35,0,78,-78
6,95,53,53,120,128,-8
6,95,53,61,58,53,5
6,95,53,63,0,107,-107
6,97,4,13,170,518,-348
6,97,4,19,0,148,-148
6,97,4,25,0,86,-86
6,97,6,1,1150,1022,128
6,97,6,7,240,251,-11
6,97,6,9,0,54,-54
6,97,6,13,1014,843,171
6,97,6,17,113,326,-213
6,97,6,19,178,190,-12
6,97,6,23,193,196,-3
6,97,6,29,121,157,-36
6,97,6,33,459,1258,-799
6,97,6,37,969,840,129
6,97,6,41,2881,2042,839
6,97,6,45,652,966,-314
6,97,6,47,79,0,79
6,97,6,53,187,151,36
6,97,6,55,746,937,-191
6,97,6,57,92,257,-165
6,97,6,59,388,360,28
6,97,6,61,210,624,-414
6,97,6,65,243,355,-112
6,97,6,67,587,1269,-682
6,97,6,71,134,135,-1
6,97,6,73,498,641,-143
6,97,6,75,1543,986,557
6,97,6,77,167,245,-78
6,97,6,79,129,168,-39
6,97,6,81,796,455,341
6,97,6,83,126,132,-6
6,97,6,85,757,602,155
6,97,6,87,180,191,-11
6,97,6,89,102,268,-166
6,97,6,93,0,92,-92
6,97,6,95,603,1090,-487
6,97,6,99,132,169,-37
6,97,6,103,0,83,-83
6,97,6,111,94,160,-66
6,97,6,113,183,198,-15
6,97,6,115,0,68,-68
6,97,8,5,0,47,-47
6,97,8,13,43,69,-26
6,97,8,31,54,58,-4
6,97,8,41,0,123,-123
6,97,8,69,0,62,-62
6,97,12,11,0,68,-68
6,97,12,86,55,0,55
6,97,15,1,63,108,-45
6,97,15,3,87,82,5
6,97,16,1,0,285,-285
6,97,16,27,0,127,-127
6,97,16,55,0,78,-78
6,97,17,31,100,87,13
6,97,25,17,57,0,57
6,97,27,53,0,61,-61
6,97,32,3,175,313,-138
6,97,32,19,0,68,-68
6,97,32,31,109,377,-268
6,97,35,1,0,51,-51
6,97,36,47,65,65,0
6,97,36,61,94,68,26
6,97,41,5,0,65,-65
6,97,41,17,62,181,-119
6,97,41,29,55,197,-142
6,97,41,33,0,86,-86
6,97,41,39,72,138,-66
6,97,41,47,0,91,-91
6,97,41,51,121,301,-180
6,97,41,67,52,129,-77
6,97,48,29,0,53,-53
6,97,48,85,0,61,-61
6,97,48,113,0,60,-60
6,97,48,201,60,85,-25
6,97,48,439,0,54,-54
6,97,48,453,0,126,-126
6,97,49,35,0,90,-90
6,97,53,11,0,117,-117
6,97,53,33,190,259,-69
6,97,53,53,0,121,-121
6,97,53,61,0,86,-86
6,97,53,63,0,112,-112
6,97,53,67,0,63,-63
6,99,4,13,171,422,-251
6,99,4,15,0,82,-82
6,99,4,19,0,108,-108
6,99,6,1,3099,1238,1861
6,99,6,5,0,81,-81
6,99,6,7,125,105,20
6,99,6,9,159,330,-171
6,99,6,13,959,495,464
6,99,6,17,52,117,-65
6,99,6,19,601,679,-78
6,99,6,23,72,96,-24
6,99,6,29,219,235,-16
6,99,6,31,67,83,-16
6,99,6,37,775,597,178
6,99,6,39,167,200,-33
6,99,6,41,0,86,-86
6,99,6,43,101,165,-64
6,99,6,47,2742,3603,-861
6,99,6,53,281,237,44
6,99,6,55,0,71,-71
6,99,6,59,217,251,-34
6,99,6,61,154,232,-78
6,99,6,65,262,233,29
6,99,6,67,777,1235,-458
6,99,6,69,123,88,35
6,99,6,71,220,227,-7
6,99,6,73,400,558,-158
6,99,6,75,229,193,36
6,99,6,77,5997,4596,1401
6,99,6,79,52,146,-94
6,99,6,81,951,330,621
6,99,6,83,79,56,23
6,99,6,85,3275,1355,1920
6,99,6,87,143,159,-16
6,99,6,89,0,114,-114
6,99,6,95,221,224,-3
6,99,6,97,169,132,37
6,99,6,107,188,163,25
6,99,6,109,382,513,-131
6,99,6,111,80,65,15
6,99,6,113,81,123,-42
6,99,15,3,89,80,9
6,99,16,1,0,167,-167
6,99,16,27,0,167,-167
6,99,17,31,78,67,11
6,99,32,3,242,351,-109
6,99,32,19,0,65,-65
6,99,32,31,146,230,-84
6,99,41,29,0,54,-54
6,99,41,39,0,77,-77
6,99,41,51,0,54,-54
6,99,48,29,0,76,-76
6,99,48,113,0,58,-58
6,99,48,201,95,84,11
6,99,48,439,0,107,-107
6,99,53,11,0,72,-72
6,99,53,33,71,81,-10
6,99,53,53,0,83,-83
6,99,53,63,0,61,-61
6,101,6,1,95,90,5
6,101,6,7,812,684,128
6,101,6,11,158,127,31
6,101,6,13,83,75,8
6,101,6,19,0,79,-79
6,101,6,37,107,72,35
6,101,6,57,84,58,26
6,101,6,61,335,375,-40
6,101,6,67,1025,793,232
6,101,6,73,0,85,-85
6,101,6,77,87,58,29
6,101,6,85,140,74,66
6,101,6,89,0,73,-73
6,101,6,95,113,104,9
6,101,6,113,240,167,73
6,101,6,115,2161,2097,64
6,101,32,3,0,74,-74
6,101,32,31,0,106,-106
6,103,6,1,71,0,71
6,103,6,7,984,524,460
6,103,6,13,110,0,110
6,103,6,21,356,215,141
6,103,6,23,0,58,-58
6,103,6,37,88,0,88
6,103,6,67,182,166,16
6,103,6,85,110,0,110
6,103,6,89,1203,1010,193
6,103,6,95,102,0,102
6,103,6,97,83,0,83
6,105,6,23,91,78,13
6,105,6,89,164,145,19
6,107,4,13,169,251,-82
6,107,6,1,304,160,144
6,107,6,7,61,0,61
6,107,6,13,173,91,82
6,107,6,19,3190,3328,-138
6,107,6,29,1778,1950,-172
6,107,6,31,1330,1158,172
6,107,6,37,1553,862,691
6,107,6,39,126,156,-30
6,107,6,47,132,109,23
6,107,6,53,314,161,153
6,107,6,59,432,264,168
6,107,6,61,0,89,-89
6,107,6,65,301,291,10
6,107,6,67,289,272,17
6,107,6,71,363,356,7
6,107,6,73,424,423,1
6,107,6,75,63,51,12
6,107,6,77,195,201,-6
6,107,6,79,314,518,-204
6,107,6,81,49,66,-17
6,107,6,83,181,110,71
6,107,6,85,320,210,110
6,107,6,87,68,0,68
6,107,6,95,61,88,-27
6,107,6,99,163,188,-25
6,107,6,111,315,166,149
6,107,6,113,0,63,-63
6,107,8,41,0,81,-81
6,107,16,1,0,73,-73
6,107,16,27,0,76,-76
6,107,32,3,175,279,-104
6,107,32,31,0,94,-94
6,107,48,453,167,0,167
6,107,53,33,71,57,14
6,107,53,53,0,90,-90
6,109,4,13,0,49,-49
6,109,6,1,298,62,236
6,109,6,9,286,183,103
6,109,6,13,168,92,76
6,109,6,37,103,65,38
6,109,6,43,101,70,31
6,109,6,47,80,76,4
6,109,6,67,88,149,-61
6,109,6,77,196,128,68
6,109,6,81,130,0,130
6,109,6,85,239,77,162
6,109,6,87,68,0,68
6,109,6,99,513,382,131
6,111,4,13,551,1366,-815
6,111,4,15,0,210,-210
6,111,4,19,118,219,-101
6,111,4,21,0,78,-78
6,111,4,25,79,261,-182
6,111,4,27,0,49,-49
6,111,6,1,369,413,-44
6,111,6,7,95,138,-43
6,111,6,13,241,248,-7
6,111,6,17,0,104,-104
6,111,6,19,287,383,-96
6,111,6,23,0,68,-68
6,111,6,25,0,81,-81
6,111,6,29,912,1555,-643
6,111,6,31,83,87,-4
6,111,6,37,18161,11519,6642
6,111,6,39,0,80,-80
6,111,6,41,72,58,14
6,111,6,53,374,565,-191
6,111,6,55,58,0,58
6,111,6,57,0,80,-80
6,111,6,59,1333,1405,-72
6,111,6,61,82,197,-115
6,111,6,65,849,1156,-307
6,111,6,67,273,376,-103
6,111,6,71,786,846,-60
6,111,6,73,1628,1946,-318
6,111,6,75,225,237,-12
6,111,6,77,70,107,-37
6,111,6,79,331,506,-175
6,111,6,81,176,182,-6
6,111,6,83,2573,2074,499
6,111,6,85,411,511,-100
6,111,6,87,155,178,-23
6,111,6,89,73,85,-12
6,111,6,95,70,103,-33
6,111,6,97,160,94,66
6,111,6,99,65,80,-15
6,111,6,107,166,315,-149
6,111,6,113,51,80,-29
6,111,8,5,74,114,-40
6,111,8,13,65,74,-9
6,111,8,31,80,99,-19
6,111,8,35,0,129,-129
6,111,8,41,85,168,-83
6,111,8,59,68,85,-17
6,111,8,69,0,97,-97
6,111,11,1,49,63,-14
6,111,12,11,70,67,3
6,111,12,31,81,88,-7
6,111,12,57,0,302,-302
6,111,12,86,55,0,55
6,111,12,95,69,0,69
6,111,12,99,68,75,-7
6,111,12,103,0,65,-65
6,111,13,121,0,66,-66
6,111,15,1,0,60,-60
6,111,15,3,263,216,47
6,111,16,1,73,271,-198
6,111,16,55,0,96,-96
6,111,17,31,222,208,14
6,111,17,97,74,67,7
6,111,24,31,0,61,-61
6,111,25,17,97,209,-112
6,111,26,125,0,69,-69
6,111,27,53,0,84,-84
6,111,28,47,54,0,54
6,111,32,3,549,1321,-772
6,111,32,31,145,267,-122
6,111,34,3,63,0,63
6,111,35,1,81,71,10
6,111,36,47,72,55,17
6,111,36,61,118,159,-41
6,111,36,81,72,0,72
6,111,36,119,77,0,77
6,111,37,119,0,101,-101
6,111,37,183,0,72,-72
6,111,39,49,54,0,54
6,111,41,5,0,121,-121
6,111,41,17,0,151,-151
6,111,41,29,55,72,-17
6,111,41,33,0,62,-62
6,111,41,39,0,140,-140
6,111,41,47,0,146,-146
6,111,41,51,145,176,-31
6,111,41,67,72,161,-89
6,111,47,37,0,60,-60
6,111,47,187,0,95,-95
6,111,48,29,73,134,-61
6,111,48,85,81,239,-158
6,111,48,113,70,222,-152
6,111,48,121,0,145,-145
6,111,48,141,65,63,2
6,111,48,201,159,187,-28
6,111,48,339,0,71,-71
6,111,48,439,135,240,-105
6,111,48,453,113,209,-96
6,111,48,491,0,192,-192
6,111,49,11,0,74,-74
6,111,49,35,151,189,-38
6,111,49,49,68,158,-90
6,111,49,53,0,61,-61
6,111,51,59,89,117,-28
6,111,51,550,0,93,-93
6,111,51,710,81,56,25
6,111,51,810,150,166,-16
6,111,53,11,0,126,-126
6,111,53,29,75,100,-25
6,111,53,33,291,457,-166
6,111,53,35,61,147,-86
6,111,53,53,104,165,-61
6,111,53,61,120,118,2
6,111,53,63,53,114,-61
6,113,4,13,74,111,-37
6,113,6,1,584,600,-16
6,113,6,5,0,67,-67
6,113,6,7,212,164,48
6,113,6,11,149,197,-48
6,113,6,13,505,417,88
6,113,6,17,159,186,-27
6,113,6,19,152,104,48
6,113,6,23,0,55,-55
6,113,6,29,101,74,27
6,113,6,37,511,446,65
6,113,6,41,95,67,28
6,113,6,53,100,88,12
6,113,6,55,141,98,43
6,113,6,57,48,80,-32
6,113,6,59,196,215,-19
6,113,6,61,381,642,-261
6,113,6,65,117,115,2
6,113,6,67,5226,6273,-1047
6,113,6,71,101,81,20
6,113,6,73,259,240,19
6,113,6,75,255,302,-47
6,113,6,77,239,204,35
6,113,6,79,60,59,1
6,113,6,81,236,214,22
6,113,6,83,69,58,11
6,113,6,85,475,486,-11
6,113,6,87,101,98,3
6,113,6,89,53,92,-39
6,113,6,95,1338,1222,116
6,113,6,97,198,183,15
6,113,6,99,123,81,42
6,113,6,101,167,240,-73
6,113,6,107,63,0,63
6,113,6,111,80,51,29
6,113,6,115,62,150,-88
6,113,17,31,55,0,55
6,113,32,3,0,95,-95
6,113,32,31,69,138,-69
6,113,36,61,53,45,8
6,113,41,51,0,68,-68
6,113,53,33,91,181,-90
6,115,4,13,0,65,-65
6,115,6,1,108,0,108
6,115,6,7,405,386,19
6,115,6,13,98,0,98
6,115,6,17,77,0,77
6,115,6,37,105,73,32
6,115,6,57,220,263,-43
6,115,6,61,954,611,343
6,115,6,65,55,0,55
6,115,6,67,1725,1002,723
6,115,6,73,62,74,-12
6,115,6,77,101,74,27
6,115,6,85,80,0,80
6,115,6,95,124,79,45
6,115,6,97,68,0,68
6,115,6,101,2097,2161,-64
6,115,6,113,150,62,88
6,115,32,3,0,77,-77
6,115,32,31,0,59,-59
6,115,48,29,0,82,-82
8,1,4,13,591,829,-238
8,1,4,15,73,64,9
8,1,4,19,78,156,-78
8,1,4,21,0,129,-129
8,1,6,1,71,50,21
8,1,6,37,488,267,221
8,1,6,59,204,133,71
8,1,6,65,143,113,30
8,1,6,67,76,0,76
8,1,6,71,156,104,52
8,1,6,73,317,238,79
8,1,6,85,147,50,97
8,1,8,5,8335,8212,123
8,1,8,13,2415,1982,433
8,1,8,14,3211,2512,699
8,1,8,19,0,70,-70
8,1,8,31,13553,9840,3713
8,1,8,35,1065,1265,-200
8,1,8,37,91,106,-15
8,1,8,39,82,239,-157
8,1,8,41,800,1174,-374
8,1,8,43,0,94,-94
8,1,8,45,74,130,-56
8,1,8,47,61,61,0
8,1,8,59,9877,8202,1675
8,1,8,69,955,1032,-77
8,1,8,75,80,109,-29
8,1,8,77,310,233,77
8,1,8,85,68,0,68
8,1,8,87,137,302,-165
8,1,8,93,63,148,-85
8,1,8,101,252,341,-89
8,1,8,117,107,0,107
8,1,8,123,3110,5320,-2210
8,1,12,11,91,62,29
8,1,12,57,97,128,-31
8,1,12,71,0,82,-82
8,1,12,86,112,74,38
8,1,12,95,98,87,11
8,1,12,99,55,0,55
8,1,12,103,70,57,13
8,1,13,135,65,0,65
8,1,15,3,126,72,54
8,1,16,1,63,105,-42
8,1,17,31,248,113,135
8,1,17,43,53,0,53
8,1,17,111,60,0,60
8,1,18,97,0,65,-65
8,1,19,153,0,69,-69
8,1,20,91,87,90,-3
8,1,20,173,102,96,6
8,1,26,125,49,0,49
8,1,27,53,86,82,4
8,1,29,95,51,84,-33
8,1,29,189,54,0,54
8,1,31,55,103,105,-2
8,1,31,109,92,84,8
8,1,32,3,302,423,-121
8,1,35,1,232,190,42
8,1,35,43,0,90,-90
8,1,36,103,47,0,47
8,1,37,183,55,0,55
8,1,39,35,71,0,71
8,1,39,49,53,55,-2
8,1,40,17,0,67,-67
8,1,40,109,80,120,-40
8,1,40,143,0,102,-102
8,1,41,39,57,0,57
8,1,41,51,46,51,-5
8,1,41,67,80,0,80
8,1,46,103,0,67,-67
8,1,47,37,49,54,-5
8,1,48,29,147,215,-68
8,1,48,85,83,100,-17
8,1,48,113,129,137,-8
8,1,48,121,142,89,53
8,1,48,141,308,382,-74
8,1,48,201,292,238,54
8,1,48,339,66,0,66
8,1,48,439,154,132,22
8,1,48,453,119,101,18
8,1,48,491,0,76,-76
8,1,49,35,155,115,40
8,1,51,59,56,0,56
8,1,53,33,96,137,-41
8,1,53,53,66,0,66
8,1,53,61,74,50,24
8,1,56,1,46,0,46
8,1,56,21,106,163,-57
8,1,56,25,72,0,72
8,3,8,21,238,131,107
8,3,8,23,61,0,61
8,3,8,41,86,80,6
8,3,8,101,64,0,64
8,3,8,105,199,173,26
8,3,8,109,79,0,79
8,5,2,20,93,65,28
8,5,4,13,985,1281,-296
8,5,4,15,0,57,-57
8,5,4,19,268,281,-13
8,5,4,21,50,150,-100
8,5,5,7,0,58,-58
8,5,6,1,182,136,46
8,5,6,13,130,84,46
8,5,6,29,64,0,64
8,5,6,37,941,673,268
8,5,6,59,424,283,141
8,5,6,65,248,184,64
8,5,6,67,118,103,15
8,5,6,71,202,182,20
8,5,6,73,538,494,44
8,5,6,75,93,68,25
8,5,6,81,74,0,74
8,5,6,83,61,0,61
8,5,6,85,269,104,165
8,5,6,95,53,0,53
8,5,6,97,47,0,47
8,5,6,111,114,74,40
8,5,8,1,8212,8335,-123
8,5,8,13,757,785,-28
8,5,8,14,418,421,-3
8,5,8,15,0,65,-65
8,5,8,19,0,81,-81
8,5,8,29,0,69,-69
8,5,8,31,25536,22255,3281
8,5,8,35,7639,10691,-3052
8,5,8,37,142,127,15
8,5,8,39,422,656,-234
8,5,8,41,1750,2575,-825
8,5,8,43,52,100,-48
8,5,8,45,104,58,46
8,5,8,49,0,73,-73
8,5,8,59,6697,6728,-31
8,5,8,67,73,68,5
8,5,8,69,808,884,-76
8,5,8,77,296,266,30
8,5,8,85,0,102,-102
8,5,8,87,97,100,-3
8,5,8,93,103,165,-62
8,5,8,101,293,322,-29
8,5,8,107,67,76,-9
8,5,8,117,103,130,-27
8,5,8,119,0,86,-86
8,5,8,123,701,1074,-373
8,5,9,1,66,0,66
8,5,9,3,62,0,62
8,5,11,1,85,76,9
8,5,12,9,103,121,-18
8,5,12,11,228,169,59
8,5,12,21,66,0,66
8,5,12,31,144,169,-25
8,5,12,33,57,0,57
8,5,12,57,218,214,4
8,5,12,71,72,94,-22
8,5,12,73,47,0,47
8,5,12,81,0,73,-73
8,5,12,86,276,110,166
8,5,12,91,0,64,-64
8,5,12,95,237,148,89
8,5,12,97,62,0,62
8,5,12,99,178,121,57
8,5,12,101,0,97,-97
8,5,12,103,118,147,-29
8,5,12,105,0,68,-68
8,5,12,115,73,81,-8
8,5,12,117,77,0,77
8,5,13,67,101,83,18
8,5,13,89,116,76,40
8,5,13,121,131,102,29
8,5,13,135,83,78,5
8,5,15,3,264,166,98
8,5,16,1,53,138,-85
8,5,17,31,498,260,238
8,5,17,43,179,92,87
8,5,17,89,85,0,85
8,5,17,97,98,0,98
8,5,17,197,50,0,50
8,5,18,97,111,122,-11
8,5,19,153,115,99,16
8,5,20,91,184,177,7
8,5,20,173,178,142,36
8,5,21,111,83,65,18
8,5,22,71,55,0,55
8,5,24,3,108,0,108
8,5,24,5,69,0,69
8,5,24,31,79,103,-24
8,5,24,33,62,0,62
8,5,25,17,77,60,17
8,5,25,25,0,44,-44
8,5,26,81,54,85,-31
8,5,26,125,52,70,-18
8,5,26,163,78,0,78
8,5,27,37,67,0,67
8,5,27,53,184,197,-13
8,5,27,123,68,71,-3
8,5,29,19,64,0,64
8,5,29,95,122,145,-23
8,5,29,189,252,115,137
8,5,29,510,47,0,47
8,5,30,31,0,82,-82
8,5,30,111,47,55,-8
8,5,31,55,153,224,-71
8,5,31,109,66,114,-48
8,5,32,3,477,650,-173
8,5,32,31,77,63,14
8,5,34,3,68,0,68
8,5,34,5,54,0,54
8,5,34,23,65,0,65
8,5,35,1,332,225,107
8,5,35,13,105,78,27
8,5,35,43,0,62,-62
8,5,35,49,74,50,24
8,5,36,47,163,52,111
8,5,36,59,63,0,63
8,5,36,61,124,107,17
8,5,36,67,50,0,50
8,5,36,81,121,0,121
8,5,36,103,93,0,93
8,5,36,119,66,0,66
8,5,37,119,119,178,-59
8,5,37,183,73,172,-99
8,5,38,17,49,0,49
8,5,39,35,83,61,22
8,5,39,49,111,193,-82
8,5,39,61,61,0,61
8,5,40,27,61,0,61
8,5,40,109,182,149,33
8,5,40,143,144,127,17
8,5,41,5,0,64,-64
8,5,41,51,121,107,14
8,5,41,67,135,95,40
8,5,42,3,57,83,-26
8,5,42,91,69,0,69
8,5,42,101,69,60,9
8,5,46,103,48,111,-63
8,5,47,37,100,104,-4
8,5,47,93,65,0,65
8,5,47,157,64,0,64
8,5,48,29,350,325,25
8,5,48,85,256,274,-18
8,5,48,113,442,316,126
8,5,48,121,237,152,85
8,5,48,141,227,223,4
8,5,48,157,110,103,7
8,5,48,201,544,512,32
8,5,48,339,105,102,3
8,5,48,439,294,323,-29
8,5,48,453,252,261,-9
8,5,48,491,73,103,-30
8,5,49,11,0,99,-99
8,5,49,35,233,286,-53
8,5,49,49,114,156,-42
8,5,51,59,220,144,76
8,5,51,107,130,0,130
8,5,51,810,63,65,-2
8,5,53,11,73,63,10
8,5,53,33,305,375,-70
8,5,53,53,111,123,-12
8,5,53,61,105,102,3
8,5,53,63,53,66,-13
8,5,55,25,109,48,61
8,5,55,79,61,0,61
8,5,56,1,73,0,73
8,5,56,21,131,160,-29
8,5,56,25,56,77,-21
8,7,4,13,67,54,13
8,7,8,67,132,94,38
8,11,8,89,85,0,85
8,13,4,13,351,346,5
8,13,4,19,134,145,-11
8,13,6,1,203,180,23
8,13,6,13,167,67,100
8,13,6,37,535,404,131
8,13,6,41,89,0,89
8,13,6,59,229,139,90
8,13,6,65,62,58,4
8,13,6,67,0,58,-58
8,13,6,73,328,280,48
8,13,6,75,214,133,81
8,13,6,81,149,53,96
8,13,6,83,78,66,12
8,13,6,85,412,226,186
8,13,6,87,65,0,65
8,13,6,97,69,43,26
8,13,6,111,74,65,9
8,13,8,1,1982,2415,-433
8,13,8,5,785,757,28
8,13,8,14,1709,2184,-475
8,13,8,31,2154,3248,-1094
8,13,8,35,356,447,-91
8,13,8,37,80,82,-2
8,13,8,41,470,448,22
8,13,8,45,59,117,-58
8,13,8,47,66,149,-83
8,13,8,49,0,66,-66
8,13,8,59,1854,2579,-725
8,13,8,67,106,102,4
8,13,8,69,1647,2557,-910
8,13,8,77,112,126,-14
8,13,8,97,43,0,43
8,13,8,101,60,85,-25
8,13,8,107,57,65,-8
8,13,8,117,97,142,-45
8,13,8,123,2335,3911,-1576
8,13,9,1,129,0,129
8,13,9,9,46,0,46
8,13,11,1,105,77,28
8,13,12,11,110,68,42
8,13,12,57,84,0,84
8,13,12,86,121,0,121
8,13,12,95,68,0,68
8,13,12,99,133,0,133
8,13,12,103,70,0,70
8,13,12,115,0,63,-63
8,13,13,121,62,47,15
8,13,15,3,75,0,75
8,13,16,1,0,52,-52
8,13,17,31,492,178,314
8,13,17,43,114,0,114
8,13,17,97,90,0,90
8,13,18,97,57,0,57
8,13,19,153,73,0,73
8,13,20,91,80,0,80
8,13,24,31,117,56,61
8,13,25,9,60,0,60
8,13,25,17,259,125,134
8,13,25,25,101,92,9
8,13,26,125,77,0,77
8,13,26,161,60,0,60
8,13,27,53,125,113,12
8,13,29,19,48,0,48
8,13,29,189,74,0,74
8,13,30,31,0,67,-67
8,13,31,55,95,0,95
8,13,31,109,51,0,51
8,13,32,3,101,167,-66
8,13,32,31,0,54,-54
8,13,34,17,68,0,68
8,13,35,1,157,116,41
8,13,35,49,66,68,-2
8,13,36,29,53,42,11
8,13,36,47,169,97,72
8,13,36,59,54,0,54
8,13,36,61,190,135,55
8,13,36,81,64,0,64
8,13,36,103,70,50,20
8,13,36,119,73,0,73
8,13,37,21,0,51,-51
8,13,37,119,63,0,63
8,13,37,183,89,86,3
8,13,39,49,72,0,72
8,13,39,61,64,0,64
8,13,40,109,80,0,80
8,13,41,17,0,51,-51
8,13,41,39,53,0,53
8,13,41,51,125,140,-15
8,13,42,3,80,72,8
8,13,42,101,85,48,37
8,13,45,19,59,0,59
8,13,47,37,64,78,-14
8,13,48,29,85,62,23
8,13,48,85,73,0,73
8,13,48,113,112,77,35
8,13,48,121,77,0,77
8,13,48,141,64,0,64
8,13,48,201,241,84,157
8,13,48,439,124,66,58
8,13,48,453,279,188,91
8,13,49,35,136,140,-4
8,13,51,13,77,0,77
8,13,51,59,150,69,81
8,13,53,33,289,419,-130
8,13,53,53,63,64,-1
8,13,53,61,74,54,20
8,13,55,25,120,62,58
8,13,55,79,72,0,72
8,13,56,21,50,59,-9
8,14,4,13,116,154,-38
8,14,6,37,131,53,78
8,14,6,59,74,0,74
8,14,6,73,70,59,11
8,14,6,85,93,0,93
8,14,8,1,2512,3211,-699
8,14,8,5,421,418,3
8,14,8,13,2184,1709,475
8,14,8,31,851,855,-4
8,14,8,35,224,284,-60
8,14,8,41,174,135,39
8,14,8,59,1595,1505,90
8,14,8,69,227,285,-58
8,14,8,123,331,704,-373
8,14,17,31,154,0,154
8,14,32,3,0,57,-57
8,14,48,201,122,0,122
8,14,48,453,53,0,53
8,14,53,33,0,81,-81
8,15,8,5,65,0,65
8,15,8,31,134,0,134
8,15,8,41,118,141,-23
8,15,8,43,87,113,-26
8,15,8,59,152,61,91
8,19,8,1,70,0,70
8,19,8,5,81,0,81
8,19,8,31,117,100,17
8,19,8,59,319,298,21
8,21,8,3,131,238,-107
8,23,8,3,0,61,-61
8,25,8,89,96,63,33
8,27,8,41,67,0,67
8,27,8,43,74,107,-33
8,29,8,5,69,0,69
8,29,8,31,72,0,72
8,29,8,41,76,0,76
8,29,8,45,0,56,-56
8,29,8,59,120,0,120
8,29,8,77,292,478,-186
8,29,8,85,384,368,16
8,31,1,73,83,0,83
8,31,2,20,119,0,119
8,31,4,5,59,0,59
8,31,4,13,1080,1091,-11
8,31,4,19,249,260,-11
8,31,4,21,0,66,-66
8,31,4,25,52,0,52
8,31,5,7,53,0,53
8,31,5,119,89,0,89
8,31,6,1,362,215,147
8,31,6,13,231,107,124
8,31,6,29,60,0,60
8,31,6,37,1446,1117,329
8,31,6,41,129,50,79
8,31,6,59,447,340,107
8,31,6,65,202,136,66
8,31,6,67,160,117,43
8,31,6,71,158,104,54
8,31,6,73,691,490,201
8,31,6,75,771,336,435
8,31,6,81,216,82,134
8,31,6,83,115,53,62
8,31,6,85,323,160,163
8,31,6,97,58,54,4
8,31,6,111,99,80,19
8,31,8,1,9840,13553,-3713
8,31,8,5,22255,25536,-3281
8,31,8,13,3248,2154,1094
8,31,8,14,855,851,4
8,31,8,15,0,134,-134
8,31,8,19,100,117,-17
8,31,8,29,0,72,-72
8,31,8,35,3809,5299,-1490
8,31,8,37,351,329,22
8,31,8,39,80,198,-118
8,31,8,41,1845,1655,190
8,31,8,43,62,66,-4
8,31,8,45,132,162,-30
8,31,8,47,0,60,-60
8,31,8,49,116,137,-21
8,31,8,51,70,74,-4
8,31,8,59,12417,18099,-5682
8,31,8,67,154,138,16
8,31,8,69,1440,1061,379
8,31,8,77,218,307,-89
8,31,8,85,0,81,-81
8,31,8,87,71,106,-35
8,31,8,93,66,192,-126
8,31,8,97,127,105,22
8,31,8,101,292,424,-132
8,31,8,107,120,121,-1
8,31,8,113,59,0,59
8,31,8,117,370,341,29
8,31,8,119,0,69,-69
8,31,8,123,779,1172,-393
8,31,9,1,229,77,152
8,31,9,3,135,0,135
8,31,9,9,114,64,50
8,31,10,3,53,0,53
8,31,11,1,626,231,395
8,31,12,1,83,49,34
8,31,12,9,75,78,-3
8,31,12,11,338,159,179
8,31,12,21,90,70,20
8,31,12,31,181,119,62
8,31,12,33,43,0,43
8,31,12,57,280,180,100
8,31,12,71,148,70,78
8,31,12,73,87,0,87
8,31,12,81,68,0,68
8,31,12,86,443,164,279
8,31,12,95,331,157,174
8,31,12,99,263,156,107
8,31,12,103,194,162,32
8,31,12,115,73,82,-9
8,31,12,117,64,0,64
8,31,12,127,62,48,14
8,31,13,51,51,61,-10
8,31,13,67,117,60,57
8,31,13,89,167,116,51
8,31,13,121,365,202,163
8,31,13,135,78,0,78
8,31,15,3,227,158,69
8,31,16,1,91,165,-74
8,31,17,31,2131,818,1313
8,31,17,43,259,111,148
8,31,17,89,114,0,114
8,31,17,97,187,85,102
8,31,17,111,56,0,56
8,31,17,197,111,0,111
8,31,18,3,0,88,-88
8,31,18,57,78,69,9
8,31,18,89,56,0,56
8,31,18,97,270,100,170
8,31,18,105,50,0,50
8,31,19,103,110,0,110
8,31,19,113,67,0,67
8,31,19,153,129,157,-28
8,31,20,45,49,0,49
8,31,20,91,247,158,89
8,31,20,173,121,74,47
8,31,21,67,58,0,58
8,31,21,111,141,87,54
8,31,22,33,109,0,109
8,31,22,51,50,0,50
8,31,22,71,156,123,33
8,31,23,5,45,80,-35
8,31,24,3,76,0,76
8,31,24,5,85,47,38
8,31,24,31,219,137,82
8,31,24,33,60,0,60
8,31,24,510,230,76,154
8,31,25,1,51,0,51
8,31,25,9,63,0,63
8,31,25,17,384,195,189
8,31,25,21,123,62,61
8,31,25,23,50,0,50
8,31,25,25,369,157,212
8,31,25,27,54,59,-5
8,31,26,65,73,0,73
8,31,26,81,145,107,38
8,31,26,99,49,0,49
8,31,26,125,151,151,0
8,31,26,161,151,67,84
8,31,26,163,123,73,50
8,31,27,37,80,76,4
8,31,27,53,549,298,251
8,31,27,109,56,0,56
8,31,27,123,104,65,39
8,31,29,19,85,0,85
8,31,29,77,57,0,57
8,31,29,95,288,176,112
8,31,29,183,73,0,73
8,31,29,189,285,197,88
8,31,29,510,181,94,87
8,31,30,31,61,79,-18
8,31,30,111,58,0,58
8,31,31,55,222,136,86
8,31,31,109,105,83,22
8,31,32,3,403,554,-151
8,31,32,31,85,109,-24
8,31,33,11,61,0,61
8,31,34,3,127,0,127
8,31,34,13,63,0,63
8,31,34,17,139,0,139
8,31,34,23,62,0,62
8,31,34,27,86,0,86
8,31,34,35,48,0,48
8,31,34,39,61,0,61
8,31,35,1,316,269,47
8,31,35,13,89,62,27
8,31,35,43,0,72,-72
8,31,35,49,149,115,34
8,31,36,1,51,0,51
8,31,36,5,57,0,57
8,31,36,29,104,0,104
8,31,36,47,537,294,243
8,31,36,55,122,53,69
8,31,36,59,102,54,48
8,31,36,61,957,328,629
8,31,36,67,68,47,21
8,31,36,81,210,87,123
8,31,36,103,153,60,93
8,31,36,119,111,68,43
8,31,37,21,86,84,2
8,31,37,63,98,54,44
8,31,37,67,54,0,54
8,31,37,81,51,57,-6
8,31,37,119,282,212,70
8,31,37,129,44,0,44
8,31,37,135,50,0,50
8,31,37,183,227,155,72
8,31,38,17,55,0,55
8,31,39,35,198,127,71
8,31,39,49,328,188,140
8,31,39,61,190,102,88
8,31,39,95,43,0,43
8,31,39,113,56,0,56
8,31,39,153,54,46,8
8,31,40,27,78,0,78
8,31,40,109,244,153,91
8,31,40,143,239,104,135
8,31,41,5,56,59,-3
8,31,41,17,0,94,-94
8,31,41,39,54,56,-2
8,31,41,51,385,320,65
8,31,41,67,88,83,5
8,31,42,3,221,121,100
8,31,42,17,46,0,46
8,31,42,29,71,0,71
8,31,42,45,58,0,58
8,31,42,71,56,57,-1
8,31,42,91,121,0,121
8,31,42,95,41,0,41
8,31,42,101,304,155,149
8,31,44,7,62,0,62
8,31,45,19,147,86,61
8,31,45,45,82,62,20
8,31,45,79,56,0,56
8,31,46,99,61,68,-7
8,31,46,103,56,0,56
8,31,47,37,282,171,111
8,31,47,65,0,51,-51
8,31,47,93,63,0,63
8,31,47,157,137,0,137
8,31,47,187,53,0,53
8,31,48,29,301,219,82
8,31,48,41,47,0,47
8,31,48,85,241,185,56
8,31,48,113,808,487,321
8,31,48,121,167,136,31
8,31,48,141,280,278,2
8,31,48,157,117,0,117
8,31,48,201,1142,528,614
8,31,48,303,65,0,65
8,31,48,329,74,0,74
8,31,48,339,157,92,65
8,31,48,439,337,255,82
8,31,48,453,721,422,299
8,31,48,491,91,97,-6
8,31,49,35,304,262,42
8,31,49,49,68,65,3
8,31,50,7,68,68,0
8,31,51,13,231,64,167
8,31,51,59,359,140,219
8,31,51,107,87,0,87
8,31,51,510,113,51,62
8,31,51,540,51,0,51
8,31,51,760,79,49,30
8,31,51,810,46,0,46
8,31,53,11,59,79,-20
8,31,53,33,676,774,-98
8,31,53,53,103,121,-18
8,31,53,61,90,80,10
8,31,53,63,53,100,-47
8,31,55,9,42,0,42
8,31,55,25,264,134,130
8,31,55,79,269,114,155
8,31,55,133,80,0,80
8,31,56,1,73,0,73
8,31,56,21,91,87,4
8,31,56,25,80,0,80
8,31,56,39,55,0,55
8,35,4,13,714,1020,-306
8,35,4,19,109,192,-83
8,35,4,21,0,100,-100
8,35,4,25,0,59,-59
8,35,5,7,0,72,-72
8,35,6,1,146,95,51
8,35,6,13,156,0,156
8,35,6,37,531,254,277
8,35,6,59,551,235,316
8,35,6,61,64,0,64
8,35,6,65,161,142,19
8,35,6,67,67,57,10
8,35,6,71,89,0,89
8,35,6,73,438,245,193
8,35,6,75,52,0,52
8,35,6,81,74,0,74
8,35,6,85,299,109,190
8,35,6,111,129,0,129
8,35,8,1,1265,1065,200
8,35,8,5,10691,7639,3052
8,35,8,13,447,356,91
8,35,8,14,284,224,60
8,35,8,31,5299,3809,1490
8,35,8,37,0,120,-120
8,35,8,39,594,1095,-501
8,35,8,41,1972,2062,-90
8,35,8,43,0,70,-70
8,35,8,45,72,78,-6
8,35,8,49,52,78,-26
8,35,8,59,4122,2795,1327
8,35,8,69,469,512,-43
8,35,8,77,166,207,-41
8,35,8,85,0,68,-68
8,35,8,93,0,101,-101
8,35,8,101,188,140,48
8,35,8,107,66,0,66
8,35,8,117,118,116,2
8,35,8,119,0,111,-111
8,35,8,123,394,350,44
8,35,12,11,96,77,19
8,35,12,21,0,59,-59
8,35,12,31,56,78,-22
8,35,12,57,176,130,46
8,35,12,71,61,90,-29
8,35,12,86,69,0,69
8,35,12,95,127,96,31
8,35,12,99,95,83,12
8,35,12,103,92,91,1
8,35,13,67,86,0,86
8,35,13,121,69,0,69
8,35,13,135,113,0,113
8,35,15,3,119,70,49
8,35,16,1,88,84,4
8,35,17,31,347,129,218
8,35,17,43,140,0,140
8,35,17,97,99,0,99
8,35,18,97,63,0,63
8,35,20,91,166,158,8
8,35,20,173,92,0,92
8,35,25,17,71,0,71
8,35,26,125,66,0,66
8,35,27,53,68,86,-18
8,35,29,95,62,0,62
8,35,29,189,102,70,32
8,35,31,55,108,92,16
8,35,32,3,274,236,38
8,35,35,1,125,117,8
8,35,37,119,98,95,3
8,35,37,183,90,89,1
8,35,39,49,75,0,75
8,35,40,109,0,81,-81
8,35,40,143,86,74,12
8,35,41,51,0,57,-57
8,35,41,67,66,0,66
8,35,47,37,0,55,-55
8,35,47,187,0,80,-80
8,35,48,29,222,99,123
8,35,48,85,222,212,10
8,35,48,113,213,158,55
8,35,48,121,144,167,-23
8,35,48,157,108,0,108
8,35,48,201,295,192,103
8,35,48,339,136,76,60
8,35,48,439,216,173,43
8,35,48,453,177,146,31
8,35,48,491,114,90,24
8,35,49,35,187,154,33
8,35,49,49,122,180,-58
8,35,49,53,0,68,-68
8,35,51,59,168,0,168
8,35,51,107,92,0,92
8,35,53,33,268,213,55
8,35,53,53,89,0,89
8,35,53,61,140,72,68
8,35,55,25,66,0,66
8,35,56,21,50,67,-17
8,37,4,13,68,99,-31
8,37,6,37,98,62,36
8,37,6,73,63,0,63
8,37,8,1,106,91,15
8,37,8,5,127,142,-15
8,37,8,13,82,80,2
8,37,8,31,329,351,-22
8,37,8,35,120,0,120
8,37,8,41,114,83,31
8,37,8,45,381,693,-312
8,37,8,59,166,153,13
8,37,8,65,0,101,-101
8,37,8,69,73,95,-22
8,37,8,77,0,148,-148
8,37,8,97,359,280,79
8,37,8,117,120,118,2
8,37,17,31,108,0,108
8,39,4,13,0,71,-71
8,39,8,1,239,82,157
8,39,8,5,656,422,234
8,39,8,31,198,80,118
8,39,8,35,1095,594,501
8,39,8,41,264,314,-50
8,39,8,59,142,78,64
8,41,1,31,118,90,28
8,41,1,45,137,125,12
8,41,1,73,0,88,-88
8,41,1,89,125,229,-104
8,41,1,97,67,0,67
8,41,1,101,115,113,2
8,41,1,113,0,139,-139
8,41,2,20,362,218,144
8,41,2,90,340,263,77
8,41,4,3,153,236,-83
8,41,4,5,57,0,57
8,41,4,13,1299,1494,-195
8,41,4,15,61,69,-8
8,41,4,19,356,456,-100
8,41,4,21,121,194,-73
8,41,4,25,95,98,-3
8,41,4,27,88,0,88
8,41,5,7,66,78,-12
8,41,5,119,114,0,114
8,41,5,143,0,87,-87
8,41,6,1,173,104,69
8,41,6,13,192,92,100
8,41,6,19,132,71,61
8,41,6,29,151,106,45
8,41,6,37,1092,751,341
8,41,6,47,65,0,65
8,41,6,53,157,111,46
8,41,6,59,655,296,359
8,41,6,61,79,90,-11
8,41,6,65,580,357,223
8,41,6,67,234,170,64
8,41,6,71,501,437,64
8,41,6,73,961,562,399
8,41,6,75,64,0,64
8,41,6,77,72,0,72
8,41,6,79,69,0,69
8,41,6,81,78,0,78
8,41,6,83,376,185,191
8,41,6,85,278,203,75
8,41,6,95,131,73,58
8,41,6,97,123,0,123
8,41,6,107,81,0,81
8,41,6,111,168,85,83
8,41,8,1,1174,800,374
8,41,8,3,80,86,-6
8,41,8,5,2575,1750,825
8,41,8,13,448,470,-22
8,41,8,14,135,174,-39
8,41,8,15,141,118,23
8,41,8,27,0,67,-67
8,41,8,29,0,76,-76
8,41,8,31,1655,1845,-190
8,41,8,35,2062,1972,90
8,41,8,37,83,114,-31
8,41,8,39,314,264,50
8,41,8,43,451,681,-230
8,41,8,45,90,90,0
8,41,8,49,0,50,-50
8,41,8,51,66,73,-7
8,41,8,55,0,83,-83
8,41,8,59,1555,1043,512
8,41,8,67,102,102,0
8,41,8,69,628,804,-176
8,41,8,71,59,63,-4
8,41,8,77,205,233,-28
8,41,8,85,57,109,-52
8,41,8,89,91,87,4
8,41,8,93,120,117,3
8,41,8,101,1399,2033,-634
8,41,8,105,59,0,59
8,41,8,117,91,97,-6
8,41,8,119,1005,1297,-292
8,41,8,123,528,438,90
8,41,9,3,56,0,56
8,41,11,1,97,120,-23
8,41,12,5,108,82,26
8,41,12,9,301,341,-40
8,41,12,11,287,213,74
8,41,12,21,91,84,7
8,41,12,31,178,203,-25
8,41,12,33,79,127,-48
8,41,12,57,406,462,-56
8,41,12,69,0,68,-68
8,41,12,71,181,152,29
8,41,12,73,56,0,56
8,41,12,81,59,110,-51
8,41,12,83,0,103,-103
8,41,12,86,380,329,51
8,41,12,91,275,320,-45
8,41,12,95,239,245,-6
8,41,12,97,68,65,3
8,41,12,99,191,161,30
8,41,12,101,127,119,8
8,41,12,103,202,266,-64
8,41,12,105,88,160,-72
8,41,12,109,73,0,73
8,41,12,111,74,0,74
8,41,12,113,110,113,-3
8,41,12,115,69,81,-12
8,41,12,117,120,79,41
8,41,12,127,66,131,-65
8,41,13,29,0,87,-87
8,41,13,51,160,131,29
8,41,13,53,127,143,-16
8,41,13,67,114,90,24
8,41,13,73,137,181,-44
8,41,13,89,64,53,11
8,41,13,121,84,64,20
8,41,13,135,114,110,4
8,41,13,153,137,67,70
8,41,13,179,325,264,61
8,41,13,185,98,82,16
8,41,13,215,311,415,-104
8,41,13,245,110,161,-51
8,41,15,1,58,0,58
8,41,15,3,1171,1078,93
8,41,16,1,90,199,-109
8,41,17,31,460,264,196
8,41,17,43,151,63,88
8,41,17,89,138,0,138
8,41,17,97,61,56,5
8,41,17,111,79,0,79
8,41,17,113,59,0,59
8,41,17,163,120,99,21
8,41,17,197,61,0,61
8,41,17,201,62,0,62
8,41,18,3,0,94,-94
8,41,18,57,84,68,16
8,41,18,97,146,148,-2
8,41,19,153,121,108,13
8,41,20,45,55,0,55
8,41,20,61,310,240,70
8,41,20,91,220,164,56
8,41,20,103,192,133,59
8,41,20,161,165,87,78
8,41,20,173,253,208,45
8,41,21,47,201,156,45
8,41,21,67,53,57,-4
8,41,21,93,151,101,50
8,41,21,111,76,77,-1
8,41,22,15,101,0,101
8,41,22,17,59,0,59
8,41,22,115,160,168,-8
8,41,24,3,227,168,59
8,41,24,5,88,0,88
8,41,24,25,77,0,77
8,41,24,31,121,117,4
8,41,24,33,137,108,29
8,41,25,9,61,0,61
8,41,25,17,133,96,37
8,41,26,81,83,61,22
8,41,26,99,55,0,55
8,41,26,125,104,136,-32
8,41,26,161,56,0,56
8,41,26,163,96,115,-19
8,41,27,37,0,68,-68
8,41,27,53,159,142,17
8,41,27,123,0,56,-56
8,41,28,47,142,98,44
8,41,28,87,0,61,-61
8,41,29,19,63,0,63
8,41,29,47,114,79,35
8,41,29,77,74,83,-9
8,41,29,95,157,130,27
8,41,29,169,195,217,-22
8,41,29,183,55,75,-20
8,41,29,189,134,100,34
8,41,29,510,60,0,60
8,41,30,13,60,65,-5
8,41,30,29,0,73,-73
8,41,30,31,0,64,-64
8,41,31,55,162,92,70
8,41,31,109,115,0,115
8,41,31,153,233,127,106
8,41,32,3,613,738,-125
8,41,32,31,78,114,-36
8,41,33,11,54,0,54
8,41,34,5,114,84,30
8,41,34,25,66,0,66
8,41,35,1,533,255,278
8,41,35,9,71,0,71
8,41,35,13,128,112,16
8,41,35,35,80,68,12
8,41,35,43,121,105,16
8,41,35,45,73,0,73
8,41,35,49,81,69,12
8,41,36,5,0,49,-49
8,41,36,29,62,57,5
8,41,36,45,410,281,129
8,41,36,47,102,51,51
8,41,36,55,77,0,77
8,41,36,61,56,55,1
8,41,36,71,71,67,4
8,41,36,81,87,0,87
8,41,36,103,73,0,73
8,41,37,51,610,665,-55
8,41,37,85,207,259,-52
8,41,37,93,127,82,45
8,41,37,119,109,107,2
8,41,37,125,128,181,-53
8,41,37,133,97,65,32
8,41,37,183,161,99,62
8,41,38,17,59,0,59
8,41,38,101,99,68,31
8,41,39,35,111,109,2
8,41,39,49,104,90,14
8,41,39,57,109,112,-3
8,41,39,61,56,80,-24
8,41,39,113,133,152,-19
8,41,39,153,0,60,-60
8,41,40,27,129,81,48
8,41,40,31,325,281,44
8,41,40,47,0,118,-118
8,41,40,109,261,314,-53
8,41,40,143,176,143,33
8,41,41,5,63,73,-10
8,41,41,39,61,95,-34
8,41,41,51,101,113,-12
8,41,41,67,101,83,18
8,41,42,3,83,103,-20
8,41,42,71,76,0,76
8,41,42,91,0,67,-67
8,41,42,101,73,55,18
8,41,45,15,0,66,-66
8,41,45,19,69,78,-9
8,41,45,45,63,0,63
8,41,45,79,224,234,-10
8,41,46,99,66,58,8
8,41,46,103,83,121,-38
8,41,47,37,107,78,29
8,41,47,65,0,70,-70
8,41,47,93,74,109,-35
8,41,47,125,510,486,24
8,41,47,149,73,0,73
8,41,47,157,191,83,108
8,41,48,27,812,706,106
8,41,48,29,1077,1013,64
8,41,48,39,76,0,76
8,41,48,41,74,0,74
8,41,48,61,71,0,71
8,41,48,85,290,243,47
8,41,48,91,0,73,-73
8,41,48,99,248,227,21
8,41,48,113,474,304,170
8,41,48,121,275,275,0
8,41,48,141,872,726,146
8,41,48,157,114,0,114
8,41,48,167,74,0,74
8,41,48,187,115,164,-49
8,41,48,201,717,446,271
8,41,48,209,87,0,87
8,41,48,215,77,0,77
8,41,48,303,94,105,-11
8,41,48,339,163,144,19
8,41,48,355,112,0,112
8,41,48,375,58,67,-9
8,41,48,381,0,89,-89
8,41,48,423,68,68,0
8,41,48,439,537,396,141
8,41,48,441,118,0,118
8,41,48,451,67,87,-20
8,41,48,453,334,289,45
8,41,48,465,0,73,-73
8,41,48,485,79,82,-3
8,41,48,491,160,186,-26
8,41,49,11,99,125,-26
8,41,49,35,229,278,-49
8,41,49,49,170,168,2
8,41,49,57,79,92,-13
8,41,51,13,89,118,-29
8,41,51,41,72,104,-32
8,41,51,59,589,477,112
8,41,51,107,140,89,51
8,41,51,149,0,169,-169
8,41,51,153,257,156,101
8,41,51,179,0,81,-81
8,41,51,510,76,74,2
8,41,51,650,67,56,11
8,41,51,700,151,171,-20
8,41,51,710,0,58,-58
8,41,51,810,143,134,9
8,41,53,11,63,139,-76
8,41,53,33,314,289,25
8,41,53,35,86,73,13
8,41,53,53,638,689,-51
8,41,53,61,135,128,7
8,41,53,63,122,169,-47
8,41,53,67,227,226,1
8,41,55,25,90,73,17
8,41,55,79,79,59,20
8,41,55,133,56,0,56
8,41,56,21,162,120,42
8,41,56,25,73,0,73
8,43,8,1,94,0,94
8,43,8,5,100,52,48
8,43,8,15,113,87,26
8,43,8,27,107,74,33
8,43,8,31,66,62,4
8,43,8,35,70,0,70
8,43,8,41,681,451,230
8,43,8,59,114,74,40
8,43,8,69,62,61,1
8,43,8,101,370,443,-73
8,43,8,119,51,0,51
8,43,8,123,61,0,61
8,45,4,13,82,76,6
8,45,6,37,92,0,92
8,45,8,1,130,74,56
8,45,8,5,58,104,-46
8,45,8,13,117,59,58
8,45,8,29,56,0,56
8,45,8,31,162,132,30
8,45,8,35,78,72,6
8,45,8,37,693,381,312
8,45,8,41,90,90,0
8,45,8,59,194,141,53
8,45,8,69,108,92,16
8,45,8,77,430,705,-275
8,45,8,85,67,0,67
8,45,8,97,441,275,166
8,45,8,123,89,135,-46
8,47,8,1,61,61,0
8,47,8,13,149,66,83
8,47,8,31,60,0,60
8,47,8,59,237,115,122
8,49,8,5,73,0,73
8,49,8,13,66,0,66
8,49,8,31,137,116,21
8,49,8,35,78,52,26
8,49,8,41,50,0,50
8,49,8,59,173,116,57
8,49,8,69,0,66,-66
8,49,8,117,117,0,117
8,51,8,31,74,70,4
8,51,8,41,73,66,7
8,51,8,59,70,49,21
8,51,8,77,0,60,-60
8,51,8,85,59,0,59
8,55,8,41,83,0,83
8,55,8,101,72,99,-27
8,59,2,20,70,69,1
8,59,4,13,619,1034,-415
8,59,4,19,152,239,-87
8,59,4,21,59,92,-33
8,59,4,25,0,73,-73
8,59,6,1,164,70,94
8,59,6,13,91,0,91
8,59,6,29,59,0,59
8,59,6,37,610,387,223
8,59,6,59,321,189,132
8,59,6,65,147,119,28
8,59,6,67,60,73,-13
8,59,6,71,97,77,20
8,59,6,73,400,297,103
8,59,6,75,103,54,49
8,59,6,81,123,0,123
8,59,6,85,221,73,148
8,59,6,111,85,68,17
8,59,8,1,8202,9877,-1675
8,59,8,5,6728,6697,31
8,59,8,13,2579,1854,725
8,59,8,14,1505,1595,-90
8,59,8,15,61,152,-91
8,59,8,19,298,319,-21
8,59,8,29,0,120,-120
8,59,8,31,18099,12417,5682
8,59,8,35,2795,4122,-1327
8,59,8,37,153,166,-13
8,59,8,39,78,142,-64
8,59,8,41,1043,1555,-512
8,59,8,43,74,114,-40
8,59,8,45,141,194,-53
8,59,8,47,115,237,-122
8,59,8,49,116,173,-57
8,59,8,51,49,70,-21
8,59,8,65,57,54,3
8,59,8,67,103,155,-52
8,59,8,69,904,1067,-163
8,59,8,77,294,558,-264
8,59,8,85,62,137,-75
8,59,8,87,0,116,-116
8,59,8,93,349,639,-290
8,59,8,101,213,342,-129
8,59,8,107,114,151,-37
8,59,8,117,268,235,33
8,59,8,119,0,72,-72
8,59,8,123,699,1591,-892
8,59,9,1,80,0,80
8,59,9,3,58,0,58
8,59,9,9,50,0,50
8,59,11,1,96,54,42
8,59,12,9,92,90,2
8,59,12,11,183,88,95
8,59,12,31,111,0,111
8,59,12,57,157,148,9
8,59,12,71,91,119,-28
8,59,12,86,101,83,18
8,59,12,95,142,105,37
8,59,12,99,169,87,82
8,59,12,103,131,105,26
8,59,12,109,0,61,-61
8,59,12,115,61,67,-6
8,59,12,117,57,0,57
8,59,12,127,0,78,-78
8,59,13,67,81,0,81
8,59,13,121,76,0,76
8,59,15,3,126,74,52
8,59,16,1,0,160,-160
8,59,17,31,548,180,368
8,59,17,43,150,0,150
8,59,17,89,71,0,71
8,59,17,97,113,0,113
8,59,17,197,70,0,70
8,59,18,97,77,0,77
8,59,19,153,62,61,1
8,59,20,91,129,76,53
8,59,20,173,89,81,8
8,59,24,31,93,0,93
8,59,25,17,102,73,29
8,59,25,25,70,0,70
8,59,26,81,0,48,-48
8,59,26,125,104,55,49
8,59,26,163,55,0,55
8,59,27,37,54,0,54
8,59,27,53,191,114,77
8,59,27,123,55,46,9
8,59,29,77,69,0,69
8,59,29,95,60,102,-42
8,59,29,189,123,55,68
8,59,29,510,51,0,51
8,59,30,31,0,72,-72
8,59,30,111,0,61,-61
8,59,31,55,116,85,31
8,59,31,109,75,57,18
8,59,32,3,227,392,-165
8,59,32,31,66,67,-1
8,59,35,1,221,172,49
8,59,35,13,0,62,-62
8,59,35,43,58,58,0
8,59,35,49,63,73,-10
8,59,36,47,88,55,33
8,59,36,55,44,0,44
8,59,36,59,59,0,59
8,59,36,61,118,0,118
8,59,36,81,54,0,54
8,59,36,103,76,0,76
8,59,37,119,86,74,12
8,59,37,183,103,87,16
8,59,39,35,75,0,75
8,59,39,49,64,0,64
8,59,39,61,67,0,67
8,59,40,109,136,81,55
8,59,40,143,99,78,21
8,59,41,51,84,98,-14
8,59,41,67,75,107,-32
8,59,42,3,104,0,104
8,59,42,17,49,0,49
8,59,42,91,65,0,65
8,59,42,101,58,44,14
8,59,46,103,52,80,-28
8,59,47,37,97,68,29
8,59,47,157,54,0,54
8,59,48,29,149,171,-22
8,59,48,85,168,103,65
8,59,48,113,223,129,94
8,59,48,121,138,84,54
8,59,48,141,113,101,12
8,59,48,157,74,68,6
8,59,48,201,515,250,265
8,59,48,339,123,0,123
8,59,48,439,210,125,85
8,59,48,453,284,192,92
8,59,48,491,100,76,24
8,59,49,11,54,0,54
8,59,49,35,154,228,-74
8,59,49,49,0,90,-90
8,59,51,13,80,0,80
8,59,51,59,160,63,97
8,59,53,33,264,293,-29
8,59,53,53,58,90,-32
8,59,53,61,0,74,-74
8,59,53,63,45,69,-24
8,59,55,25,115,70,45
8,59,55,79,90,0,90
8,59,56,1,63,0,63
8,59,56,21,97,114,-17
8,59,56,25,0,61,-61
8,65,8,37,101,0,101
8,65,8,59,54,57,-3
8,65,8,117,157,83,74
8,67,4,13,219,220,-1
8,67,6,37,53,0,53
8,67,6,59,56,0,56
8,67,6,73,69,46,23
8,67,8,5,68,73,-5
8,67,8,7,94,132,-38
8,67,8,13,102,106,-4
8,67,8,31,138,154,-16
8,67,8,41,102,102,0
8,67,8,59,155,103,52
8,67,8,69,62,83,-21
8,67,8,77,76,74,2
8,67,8,83,158,272,-114
8,67,35,1,137,102,35
8,67,35,45,328,467,-139
8,67,48,201,53,0,53
8,67,48,453,58,0,58
8,67,53,33,52,53,-1
8,69,2,20,100,0,100
8,69,4,13,532,607,-75
8,69,4,19,122,186,-64
8,69,4,21,0,63,-63
8,69,4,25,0,70,-70
8,69,6,1,112,66,46
8,69,6,19,62,0,62
8,69,6,37,340,208,132
8,69,6,59,232,114,118
8,69,6,65,168,81,87
8,69,6,67,0,57,-57
8,69,6,71,127,0,127
8,69,6,73,354,268,86
8,69,6,75,0,44,-44
8,69,6,83,80,0,80
8,69,6,85,156,82,74
8,69,6,97,62,0,62
8,69,6,111,97,0,97
8,69,8,1,1032,955,77
8,69,8,5,884,808,76
8,69,8,13,2557,1647,910
8,69,8,14,285,227,58
8,69,8,31,1061,1440,-379
8,69,8,35,512,469,43
8,69,8,37,95,73,22
8,69,8,41,804,628,176
8,69,8,43,61,62,-1
8,69,8,45,92,108,-16
8,69,8,49,66,0,66
8,69,8,59,1067,904,163
8,69,8,67,83,62,21
8,69,8,75,73,0,73
8,69,8,77,242,275,-33
8,69,8,85,0,93,-93
8,69,8,87,80,91,-11
8,69,8,101,125,110,15
8,69,8,107,109,116,-7
8,69,8,117,116,0,116
8,69,8,123,4924,7283,-2359
8,69,12,9,59,62,-3
8,69,12,11,76,0,76
8,69,12,31,74,0,74
8,69,12,57,59,65,-6
8,69,12,71,64,64,0
8,69,12,86,65,0,65
8,69,12,95,77,0,77
8,69,12,99,91,0,91
8,69,12,103,78,75,3
8,69,15,1,0,60,-60
8,69,15,3,86,83,3
8,69,16,1,72,91,-19
8,69,17,31,238,146,92
8,69,17,43,86,0,86
8,69,17,89,58,0,58
8,69,17,97,66,0,66
8,69,17,111,55,0,55
8,69,19,153,77,0,77
8,69,20,91,138,61,77
8,69,20,173,88,0,88
8,69,24,31,59,0,59
8,69,25,17,0,52,-52
8,69,27,53,114,80,34
8,69,27,123,0,53,-53
8,69,29,95,68,56,12
8,69,29,189,99,0,99
8,69,29,510,47,0,47
8,69,30,31,58,74,-16
8,69,31,55,149,67,82
8,69,31,109,111,78,33
8,69,32,3,220,157,63
8,69,32,31,68,0,68
8,69,35,1,147,83,64
8,69,35,49,0,58,-58
8,69,36,47,44,0,44
8,69,36,61,45,51,-6
8,69,37,183,58,83,-25
8,69,40,109,60,0,60
8,69,41,51,65,120,-55
8,69,41,67,55,108,-53
8,69,42,3,47,0,47
8,69,46,103,71,60,11
8,69,48,29,108,82,26
8,69,48,85,80,77,3
8,69,48,113,90,97,-7
8,69,48,121,81,77,4
8,69,48,141,107,0,107
8,69,48,201,254,130,124
8,69,48,339,69,0,69
8,69,48,439,200,96,104
8,69,48,453,187,169,18
8,69,48,491,74,63,11
8,69,49,35,135,108,27
8,69,49,49,0,72,-72
8,69,49,53,0,58,-58
8,69,51,59,67,0,67
8,69,53,33,176,234,-58
8,69,53,53,0,71,-71
8,69,55,25,109,0,109
8,69,55,79,72,0,72
8,69,56,1,241,195,46
8,69,56,21,504,583,-79
8,69,56,25,123,77,46
8,71,8,41,63,59,4
8,71,8,101,77,98,-21
8,75,8,1,109,80,29
8,75,8,69,0,73,-73
8,75,8,87,86,56,30
8,75,8,123,108,129,-21
8,75,31,33,0,99,-99
8,77,4,13,234,279,-45
8,77,4,19,60,94,-34
8,77,6,37,107,0,107
8,77,6,59,75,0,75
8,77,6,73,123,62,61
8,77,8,1,233,310,-77
8,77,8,5,266,296,-30
8,77,8,13,126,112,14
8,77,8,29,478,292,186
8,77,8,31,307,218,89
8,77,8,35,207,166,41
8,77,8,37,148,0,148
8,77,8,41,233,205,28
8,77,8,45,705,430,275
8,77,8,51,60,0,60
8,77,8,59,558,294,264
8,77,8,67,74,76,-2
8,77,8,69,275,242,33
8,77,8,81,104,86,18
8,77,8,83,88,0,88
8,77,8,85,353,222,131
8,77,8,101,74,0,74
8,77,8,103,74,85,-11
8,77,8,107,60,0,60
8,77,8,123,188,255,-67
8,77,32,3,150,187,-37
8,77,35,1,54,0,54
8,77,48,201,0,59,-59
8,77,49,19,69,0,69
8,77,49,35,116,141,-25
8,77,49,49,0,88,-88
8,77,53,33,0,55,-55
8,77,56,21,0,79,-79
8,81,8,77,86,104,-18
8,81,8,107,159,112,47
8,83,4,1,76,0,76
8,83,4,13,106,142,-36
8,83,8,67,272,158,114
8,83,8,77,0,88,-88
8,83,35,45,224,112,112
8,85,4,13,77,72,5
8,85,6,37,65,0,65
8,85,8,1,0,68,-68
8,85,8,5,102,0,102
8,85,8,29,368,384,-16
8,85,8,31,81,0,81
8,85,8,35,68,0,68
8,85,8,41,109,57,52
8,85,8,45,0,67,-67
8,85,8,51,0,59,-59
8,85,8,59,137,62,75
8,85,8,69,93,0,93
8,85,8,77,222,353,-131
8,85,8,91,192,142,50
8,85,8,113,119,68,51
8,87,8,1,302,137,165
8,87,8,5,100,97,3
8,87,8,31,106,71,35
8,87,8,59,116,0,116
8,87,8,69,91,80,11
8,87,8,75,56,86,-30
8,87,8,121,0,68,-68
8,87,8,123,376,325,51
8,89,8,11,0,85,-85
8,89,8,25,63,96,-33
8,89,8,41,87,91,-4
8,89,8,101,226,203,23
8,91,8,85,142,192,-50
8,91,8,113,63,0,63
8,93,8,1,148,63,85
8,93,8,5,165,103,62
8,93,8,31,192,66,126
8,93,8,35,101,0,101
8,93,8,41,117,120,-3
8,93,8,59,639,349,290
8,93,8,117,108,70,38
8,93,8,119,109,0,109
8,97,6,37,0,80,-80
8,97,8,13,0,43,-43
8,97,8,31,105,127,-22
8,97,8,37,280,359,-79
8,97,8,45,275,441,-166
8,99,8,101,0,59,-59
8,101,4,13,127,178,-51
8,101,6,37,60,0,60
8,101,6,73,92,69,23
8,101,8,1,341,252,89
8,101,8,3,0,64,-64
8,101,8,5,322,293,29
8,101,8,13,85,60,25
8,101,8,31,424,292,132
8,101,8,35,140,188,-48
8,101,8,41,2033,1399,634
8,101,8,43,443,370,73
8,101,8,55,99,72,27
8,101,8,59,342,213,129
8,101,8,69,110,125,-15
8,101,8,71,98,77,21
8,101,8,77,0,74,-74
8,101,8,89,203,226,-23
8,101,8,99,59,0,59
8,101,8,123,130,95,35
8,101,32,3,93,108,-15
8,101,35,1,66,0,66
8,103,8,77,85,74,11
8,105,8,3,173,199,-26
8,105,8,41,0,59,-59
8,105,8,109,100,141,-41
8,107,8,5,76,67,9
8,107,8,13,65,57,8
8,107,8,31,121,120,1
8,107,8,35,0,66,-66
8,107,8,59,151,114,37
8,107,8,69,116,109,7
8,107,8,77,0,60,-60
8,107,8,81,112,159,-47
8,109,8,3,0,79,-79
8,109,8,105,141,100,41
8,113,8,31,0,59,-59
8,113,8,85,68,119,-51
8,113,8,91,0,63,-63
8,117,4,13,0,49,-49
8,117,6,73,0,53,-53
8,117,8,1,0,107,-107
8,117,8,5,130,103,27
8,117,8,13,142,97,45
8,117,8,31,341,370,-29
8,117,8,35,116,118,-2
8,117,8,37,118,120,-2
8,117,8,41,97,91,6
8,117,8,49,0,117,-117
8,117,8,59,235,268,-33
8,117,8,65,83,157,-74
8,117,8,69,0,116,-116
8,117,8,93,70,108,-38
8,117,17,31,60,0,60
8,117,48,201,51,0,51
8,119,8,5,86,0,86
8,119,8,31,69,0,69
8,119,8,35,111,0,111
8,119,8,41,1297,1005,292
8,119,8,43,0,51,-51
8,119,8,59,72,0,72
8,119,8,93,0,109,-109
8,121,8,87,68,0,68
8,123,4,13,398,388,10
8,123,4,19,64,72,-8
8,123,4,21,0,86,-86
8,123,6,37,178,121,57
8,123,6,59,115,0,115
8,123,6,65,88,60,28
8,123,6,71,110,0,110
8,123,6,73,161,56,105
8,123,6,85,70,0,70
8,123,8,1,5320,3110,2210
8,123,8,5,1074,701,373
8,123,8,13,3911,2335,1576
8,123,8,14,704,331,373
8,123,8,31,1172,779,393
8,123,8,35,350,394,-44
8,123,8,41,438,528,-90
8,123,8,43,0,61,-61
8,123,8,45,135,89,46
8,123,8,59,1591,699,892
8,123,8,69,7283,4924,2359
8,123,8,75,129,108,21
8,123,8,77,255,188,67
8,123,8,87,325,376,-51
8,123,8,101,95,130,-35
8,123,8,125,71,0,71
8,123,17,31,76,0,76
8,123,27,53,0,78,-78
8,123,31,55,62,0,62
8,123,32,3,139,154,-15
8,123,35,1,87,0,87
8,123,46,103,0,52,-52
8,123,48,29,101,59,42
8,123,48,113,81,68,13
8,123,48,121,66,0,66
8,123,48,141,79,101,-22
8,123,48,201,105,87,18
8,123,48,439,115,0,115
8,123,49,35,63,0,63
8,123,53,33,0,69,-69
8,123,56,1,84,0,84
8,123,56,21,271,332,-61
8,123,56,25,114,0,114
8,123,56,37,62,0,62
8,125,8,123,0,71,-71
9,1,4,13,225,414,-189
9,1,4,19,0,62,-62
9,1,6,1,99,106,-7
9,1,6,13,72,111,-39
9,1,6,37,523,693,-170
9,1,6,41,0,82,-82
9,1,6,59,144,272,-128
9,1,6,65,0,75,-75
9,1,6,73,155,318,-163
9,1,6,75,149,236,-87
9,1,6,81,107,124,-17
9,1,6,85,109,194,-85
9,1,8,5,0,66,-66
9,1,8,13,0,129,-129
9,1,8,31,77,229,-152
9,1,8,59,0,80,-80
9,1,9,3,1154,1444,-290
9,1,9,5,1274,2010,-736
9,1,9,7,252,353,-101
9,1,9,9,7050,10983,-3933
9,1,9,11,237,297,-60
9,1,9,13,148,110,38
9,1,9,15,56,0,56
9,1,10,3,65,65,0
9,1,10,5,0,62,-62
9,1,11,1,192,282,-90
9,1,12,9,0,143,-143
9,1,12,11,274,409,-135
9,1,12,15,0,77,-77
9,1,12,21,115,372,-257
9,1,12,31,57,144,-87
9,1,12,35,0,86,-86
9,1,12,57,147,257,-110
9,1,12,61,0,238,-238
9,1,12,71,111,298,-187
9,1,12,81,0,134,-134
9,1,12,85,53,94,-41
9,1,12,86,210,432,-222
9,1,12,95,188,417,-229
9,1,12,97,0,110,-110
9,1,12,99,424,1070,-646
9,1,12,101,0,105,-105
9,1,12,103,120,333,-213
9,1,12,105,54,106,-52
9,1,12,109,0,123,-123
9,1,12,111,94,178,-84
9,1,12,115,93,347,-254
9,1,12,117,56,115,-59
9,1,12,119,0,52,-52
9,1,12,127,0,124,-124
9,1,13,67,87,137,-50
9,1,13,89,60,143,-83
9,1,13,121,123,245,-122
9,1,13,135,70,135,-65
9,1,17,31,360,410,-50
9,1,17,43,0,90,-90
9,1,23,5,60,93,-33
9,1,24,3,0,75,-75
9,1,24,5,64,61,3
9,1,24,27,0,68,-68
9,1,24,31,160,202,-42
9,1,24,33,0,59,-59
9,1,24,510,79,81,-2
9,1,25,1,81,210,-129
9,1,25,5,0,81,-81
9,1,25,9,144,144,0
9,1,25,13,93,101,-8
9,1,25,17,486,721,-235
9,1,25,21,178,279,-101
9,1,25,23,72,137,-65
9,1,25,25,348,527,-179
9,1,25,27,120,144,-24
9,1,26,125,66,77,-11
9,1,27,53,91,77,14
9,1,29,189,0,81,-81
9,1,32,3,60,134,-74
9,1,33,9,0,49,-49
9,1,33,11,62,131,-69
9,1,33,15,59,83,-24
9,1,34,3,403,354,49
9,1,34,5,69,0,69
9,1,34,13,209,234,-25
9,1,34,17,539,432,107
9,1,34,21,68,104,-36
9,1,34,23,205,279,-74
9,1,34,25,107,120,-13
9,1,34,27,170,176,-6
9,1,34,29,89,69,20
9,1,34,31,109,60,49
9,1,34,35,132,134,-2
9,1,34,39,93,100,-7
9,1,36,1,79,57,22
9,1,36,5,2716,846,1870
9,1,36,27,413,323,90
9,1,36,29,66,66,0
9,1,36,47,1787,1195,592
9,1,36,55,78,85,-7
9,1,36,59,795,353,442
9,1,36,61,4051,3446,605
9,1,36,67,78,72,6
9,1,36,71,202,128,74
9,1,36,79,852,283,569
9,1,36,81,1799,943,856
9,1,36,85,99,58,41
9,1,36,87,293,195,98
9,1,36,91,73,53,20
9,1,36,103,597,467,130
9,1,36,111,66,77,-11
9,1,36,119,6664,2815,3849
9,1,37,19,0,148,-148
9,1,37,63,0,77,-77
9,1,37,81,0,70,-70
9,1,37,119,144,408,-264
9,1,37,129,0,87,-87
9,1,37,133,0,72,-72
9,1,37,179,0,103,-103
9,1,37,183,125,400,-275
9,1,39,35,59,67,-8
9,1,39,49,0,83,-83
9,1,39,61,430,108,322
9,1,41,51,0,72,-72
9,1,42,3,89,130,-41
9,1,42,17,82,90,-8
9,1,42,29,70,78,-8
9,1,42,45,0,62,-62
9,1,42,77,0,63,-63
9,1,42,91,104,119,-15
9,1,42,101,118,273,-155
9,1,44,5,0,72,-72
9,1,44,7,111,172,-61
9,1,44,9,0,107,-107
9,1,45,13,0,145,-145
9,1,45,15,0,100,-100
9,1,45,19,77,202,-125
9,1,45,45,0,94,-94
9,1,45,51,60,180,-120
9,1,45,79,0,51,-51
9,1,45,91,0,90,-90
9,1,47,37,56,95,-39
9,1,48,29,0,91,-91
9,1,48,85,83,146,-63
9,1,48,113,160,302,-142
9,1,48,121,78,116,-38
9,1,48,157,0,101,-101
9,1,48,201,206,361,-155
9,1,48,439,78,135,-57
9,1,48,453,131,278,-147
9,1,48,491,0,52,-52
9,1,49,35,0,77,-77
9,1,50,7,0,77,-77
9,1,50,25,0,57,-57
9,1,51,13,95,92,3
9,1,51,59,122,226,-104
9,1,51,87,0,66,-66
9,1,51,107,52,78,-26
9,1,51,510,0,77,-77
9,1,51,810,0,64,-64
9,1,53,33,136,249,-113
9,3,4,13,213,357,-144
9,3,4,19,0,109,-109
9,3,6,1,59,103,-44
9,3,6,13,0,87,-87
9,3,6,37,326,421,-95
9,3,6,59,73,158,-85
9,3,6,71,64,0,64
9,3,6,73,208,234,-26
9,3,6,75,0,78,-78
9,3,6,85,0,111,-111
9,3,8,5,0,62,-62
9,3,8,31,0,135,-135
9,3,8,41,0,56,-56
9,3,8,59,0,58,-58
9,3,9,1,1444,1154,290
9,3,9,5,2309,2053,256
9,3,9,7,3110,3497,-387
9,3,9,9,5701,4607,1094
9,3,9,11,1191,1360,-169
9,3,9,13,4374,5427,-1053
9,3,9,15,535,497,38
9,3,10,3,94,78,16
9,3,11,1,109,168,-59
9,3,12,9,91,224,-133
9,3,12,11,222,325,-103
9,3,12,15,0,127,-127
9,3,12,21,52,212,-160
9,3,12,31,98,173,-75
9,3,12,35,0,58,-58
9,3,12,57,192,468,-276
9,3,12,61,0,141,-141
9,3,12,69,0,130,-130
9,3,12,71,132,283,-151
9,3,12,81,0,194,-194
9,3,12,83,0,77,-77
9,3,12,85,0,99,-99
9,3,12,86,117,191,-74
9,3,12,95,250,350,-100
9,3,12,97,111,149,-38
9,3,12,99,291,614,-323
9,3,12,101,77,209,-132
9,3,12,103,157,302,-145
9,3,12,105,105,244,-139
9,3,12,109,0,86,-86
9,3,12,111,92,178,-86
9,3,12,115,87,254,-167
9,3,12,117,68,132,-64
9,3,12,119,0,61,-61
9,3,12,127,75,180,-105
9,3,13,67,0,133,-133
9,3,13,89,78,160,-82
9,3,13,121,86,196,-110
9,3,13,135,0,135,-135
9,3,15,3,0,46,-46
9,3,17,31,254,287,-33
9,3,17,43,0,72,-72
9,3,23,5,88,182,-94
9,3,23,31,57,94,-37
9,3,24,3,59,0,59
9,3,24,5,91,90,1
9,3,24,31,104,152,-48
9,3,24,33,65,74,-9
9,3,24,510,51,95,-44
9,3,25,1,109,255,-146
9,3,25,3,100,102,-2
9,3,25,5,93,94,-1
9,3,25,9,180,166,14
9,3,25,11,52,49,3
9,3,25,13,2384,1687,697
9,3,25,15,286,214,72
9,3,25,17,616,790,-174
9,3,25,21,221,368,-147
9,3,25,23,89,125,-36
9,3,25,25,348,540,-192
9,3,25,27,464,409,55
9,3,26,125,0,84,-84
9,3,26,163,0,58,-58
9,3,27,53,113,117,-4
9,3,32,3,93,146,-53
9,3,33,5,0,56,-56
9,3,33,9,0,69,-69
9,3,33,11,135,167,-32
9,3,33,13,0,73,-73
9,3,33,15,79,116,-37
9,3,34,3,125,107,18
9,3,34,13,90,88,2
9,3,34,17,203,173,30
9,3,34,23,189,206,-17
9,3,34,27,81,106,-25
9,3,34,31,65,0,65
9,3,34,35,0,83,-83
9,3,34,39,0,54,-54
9,3,36,1,103,80,23
9,3,36,5,498,211,287
9,3,36,27,70,63,7
9,3,36,29,71,68,3
9,3,36,47,660,471,189
9,3,36,55,96,81,15
9,3,36,59,202,142,60
9,3,36,61,393,573,-180
9,3,36,67,77,0,77
9,3,36,81,537,299,238
9,3,36,85,71,0,71
9,3,36,91,0,60,-60
9,3,36,103,204,125,79
9,3,36,119,297,187,110
9,3,37,19,0,73,-73
9,3,37,25,0,62,-62
9,3,37,51,0,58,-58
9,3,37,63,0,45,-45
9,3,37,81,0,55,-55
9,3,37,119,215,429,-214
9,3,37,179,0,77,-77
9,3,37,183,115,209,-94
9,3,39,35,83,71,12
9,3,39,49,83,123,-40
9,3,41,51,0,58,-58
9,3,42,3,109,139,-30
9,3,42,29,52,93,-41
9,3,42,45,0,68,-68
9,3,42,77,54,89,-35
9,3,42,91,82,109,-27
9,3,42,101,161,179,-18
9,3,44,3,67,0,67
9,3,44,5,55,74,-19
9,3,44,7,269,271,-2
9,3,44,9,96,243,-147
9,3,45,13,0,98,-98
9,3,45,19,0,123,-123
9,3,45,45,0,81,-81
9,3,45,51,56,333,-277
9,3,45,79,0,69,-69
9,3,45,91,0,115,-115
9,3,47,37,0,85,-85
9,3,47,157,0,67,-67
9,3,48,29,67,115,-48
9,3,48,85,78,149,-71
9,3,48,113,84,179,-95
9,3,48,201,177,174,3
9,3,48,439,91,69,22
9,3,48,453,102,114,-12
9,3,48,491,0,80,-80
9,3,49,35,0,83,-83
9,3,50,7,61,75,-14
9,3,50,25,0,71,-71
9,3,51,13,0,63,-63
9,3,51,59,111,139,-28
9,3,51,107,0,66,-66
9,3,51,810,0,83,-83
9,3,53,33,138,225,-87
9,3,55,25,0,53,-53
9,3,55,79,0,70,-70
9,5,6,37,0,65,-65
9,5,9,1,2010,1274,736
9,5,9,3,2053,2309,-256
9,5,9,7,127,175,-48
9,5,9,9,2902,2098,804
9,5,9,11,99,96,3
9,5,9,13,90,85,5
9,5,12,15,0,52,-52
9,5,12,21,0,74,-74
9,5,12,71,0,70,-70
9,5,12,99,0,85,-85
9,5,12,103,0,55,-55
9,5,25,3,133,113,20
9,5,25,13,0,62,-62
9,5,25,17,74,95,-21
9,5,25,25,52,79,-27
9,5,36,5,99,76,23
9,5,36,27,248,131,117
9,5,36,47,149,85,64
9,5,36,59,67,0,67
9,5,36,61,282,189,93
9,5,36,79,67,0,67
9,5,36,81,96,48,48
9,5,36,103,74,0,74
9,5,36,119,195,111,84
9,5,45,51,0,110,-110
9,7,6,37,0,79,-79
9,7,6,73,0,48,-48
9,7,9,1,353,252,101
9,7,9,3,3497,3110,387
9,7,9,5,175,127,48
9,7,9,9,3188,2248,940
9,7,9,11,1139,1138,1
9,7,9,13,329,311,18
9,7,9,15,121,90,31
9,7,12,11,0,52,-52
9,7,12,57,0,55,-55
9,7,12,71,0,97,-97
9,7,12,99,60,102,-42
9,7,12,103,0,52,-52
9,7,25,13,67,52,15
9,7,25,17,92,93,-1
9,7,25,25,57,77,-20
9,7,25,27,64,72,-8
9,7,36,47,84,86,-2
9,7,36,61,88,100,-12
9,7,36,81,73,0,73
9,7,44,7,0,54,-54
9,7,45,51,0,77,-77
9,9,4,13,143,255,-112
9,9,4,19,0,68,-68
9,9,6,1,89,114,-25
9,9,6,37,306,459,-153
9,9,6,59,64,128,-64
9,9,6,65,0,67,-67
9,9,6,73,189,246,-57
9,9,6,75,76,129,-53
9,9,6,81,0,79,-79
9,9,6,85,86,184,-98
9,9,8,13,0,46,-46
9,9,8,31,64,114,-50
9,9,8,59,0,50,-50
9,9,9,1,10983,7050,3933
9,9,9,3,4607,5701,-1094
9,9,9,5,2098,2902,-804
9,9,9,7,2248,3188,-940
9,9,9,11,642,775,-133
9,9,9,13,325,385,-60
9,9,9,15,148,175,-27
9,9,10,3,0,57,-57
9,9,11,1,165,223,-58
9,9,12,9,75,110,-35
9,9,12,11,189,243,-54
9,9,12,15,0,107,-107
9,9,12,21,89,196,-107
9,9,12,31,66,153,-87
9,9,12,57,170,319,-149
9,9,12,61,0,71,-71
9,9,12,69,0,131,-131
9,9,12,71,106,310,-204
9,9,12,81,0,136,-136
9,9,12,83,0,123,-123
9,9,12,85,0,58,-58
9,9,12,86,136,148,-12
9,9,12,95,189,387,-198
9,9,12,97,0,150,-150
9,9,12,99,234,454,-220
9,9,12,101,56,127,-71
9,9,12,103,91,203,-112
9,9,12,105,100,246,-146
9,9,12,109,0,80,-80
9,9,12,111,0,142,-142
9,9,12,115,51,206,-155
9,9,12,117,0,91,-91
9,9,12,119,0,56,-56
9,9,12,127,73,155,-82
9,9,13,67,0,101,-101
9,9,13,89,51,93,-42
9,9,13,121,64,144,-80
9,9,13,135,65,123,-58
9,9,15,3,60,0,60
9,9,17,31,216,257,-41
9,9,23,5,43,114,-71
9,9,23,31,0,83,-83
9,9,24,3,0,65,-65
9,9,24,31,79,169,-90
9,9,24,33,0,61,-61
9,9,24,510,79,107,-28
9,9,25,1,56,136,-80
9,9,25,5,97,68,29
9,9,25,9,131,144,-13
9,9,25,13,214,226,-12
9,9,25,15,72,73,-1
9,9,25,17,427,739,-312
9,9,25,21,201,310,-109
9,9,25,23,54,0,54
9,9,25,25,313,527,-214
9,9,25,27,165,253,-88
9,9,26,125,0,58,-58
9,9,26,161,60,55,5
9,9,27,53,52,63,-11
9,9,32,3,84,120,-36
9,9,33,9,0,68,-68
9,9,33,11,62,115,-53
9,9,33,15,61,74,-13
9,9,34,3,145,133,12
9,9,34,13,100,96,4
9,9,34,17,122,130,-8
9,9,34,21,69,111,-42
9,9,34,23,128,172,-44
9,9,34,25,61,0,61
9,9,34,27,83,87,-4
9,9,34,31,0,59,-59
9,9,34,35,0,62,-62
9,9,34,39,61,0,61
9,9,36,1,61,57,4
9,9,36,5,1399,446,953
9,9,36,27,101,86,15
9,9,36,29,59,0,59
9,9,36,47,926,700,226
9,9,36,55,89,78,11
9,9,36,59,254,114,140
9,9,36,61,940,942,-2
9,9,36,67,74,0,74
9,9,36,71,91,58,33
9,9,36,79,52,0,52
9,9,36,81,958,440,518
9,9,36,85,97,0,97
9,9,36,87,93,0,93
9,9,36,103,328,178,150
9,9,36,111,61,0,61
9,9,36,119,741,388,353
9,9,37,19,0,64,-64
9,9,37,21,0,49,-49
9,9,37,63,73,114,-41
9,9,37,119,90,244,-154
9,9,37,133,0,85,-85
9,9,37,147,0,56,-56
9,9,37,183,105,203,-98
9,9,39,35,66,72,-6
9,9,39,49,60,111,-51
9,9,41,51,0,89,-89
9,9,42,3,71,118,-47
9,9,42,17,0,72,-72
9,9,42,29,0,81,-81
9,9,42,45,0,76,-76
9,9,42,91,48,73,-25
9,9,42,101,191,236,-45
9,9,44,3,58,44,14
9,9,44,7,182,230,-48
9,9,44,9,65,111,-46
9,9,45,13,0,81,-81
9,9,45,19,0,85,-85
9,9,45,45,0,88,-88
9,9,45,51,75,290,-215
9,9,45,63,0,57,-57
9,9,45,91,0,60,-60
9,9,47,37,64,69,-5
9,9,48,29,83,111,-28
9,9,48,85,0,71,-71
9,9,48,113,74,90,-16
9,9,48,121,0,68,-68
9,9,48,201,144,192,-48
9,9,48,439,71,95,-24
9,9,48,453,106,172,-66
9,9,49,35,79,81,-2
9,9,50,7,0,73,-73
9,9,51,13,53,43,10
9,9,51,59,102,129,-27
9,9,51,810,0,65,-65
9,9,53,33,105,189,-84
9,9,55,25,52,0,52
9,11,4,13,78,99,-21
9,11,6,37,89,101,-12
9,11,6,59,0,57,-57
9,11,6,73,187,266,-79
9,11,9,1,297,237,60
9,11,9,3,1360,1191,169
9,11,9,5,96,99,-3
9,11,9,7,1138,1139,-1
9,11,9,9,775,642,133
9,11,9,13,412,434,-22
9,11,9,15,1575,1320,255
9,11,11,1,0,58,-58
9,11,12,9,0,82,-82
9,11,12,11,79,83,-4
9,11,12,21,0,62,-62
9,11,12,31,0,109,-109
9,11,12,57,0,75,-75
9,11,12,71,54,77,-23
9,11,12,86,61,49,12
9,11,12,95,0,79,-79
9,11,12,99,94,64,30
9,11,12,103,68,135,-67
9,11,12,105,0,71,-71
9,11,12,115,0,102,-102
9,11,12,127,0,52,-52
9,11,13,39,198,231,-33
9,11,15,3,255,419,-164
9,11,17,31,0,67,-67
9,11,23,5,0,49,-49
9,11,23,31,70,145,-75
9,11,24,31,63,63,0
9,11,25,1,0,53,-53
9,11,25,5,115,78,37
9,11,25,9,0,63,-63
9,11,25,13,97,82,15
9,11,25,17,128,206,-78
9,11,25,21,69,98,-29
9,11,25,23,51,0,51
9,11,25,25,97,154,-57
9,11,25,27,134,134,0
9,11,32,3,0,66,-66
9,11,33,15,66,116,-50
9,11,33,17,0,84,-84
9,11,36,5,110,0,110
9,11,36,47,172,149,23
9,11,36,59,61,0,61
9,11,36,61,121,124,-3
9,11,36,81,171,141,30
9,11,36,91,215,0,215
9,11,36,103,100,50,50
9,11,44,3,216,158,58
9,11,44,5,58,60,-2
9,11,44,7,332,245,87
9,11,44,9,973,650,323
9,11,45,15,222,114,108
9,11,45,19,56,70,-14
9,11,45,51,0,80,-80
9,11,51,59,0,73,-73
9,11,51,550,68,138,-70
9,11,51,710,105,111,-6
9,11,51,810,106,189,-83
9,11,53,33,0,84,-84
9,11,53,35,230,390,-160
9,13,4,13,0,71,-71
9,13,6,37,0,42,-42
9,13,9,1,110,148,-38
9,13,9,3,5427,4374,1053
9,13,9,5,85,90,-5
9,13,9,7,311,329,-18
9,13,9,9,385,325,60
9,13,9,11,434,412,22
9,13,9,15,1001,863,138
9,13,12,99,0,60,-60
9,13,12,103,0,55,-55
9,13,25,13,404,266,138
9,13,25,15,69,73,-4
9,13,25,17,86,159,-73
9,13,25,21,0,51,-51
9,13,25,25,58,114,-56
9,13,25,27,195,131,64
9,13,36,47,0,61,-61
9,13,36,61,0,54,-54
9,13,44,7,0,44,-44
9,13,44,9,0,72,-72
9,13,45,51,0,96,-96
9,15,9,1,0,56,-56
9,15,9,3,497,535,-38
9,15,9,7,90,121,-31
9,15,9,9,175,148,27
9,15,9,11,1320,1575,-255
9,15,9,13,863,1001,-138
9,15,25,5,84,0,84
9,15,25,13,61,56,5
9,15,25,17,70,75,-5
9,15,25,25,0,70,-70
9,15,25,27,1226,475,751
9,15,44,3,311,121,190
9,15,44,7,652,287,365
9,15,44,9,101,56,45
10,1,10,3,3040,2156,884
10,1,10,5,2133,2243,-110
10,1,12,99,62,0,62
10,1,15,3,0,54,-54
10,1,24,3,92,109,-17
10,1,24,5,84,56,28
10,1,24,11,181,127,54
10,1,24,15,181,121,60
10,1,24,25,68,0,68
10,1,24,29,68,86,-18
10,1,24,33,133,92,41
10,1,24,35,120,104,16
10,1,24,45,94,158,-64
10,1,32,3,0,63,-63
10,1,34,5,131,69,62
10,1,34,7,110,75,35
10,1,34,13,96,0,96
10,1,34,15,98,0,98
10,1,34,17,66,0,66
10,1,34,23,100,0,100
10,1,34,31,57,0,57
10,1,34,35,60,0,60
10,1,36,5,83,0,83
10,1,36,47,143,59,84
10,1,36,59,57,0,57
10,1,36,81,147,0,147
10,1,36,103,93,0,93
10,1,42,17,78,0,78
10,1,42,29,94,55,39
10,1,42,45,215,70,145
10,1,42,91,78,57,21
10,1,42,101,434,164,270
10,1,48,29,65,133,-68
10,1,51,59,62,65,-3
10,3,4,13,141,229,-88
10,3,6,37,158,229,-71
10,3,6,59,0,82,-82
10,3,6,67,0,65,-65
10,3,6,73,107,73,34
10,3,6,85,50,102,-52
10,3,8,31,0,53,-53
10,3,9,1,65,65,0
10,3,9,3,78,94,-16
10,3,9,9,57,0,57
10,3,10,1,2156,3040,-884
10,3,10,5,844,1552,-708
10,3,11,1,110,145,-35
10,3,12,9,0,67,-67
10,3,12,11,114,100,14
10,3,12,31,0,110,-110
10,3,12,57,140,220,-80
10,3,12,71,0,111,-111
10,3,12,86,0,95,-95
10,3,12,95,104,138,-34
10,3,12,99,146,153,-7
10,3,12,103,0,100,-100
10,3,12,105,0,99,-99
10,3,12,117,0,65,-65
10,3,12,127,0,57,-57
10,3,13,67,0,69,-69
10,3,13,89,0,79,-79
10,3,13,121,80,110,-30
10,3,13,135,0,91,-91
10,3,17,31,179,155,24
10,3,24,3,108,156,-48
10,3,24,5,271,202,69
10,3,24,15,1654,1853,-199
10,3,24,25,194,292,-98
10,3,24,27,112,118,-6
10,3,24,29,59,118,-59
10,3,24,31,141,180,-39
10,3,24,33,164,194,-30
10,3,24,45,59,0,59
10,3,24,47,0,53,-53
10,3,24,510,172,200,-28
10,3,25,17,102,121,-19
10,3,25,25,0,62,-62
10,3,32,3,0,85,-85
10,3,34,1,145,66,79
10,3,34,3,129,69,60
10,3,34,5,308,147,161
10,3,34,7,436,283,153
10,3,34,9,0,60,-60
10,3,34,11,123,98,25
10,3,34,13,238,90,148
10,3,34,15,422,284,138
10,3,34,17,203,169,34
10,3,34,21,119,74,45
10,3,34,23,361,215,146
10,3,34,25,97,0,97
10,3,34,27,110,89,21
10,3,34,29,97,67,30
10,3,34,31,68,0,68
10,3,34,33,410,282,128
10,3,34,35,84,85,-1
10,3,34,39,99,58,41
10,3,36,5,241,86,155
10,3,36,29,59,49,10
10,3,36,47,347,178,169
10,3,36,59,125,73,52
10,3,36,61,166,260,-94
10,3,36,81,297,131,166
10,3,36,85,84,0,84
10,3,36,103,149,69,80
10,3,36,119,98,82,16
10,3,37,63,0,74,-74
10,3,37,81,0,98,-98
10,3,37,119,181,160,21
10,3,37,183,134,141,-7
10,3,39,49,89,70,19
10,3,42,3,118,114,4
10,3,42,11,105,63,42
10,3,42,17,273,224,49
10,3,42,29,1854,2108,-254
10,3,42,43,63,58,5
10,3,42,45,3327,2103,1224
10,3,42,71,186,178,8
10,3,42,77,74,87,-13
10,3,42,79,74,0,74
10,3,42,91,611,459,152
10,3,42,101,2603,1833,770
10,3,42,133,73,62,11
10,3,45,51,0,117,-117
10,3,48,29,0,78,-78
10,3,48,85,59,64,-5
10,3,48,113,111,140,-29
10,3,48,201,135,142,-7
10,3,48,439,0,104,-104
10,3,48,453,81,67,14
10,3,51,13,54,54,0
10,3,51,59,169,214,-45
10,3,51,87,62,0,62
10,3,51,107,0,90,-90
10,3,51,810,81,0,81
10,3,53,33,56,133,-77
10,5,4,13,0,61,-61
10,5,6,73,0,52,-52
10,5,9,1,62,0,62
10,5,10,1,2243,2133,110
10,5,10,3,1552,844,708
10,5,11,1,150,67,83
10,5,12,11,98,88,10
10,5,12,71,0,86,-86
10,5,12,99,82,80,2
10,5,12,103,0,47,-47
10,5,12,115,0,57,-57
10,5,24,3,616,196,420
10,5,24,5,675,177,498
10,5,24,9,97,0,97
10,5,24,11,192,191,1
10,5,24,13,181,50,131
10,5,24,15,165,68,97
10,5,24,17,82,0,82
10,5,24,19,168,146,22
10,5,24,21,168,56,112
10,5,24,25,312,92,220
10,5,24,27,300,84,216
10,5,24,31,595,141,454
10,5,24,33,204,69,135
10,5,24,35,103,55,48
10,5,24,39,69,62,7
10,5,24,41,77,56,21
10,5,24,45,1055,949,106
10,5,24,47,468,363,105
10,5,24,510,172,73,99
10,5,34,3,141,0,141
10,5,34,5,85,0,85
10,5,34,7,94,0,94
10,5,34,13,57,0,57
10,5,34,15,80,0,80
10,5,34,21,68,0,68
10,5,34,23,160,0,160
10,5,34,25,136,0,136
10,5,34,27,168,0,168
10,5,34,29,122,54,68
10,5,34,31,64,0,64
10,5,34,35,108,0,108
10,5,34,39,70,0,70
10,5,36,27,53,0,53
10,5,36,47,74,59,15
10,5,36,59,110,0,110
10,5,36,71,73,0,73
10,5,36,81,62,0,62
10,5,36,103,139,0,139
10,5,36,119,78,0,78
10,5,42,3,68,0,68
10,5,42,11,151,0,151
10,5,42,17,148,60,88
10,5,42,29,409,90,319
10,5,42,41,58,0,58
10,5,42,43,123,0,123
10,5,42,45,272,118,154
10,5,42,71,131,96,35
10,5,42,77,98,0,98
10,5,42,91,232,126,106
10,5,42,95,76,0,76
10,5,42,101,202,142,60
10,5,42,133,270,96,174
10,5,45,19,0,56,-56
10,5,51,1,104,0,104
10,5,51,13,56,0,56
10,5,51,59,348,113,235
10,5,51,107,99,0,99
10,5,51,153,58,0,58
10,5,51,510,67,0,67
10,5,51,710,143,94,49
11,1,1,73,74,0,74
11,1,2,20,48,0,48
11,1,4,13,293,280,13
11,1,4,19,96,108,-12
11,1,5,119,71,0,71
11,1,6,1,366,529,-163
11,1,6,13,100,122,-22
11,1,6,37,962,1384,-422
11,1,6,41,66,64,2
11,1,6,59,238,260,-22
11,1,6,65,80,88,-8
11,1,6,67,107,138,-31
11,1,6,71,68,58,10
11,1,6,73,418,561,-143
11,1,6,75,438,915,-477
11,1,6,81,113,199,-86
11,1,6,83,63,59,4
11,1,6,85,257,320,-63
11,1,6,111,63,49,14
11,1,8,5,76,85,-9
11,1,8,13,77,105,-28
11,1,8,31,231,626,-395
11,1,8,41,120,97,23
11,1,8,59,54,96,-42
11,1,9,1,282,192,90
11,1,9,3,168,109,59
11,1,9,9,223,165,58
11,1,9,11,58,0,58
11,1,10,3,145,110,35
11,1,10,5,67,150,-83
11,1,12,1,77,0,77
11,1,12,11,235,321,-86
11,1,12,21,0,47,-47
11,1,12,31,133,100,33
11,1,12,33,0,61,-61
11,1,12,57,219,198,21
11,1,12,71,57,58,-1
11,1,12,73,81,67,14
11,1,12,86,531,438,93
11,1,12,95,184,148,36
11,1,12,99,168,213,-45
11,1,12,103,101,121,-20
11,1,12,115,50,68,-18
11,1,12,117,46,0,46
11,1,12,127,0,44,-44
11,1,13,51,0,46,-46
11,1,13,67,117,88,29
11,1,13,89,221,227,-6
11,1,13,121,449,495,-46
11,1,13,135,81,71,10
11,1,15,3,171,196,-25
11,1,17,31,1066,1324,-258
11,1,17,43,73,67,6
11,1,17,97,69,65,4
11,1,18,97,101,79,22
11,1,20,91,46,0,46
11,1,21,67,0,81,-81
11,1,21,111,68,90,-22
11,1,22,71,114,149,-35
11,1,23,5,95,155,-60
11,1,24,3,692,855,-163
11,1,24,5,399,359,40
11,1,24,9,86,98,-12
11,1,24,13,44,0,44
11,1,24,17,513,871,-358
11,1,24,21,240,229,11
11,1,24,25,61,57,4
11,1,24,27,449,373,76
11,1,24,31,6781,8632,-1851
11,1,24,33,11092,14297,-3205
11,1,24,37,95,107,-12
11,1,24,41,0,56,-56
11,1,24,43,71,108,-37
11,1,24,510,844,1212,-368
11,1,25,1,41,62,-21
11,1,25,9,104,82,22
11,1,25,15,42,0,42
11,1,25,17,820,753,67
11,1,25,21,156,194,-38
11,1,25,23,63,0,63
11,1,25,25,526,556,-30
11,1,25,27,88,0,88
11,1,26,81,45,0,45
11,1,26,125,149,99,50
11,1,26,161,140,205,-65
11,1,26,163,125,135,-10
11,1,27,53,197,291,-94
11,1,27,123,62,93,-31
11,1,29,95,92,62,30
11,1,29,189,93,82,11
11,1,29,510,80,99,-19
11,1,32,3,149,223,-74
11,1,33,11,69,0,69
11,1,33,15,0,54,-54
11,1,34,3,133,114,19
11,1,34,5,71,53,18
11,1,34,7,64,44,20
11,1,34,13,107,101,6
11,1,34,17,184,214,-30
11,1,34,21,139,100,39
11,1,34,23,114,87,27
11,1,34,25,112,83,29
11,1,34,27,119,73,46
11,1,34,35,82,46,36
11,1,34,39,62,53,9
11,1,35,1,79,75,4
11,1,36,1,49,0,49
11,1,36,5,98,91,7
11,1,36,27,59,0,59
11,1,36,29,100,84,16
11,1,36,47,925,1261,-336
11,1,36,55,124,88,36
11,1,36,59,207,148,59
11,1,36,61,1777,2434,-657
11,1,36,67,96,67,29
11,1,36,81,291,240,51
11,1,36,103,118,116,2
11,1,36,109,56,44,12
11,1,36,119,198,132,66
11,1,37,21,0,57,-57
11,1,37,51,97,74,23
11,1,37,63,260,333,-73
11,1,37,67,75,60,15
11,1,37,81,112,87,25
11,1,37,119,271,361,-90
11,1,37,133,0,67,-67
11,1,37,135,115,110,5
11,1,37,183,308,337,-29
11,1,39,35,231,163,68
11,1,39,49,200,165,35
11,1,39,61,123,74,49
11,1,39,153,46,0,46
11,1,40,109,62,0,62
11,1,41,51,151,244,-93
11,1,42,3,320,295,25
11,1,42,17,87,63,24
11,1,42,27,51,0,51
11,1,42,29,114,70,44
11,1,42,41,55,0,55
11,1,42,43,0,55,-55
11,1,42,45,74,86,-12
11,1,42,71,56,53,3
11,1,42,91,167,199,-32
11,1,42,101,583,841,-258
11,1,44,7,106,96,10
11,1,45,19,145,201,-56
11,1,45,45,48,46,2
11,1,45,51,58,0,58
11,1,45,79,77,76,1
11,1,47,37,228,220,8
11,1,47,93,82,0,82
11,1,47,157,87,65,22
11,1,48,29,168,186,-18
11,1,48,85,74,64,10
11,1,48,113,282,254,28
11,1,48,121,57,0,57
11,1,48,141,82,0,82
11,1,48,157,66,0,66
11,1,48,201,413,338,75
11,1,48,439,135,93,42
11,1,48,453,378,528,-150
11,1,49,35,86,77,9
11,1,50,7,70,58,12
11,1,51,3,107,119,-12
11,1,51,13,5509,4374,1135
11,1,51,41,71,51,20
11,1,51,59,3441,3717,-276
11,1,51,61,72,69,3
11,1,51,87,142,138,4
11,1,51,95,51,0,51
11,1,51,107,650,714,-64
11,1,51,153,502,677,-175
11,1,51,177,0,88,-88
11,1,51,179,102,127,-25
11,1,51,510,1685,2324,-639
11,1,51,540,149,120,29
11,1,51,610,103,123,-20
11,1,51,630,43,0,43
11,1,51,710,165,126,39
11,1,51,760,233,242,-9
11,1,51,810,149,161,-12
11,1,53,33,440,807,-367
11,1,53,35,0,76,-76
11,1,53,53,63,79,-16
11,1,54,3,0,52,-52
11,1,55,25,148,117,31
11,1,55,79,109,66,43
12,1,4,13,60,77,-17
12,1,6,1,0,56,-56
12,1,6,37,117,131,-14
12,1,6,73,0,98,-98
12,1,6,75,0,43,-43
12,1,6,85,0,149,-149
12,1,8,31,49,83,-34
12,1,11,1,0,77,-77
12,1,12,5,107,0,107
12,1,12,7,290,286,4
12,1,12,9,232,248,-16
12,1,12,11,728,543,185
12,1,12,17,140,149,-9
12,1,12,19,388,432,-44
12,1,12,21,98,72,26
12,1,12,23,545,759,-214
12,1,12,29,59,72,-13
12,1,12,31,706,930,-224
12,1,12,33,79,117,-38
12,1,12,35,66,108,-42
12,1,12,41,345,473,-128
12,1,12,53,78,57,21
12,1,12,55,55,0,55
12,1,12,57,559,730,-171
12,1,12,61,0,73,-73
12,1,12,69,213,236,-23
12,1,12,71,209,189,20
12,1,12,73,273,273,0
12,1,12,75,694,750,-56
12,1,12,81,113,121,-8
12,1,12,83,1130,1179,-49
12,1,12,85,0,63,-63
12,1,12,86,876,425,451
12,1,12,87,55,58,-3
12,1,12,89,0,54,-54
12,1,12,91,51,59,-8
12,1,12,95,544,820,-276
12,1,12,97,117,89,28
12,1,12,99,469,426,43
12,1,12,101,156,208,-52
12,1,12,103,317,513,-196
12,1,12,105,204,181,23
12,1,12,107,527,503,24
12,1,12,109,200,342,-142
12,1,12,111,120,127,-7
12,1,12,115,163,111,52
12,1,12,117,215,271,-56
12,1,12,119,67,62,5
12,1,12,121,133,135,-2
12,1,12,125,141,216,-75
12,1,12,127,276,284,-8
12,1,13,67,0,127,-127
12,1,13,89,62,167,-105
12,1,13,121,96,259,-163
12,1,13,135,57,117,-60
12,1,13,185,73,55,18
12,1,17,19,59,0,59
12,1,17,31,139,124,15
12,1,24,31,64,106,-42
12,1,25,17,56,104,-48
12,1,25,25,0,57,-57
12,1,32,3,0,76,-76
12,1,36,47,0,86,-86
12,1,36,61,81,81,0
12,1,36,81,0,44,-44
12,1,36,103,54,0,54
12,1,37,21,0,48,-48
12,1,37,63,0,67,-67
12,1,37,119,61,120,-59
12,1,37,183,0,110,-110
12,1,39,49,66,69,-3
12,1,41,51,0,55,-55
12,1,41,67,0,84,-84
12,1,45,45,0,67,-67
12,1,47,37,0,57,-57
12,1,47,65,0,54,-54
12,1,48,29,0,79,-79
12,1,48,113,44,49,-5
12,1,48,201,65,113,-48
12,1,48,453,79,98,-19
12,1,49,35,0,63,-63
12,1,51,59,68,0,68
12,1,53,33,0,209,-209
12,3,12,7,85,0,85
12,3,12,19,179,120,59
12,3,12,23,65,130,-65
12,3,12,31,887,510,377
12,3,12,89,96,66,30
12,3,12,125,0,74,-74
12,5,1,3,56,98,-42
12,5,1,31,66,80,-14
12,5,1,45,0,84,-84
12,5,1,69,156,385,-229
12,5,1,73,110,116,-6
12,5,1,81,57,0,57
12,5,1,89,81,106,-25
12,5,1,97,0,145,-145
12,5,1,117,60,86,-26
12,5,2,20,79,121,-42
12,5,4,13,93,159,-66
12,5,6,73,106,123,-17
12,5,8,41,82,108,-26
12,5,12,1,0,107,-107
12,5,12,9,0,142,-142
12,5,12,11,83,115,-32
12,5,12,13,133,108,25
12,5,12,31,156,292,-136
12,5,12,33,249,469,-220
12,5,12,37,51,0,51
12,5,12,45,365,352,13
12,5,12,57,142,369,-227
12,5,12,59,106,191,-85
12,5,12,63,222,344,-122
12,5,12,71,0,81,-81
12,5,12,73,320,554,-234
12,5,12,81,0,56,-56
12,5,12,83,0,87,-87
12,5,12,86,98,142,-44
12,5,12,91,365,839,-474
12,5,12,95,126,262,-136
12,5,12,97,0,70,-70
12,5,12,99,97,91,6
12,5,12,101,96,105,-9
12,5,12,103,100,137,-37
12,5,12,105,82,109,-27
12,5,12,113,125,330,-205
12,5,12,115,0,66,-66
12,5,12,117,0,80,-80
12,5,12,127,0,88,-88
12,5,12,129,0,62,-62
12,5,12,131,456,737,-281
12,5,12,133,497,888,-391
12,5,13,67,103,135,-32
12,5,13,77,62,0,62
12,5,13,89,79,55,24
12,5,13,117,51,0,51
12,5,13,121,90,114,-24
12,5,13,135,153,105,48
12,5,13,153,0,93,-93
12,5,13,215,60,80,-20
12,5,15,3,104,70,34
12,5,17,31,45,63,-18
12,5,21,111,57,0,57
12,5,28,47,87,123,-36
12,5,28,59,0,82,-82
12,5,32,3,97,163,-66
12,5,40,109,0,79,-79
12,5,47,37,0,55,-55
12,5,48,29,0,145,-145
12,5,48,113,69,80,-11
12,5,48,201,96,142,-46
12,5,48,439,84,0,84
12,5,51,810,67,104,-37
12,7,12,1,286,290,-4
12,7,12,3,0,85,-85
12,7,12,19,486,383,103
12,7,12,23,0,79,-79
12,7,12,31,277,181,96
12,7,12,107,122,79,43
12,7,12,125,156,216,-60
12,9,1,89,96,172,-76
12,9,2,20,57,0,57
12,9,4,13,188,222,-34
12,9,4,19,90,103,-13
12,9,6,1,69,0,69
12,9,6,37,391,238,153
12,9,6,59,139,88,51
12,9,6,65,107,0,107
12,9,6,71,86,0,86
12,9,6,73,322,163,159
12,9,6,85,104,69,35
12,9,8,5,121,103,18
12,9,8,31,78,75,3
12,9,8,41,341,301,40
12,9,8,59,90,92,-2
12,9,8,69,62,59,3
12,9,9,1,143,0,143
12,9,9,3,224,91,133
12,9,9,9,110,75,35
12,9,9,11,82,0,82
12,9,10,3,67,0,67
12,9,12,1,248,232,16
12,9,12,5,142,0,142
12,9,12,11,1351,670,681
12,9,12,15,87,65,22
12,9,12,17,122,117,5
12,9,12,19,141,156,-15
12,9,12,21,120,92,28
12,9,12,31,627,662,-35
12,9,12,33,115,132,-17
12,9,12,35,114,91,23
12,9,12,53,70,74,-4
12,9,12,55,87,64,23
12,9,12,57,633,764,-131
12,9,12,61,1106,1170,-64
12,9,12,69,395,361,34
12,9,12,71,332,177,155
12,9,12,73,210,198,12
12,9,12,81,113,164,-51
12,9,12,83,250,268,-18
12,9,12,85,188,133,55
12,9,12,86,1004,440,564
12,9,12,87,151,81,70
12,9,12,89,0,73,-73
12,9,12,91,173,169,4
12,9,12,95,3497,2900,597
12,9,12,97,952,579,373
12,9,12,99,1010,737,273
12,9,12,101,236,262,-26
12,9,12,103,375,448,-73
12,9,12,105,550,446,104
12,9,12,107,0,56,-56
12,9,12,109,201,264,-63
12,9,12,111,544,444,100
12,9,12,113,0,66,-66
12,9,12,115,138,129,9
12,9,12,117,1099,813,286
12,9,12,119,74,102,-28
12,9,12,127,811,992,-181
12,9,13,39,97,0,97
12,9,13,51,92,107,-15
12,9,13,57,0,87,-87
12,9,13,67,143,130,13
12,9,13,89,112,107,5
12,9,13,121,156,146,10
12,9,13,135,155,121,34
12,9,15,3,151,109,42
12,9,17,31,224,125,99
12,9,17,43,60,0,60
12,9,18,3,67,0,67
12,9,18,97,110,61,49
12,9,19,113,72,0,72
12,9,20,91,67,0,67
12,9,21,111,79,0,79
12,9,24,3,212,64,148
12,9,24,5,94,0,94
12,9,24,25,71,0,71
12,9,24,27,69,0,69
12,9,24,31,115,82,33
12,9,24,33,63,53,10
12,9,24,37,82,0,82
12,9,25,1,54,0,54
12,9,25,5,79,0,79
12,9,25,9,73,0,73
12,9,25,13,74,0,74
12,9,25,17,129,123,6
12,9,25,21,56,0,56
12,9,25,23,70,0,70
12,9,25,25,55,0,55
12,9,25,27,182,89,93
12,9,26,99,57,0,57
12,9,26,125,116,71,45
12,9,26,163,86,101,-15
12,9,27,53,80,0,80
12,9,29,95,81,0,81
12,9,29,183,75,0,75
12,9,29,189,131,0,131
12,9,32,3,214,226,-12
12,9,33,11,86,77,9
12,9,33,15,62,0,62
12,9,34,1,53,0,53
12,9,34,3,66,0,66
12,9,34,13,92,0,92
12,9,34,15,64,0,64
12,9,34,23,79,0,79
12,9,34,25,85,0,85
12,9,34,27,70,0,70
12,9,34,29,127,52,75
12,9,35,1,89,0,89
12,9,36,5,114,0,114
12,9,36,27,74,0,74
12,9,36,29,95,0,95
12,9,36,45,57,0,57
12,9,36,47,249,145,104
12,9,36,55,175,81,94
12,9,36,59,188,91,97
12,9,36,61,101,99,2
12,9,36,65,54,0,54
12,9,36,67,81,0,81
12,9,36,71,84,0,84
12,9,36,81,220,81,139
12,9,36,85,65,0,65
12,9,36,91,73,0,73
12,9,36,103,436,143,293
12,9,36,119,75,0,75
12,9,37,21,91,137,-46
12,9,37,51,132,84,48
12,9,37,81,75,78,-3
12,9,37,119,115,121,-6
12,9,37,133,86,0,86
12,9,37,183,114,184,-70
12,9,39,17,68,0,68
12,9,39,35,100,81,19
12,9,39,49,92,92,0
12,9,39,113,95,79,16
12,9,39,153,71,0,71
12,9,40,27,59,0,59
12,9,40,109,105,58,47
12,9,42,3,120,94,26
12,9,42,29,58,0,58
12,9,42,49,61,0,61
12,9,42,71,85,0,85
12,9,42,77,57,0,57
12,9,42,79,72,0,72
12,9,42,91,78,0,78
12,9,42,101,126,59,67
12,9,42,133,86,0,86
12,9,44,7,85,0,85
12,9,45,13,68,0,68
12,9,45,15,0,59,-59
12,9,45,19,100,49,51
12,9,45,35,73,0,73
12,9,45,45,76,85,-9
12,9,45,51,0,54,-54
12,9,47,37,59,75,-16
12,9,47,93,64,79,-15
12,9,47,125,96,0,96
12,9,47,149,77,0,77
12,9,47,157,66,0,66
12,9,48,27,66,78,-12
12,9,48,29,171,206,-35
12,9,48,85,90,72,18
12,9,48,113,81,116,-35
12,9,48,121,60,0,60
12,9,48,141,70,0,70
12,9,48,201,174,180,-6
12,9,48,439,133,166,-33
12,9,48,453,93,101,-8
12,9,48,491,0,64,-64
12,9,49,35,68,69,-1
12,9,51,13,0,53,-53
12,9,51,41,78,0,78
12,9,51,59,294,171,123
12,9,51,107,156,72,84
12,9,51,153,99,0,99
12,9,51,810,83,86,-3
12,9,53,33,188,94,94
12,9,53,35,82,0,82
12,9,53,53,118,63,55
12,9,53,61,86,0,86
12,9,54,39,61,0,61
12,11,1,3,0,75,-75
12,11,1,73,77,100,-23
12,11,1,89,63,109,-46
12,11,1,97,0,71,-71
12,11,4,13,470,669,-199
12,11,4,19,75,124,-49
12,11,5,7,60,0,60
12,11,6,1,188,196,-8
12,11,6,13,107,150,-43
12,11,6,37,989,1234,-245
12,11,6,59,356,355,1
12,11,6,65,130,196,-66
12,11,6,67,53,100,-47
12,11,6,71,125,155,-30
12,11,6,73,471,565,-94
12,11,6,75,124,172,-48
12,11,6,81,100,77,23
12,11,6,85,296,223,73
12,11,6,95,0,57,-57
12,11,6,97,68,0,68
12,11,6,111,67,70,-3
12,11,8,1,62,91,-29
12,11,8,5,169,228,-59
12,11,8,13,68,110,-42
12,11,8,31,159,338,-179
12,11,8,35,77,96,-19
12,11,8,41,213,287,-74
12,11,8,59,88,183,-95
12,11,8,69,0,76,-76
12,11,9,1,409,274,135
12,11,9,3,325,222,103
12,11,9,7,52,0,52
12,11,9,9,243,189,54
12,11,9,11,83,79,4
12,11,10,3,100,114,-14
12,11,10,5,88,98,-10
12,11,11,1,321,235,86
12,11,12,1,543,728,-185
12,11,12,5,115,83,32
12,11,12,9,670,1351,-681
12,11,12,15,117,310,-193
12,11,12,17,66,309,-243
12,11,12,19,171,329,-158
12,11,12,21,635,1111,-476
12,11,12,23,0,142,-142
12,11,12,31,853,1649,-796
12,11,12,33,108,202,-94
12,11,12,35,130,284,-154
12,11,12,51,126,187,-61
12,11,12,53,98,233,-135
12,11,12,55,156,451,-295
12,11,12,57,1421,2845,-1424
12,11,12,61,219,583,-364
12,11,12,69,304,945,-641
12,11,12,71,1189,2066,-877
12,11,12,73,639,705,-66
12,11,12,75,0,88,-88
12,11,12,81,277,497,-220
12,11,12,83,280,921,-641
12,11,12,85,338,691,-353
12,11,12,86,47205,27955,19250
12,11,12,87,469,385,84
12,11,12,89,0,138,-138
12,11,12,91,119,139,-20
12,11,12,93,0,96,-96
12,11,12,95,2641,4715,-2074
12,11,12,97,551,1091,-540
12,11,12,99,14915,21869,-6954
12,11,12,101,310,822,-512
12,11,12,103,619,1011,-392
12,11,12,105,582,1207,-625
12,11,12,107,0,54,-54
12,11,12,109,145,666,-521
12,11,12,111,1268,3230,-1962
12,11,12,113,0,94,-94
12,11,12,115,233,535,-302
12,11,12,117,712,1122,-410
12,11,12,119,74,291,-217
12,11,12,121,0,64,-64
12,11,12,127,495,886,-391
12,11,13,21,0,58,-58
12,11,13,51,141,158,-17
12,11,13,57,84,210,-126
12,11,13,63,155,342,-187
12,11,13,67,407,792,-385
12,11,13,77,0,70,-70
12,11,13,89,455,586,-131
12,11,13,97,82,147,-65
12,11,13,113,0,83,-83
12,11,13,117,81,236,-155
12,11,13,121,630,1039,-409
12,11,13,135,490,903,-413
12,11,13,151,112,254,-142
12,11,13,153,0,120,-120
12,11,13,179,52,97,-45
12,11,13,185,56,113,-57
12,11,13,215,59,87,-28
12,11,13,217,0,78,-78
12,11,13,223,0,118,-118
12,11,13,245,0,151,-151
12,11,13,247,0,81,-81
12,11,15,3,160,174,-14
12,11,17,31,1148,905,243
12,11,17,43,146,185,-39
12,11,17,89,84,0,84
12,11,17,97,149,146,3
12,11,17,111,55,0,55
12,11,17,197,78,74,4
12,11,18,57,67,81,-14
12,11,18,89,76,0,76
12,11,18,97,124,302,-178
12,11,19,113,0,107,-107
12,11,20,91,117,120,-3
12,11,21,67,75,104,-29
12,11,21,111,174,226,-52
12,11,22,51,104,86,18
12,11,22,71,91,78,13
12,11,22,103,72,0,72
12,11,23,5,0,70,-70
12,11,23,31,56,70,-14
12,11,24,3,169,184,-15
12,11,24,5,244,155,89
12,11,24,27,101,117,-16
12,11,24,31,410,417,-7
12,11,24,33,286,198,88
12,11,24,510,128,121,7
12,11,25,1,93,116,-23
12,11,25,5,89,114,-25
12,11,25,9,184,204,-20
12,11,25,13,93,72,21
12,11,25,17,449,492,-43
12,11,25,21,224,202,22
12,11,25,23,144,112,32
12,11,25,25,341,261,80
12,11,25,27,208,146,62
12,11,26,81,75,58,17
12,11,26,99,93,88,5
12,11,26,125,278,229,49
12,11,26,161,60,73,-13
12,11,26,163,226,188,38
12,11,27,53,137,177,-40
12,11,29,95,84,77,7
12,11,29,183,55,0,55
12,11,29,189,182,132,50
12,11,29,510,60,0,60
12,11,31,55,76,62,14
12,11,32,3,444,717,-273
12,11,32,31,0,95,-95
12,11,33,11,80,99,-19
12,11,33,15,69,66,3
12,11,34,1,173,95,78
12,11,34,3,530,281,249
12,11,34,5,116,105,11
12,11,34,7,135,131,4
12,11,34,13,386,274,112
12,11,34,15,59,0,59
12,11,34,17,488,282,206
12,11,34,21,98,75,23
12,11,34,23,373,259,114
12,11,34,25,292,154,138
12,11,34,27,247,117,130
12,11,34,29,231,142,89
12,11,34,31,205,145,60
12,11,34,35,124,76,48
12,11,34,39,331,147,184
12,11,35,1,66,102,-36
12,11,36,1,116,0,116
12,11,36,5,847,437,410
12,11,36,27,66,79,-13
12,11,36,29,148,175,-27
12,11,36,47,1628,951,677
12,11,36,55,188,113,75
12,11,36,59,997,525,472
12,11,36,61,1044,752,292
12,11,36,67,106,92,14
12,11,36,71,126,108,18
12,11,36,81,1871,837,1034
12,11,36,85,324,123,201
12,11,36,87,189,108,81
12,11,36,103,915,429,486
12,11,36,111,59,0,59
12,11,36,119,582,259,323
12,11,37,21,85,239,-154
12,11,37,25,0,102,-102
12,11,37,51,126,202,-76
12,11,37,63,80,112,-32
12,11,37,67,83,130,-47
12,11,37,71,0,70,-70
12,11,37,81,99,200,-101
12,11,37,89,0,97,-97
12,11,37,97,0,103,-103
12,11,37,101,0,63,-63
12,11,37,119,416,905,-489
12,11,37,129,0,85,-85
12,11,37,133,120,135,-15
12,11,37,179,0,173,-173
12,11,37,183,266,665,-399
12,11,39,17,0,47,-47
12,11,39,35,285,222,63
12,11,39,49,252,238,14
12,11,39,61,136,99,37
12,11,39,95,50,0,50
12,11,39,113,61,66,-5
12,11,39,153,110,79,31
12,11,40,109,0,71,-71
12,11,40,143,54,0,54
12,11,41,51,76,94,-18
12,11,41,67,0,73,-73
12,11,42,3,288,211,77
12,11,42,11,103,77,26
12,11,42,17,196,109,87
12,11,42,29,70,133,-63
12,11,42,43,69,0,69
12,11,42,45,62,105,-43
12,11,42,71,69,0,69
12,11,42,77,112,75,37
12,11,42,79,56,0,56
12,11,42,89,74,0,74
12,11,42,91,142,183,-41
12,11,42,95,63,0,63
12,11,42,101,355,332,23
12,11,44,3,0,54,-54
12,11,44,5,57,0,57
12,11,44,7,188,174,14
12,11,45,3,0,80,-80
12,11,45,13,67,83,-16
12,11,45,15,0,74,-74
12,11,45,19,144,172,-28
12,11,45,45,109,234,-125
12,11,45,51,93,156,-63
12,11,45,63,0,127,-127
12,11,45,79,64,167,-103
12,11,45,83,0,97,-97
12,11,45,91,62,123,-61
12,11,47,9,0,58,-58
12,11,47,37,146,247,-101
12,11,47,65,66,116,-50
12,11,47,93,71,220,-149
12,11,47,125,0,76,-76
12,11,47,149,61,118,-57
12,11,47,155,0,87,-87
12,11,47,157,175,192,-17
12,11,47,187,0,125,-125
12,11,48,27,105,115,-10
12,11,48,29,238,309,-71
12,11,48,39,0,66,-66
12,11,48,85,195,445,-250
12,11,48,113,444,560,-116
12,11,48,121,142,214,-72
12,11,48,141,148,125,23
12,11,48,157,125,172,-47
12,11,48,167,0,61,-61
12,11,48,201,736,985,-249
12,11,48,339,89,232,-143
12,11,48,439,236,408,-172
12,11,48,453,492,451,41
12,11,48,491,91,193,-102
12,11,49,35,126,148,-22
12,11,49,49,0,71,-71
12,11,50,7,57,0,57
12,11,51,13,131,152,-21
12,11,51,41,0,78,-78
12,11,51,59,430,380,50
12,11,51,87,65,99,-34
12,11,51,107,159,166,-7
12,11,51,153,162,122,40
12,11,51,510,77,98,-21
12,11,51,550,0,74,-74
12,11,51,700,76,63,13
12,11,51,710,76,102,-26
12,11,51,760,0,53,-53
12,11,51,810,151,185,-34
12,11,53,33,355,480,-125
12,11,53,53,122,132,-10
12,11,53,61,0,112,-112
12,11,55,25,60,0,60
12,11,55,79,98,98,0
12,13,12,5,108,133,-25
12,13,12,63,183,207,-24
12,13,12,73,0,60,-60
12,13,12,77,108,107,1
12,15,4,13,74,0,74
12,15,6,73,83,0,83
12,15,9,1,77,0,77
12,15,9,3,127,0,127
12,15,9,5,52,0,52
12,15,9,9,107,0,107
12,15,12,9,65,87,-22
12,15,12,11,310,117,193
12,15,12,21,212,103,109
12,15,12,27,481,559,-78
12,15,12,31,95,79,16
12,15,12,55,74,60,14
12,15,12,57,341,376,-35
12,15,12,69,0,76,-76
12,15,12,71,1758,1151,607
12,15,12,81,420,369,51
12,15,12,83,0,96,-96
12,15,12,86,292,114,178
12,15,12,87,85,0,85
12,15,12,95,171,158,13
12,15,12,99,287,116,171
12,15,12,101,109,90,19
12,15,12,103,214,214,0
12,15,12,105,176,116,60
12,15,12,115,3569,3677,-108
12,15,12,117,81,62,19
12,15,12,127,54,60,-6
12,15,13,135,54,0,54
12,15,17,31,133,71,62
12,15,17,43,50,0,50
12,15,17,89,63,0,63
12,15,17,111,65,0,65
12,15,18,97,94,0,94
12,15,24,5,55,0,55
12,15,25,1,84,0,84
12,15,25,5,107,0,107
12,15,25,9,81,0,81
12,15,25,17,90,0,90
12,15,25,21,60,0,60
12,15,25,23,84,0,84
12,15,25,27,86,53,33
12,15,26,99,94,0,94
12,15,26,125,118,58,60
12,15,26,163,82,0,82
12,15,32,3,0,47,-47
12,15,33,11,54,0,54
12,15,33,15,74,0,74
12,15,34,29,102,0,102
12,15,36,29,65,0,65
12,15,36,47,74,0,74
12,15,36,103,179,0,179
12,15,39,49,71,0,71
12,15,44,7,63,0,63
12,15,44,9,48,0,48
12,15,48,113,65,0,65
12,15,51,59,46,0,46
12,17,4,13,0,61,-61
12,17,6,37,50,0,50
12,17,12,1,149,140,9
12,17,12,9,117,122,-5
12,17,12,11,309,66,243
12,17,12,21,91,0,91
12,17,12,31,82,86,-4
12,17,12,53,806,574,232
12,17,12,57,564,347,217
12,17,12,69,294,256,38
12,17,12,71,143,76,67
12,17,12,75,213,198,15
12,17,12,81,86,0,86
12,17,12,83,1289,1207,82
12,17,12,86,161,0,161
12,17,12,87,55,0,55
12,17,12,91,50,0,50
12,17,12,95,245,192,53
12,17,12,97,171,0,171
12,17,12,99,191,102,89
12,17,12,101,602,378,224
12,17,12,103,729,354,375
12,17,12,105,202,110,92
12,17,12,109,0,59,-59
12,17,12,111,90,0,90
12,17,12,115,83,58,25
12,17,12,117,117,106,11
12,17,12,119,324,262,62
12,17,12,127,114,104,10
12,17,17,31,47,0,47
12,17,36,103,84,0,84
12,17,37,119,0,50,-50
12,19,4,13,75,81,-6
12,19,6,37,64,64,0
12,19,6,73,263,225,38
12,19,12,1,432,388,44
12,19,12,3,120,179,-59
12,19,12,7,383,486,-103
12,19,12,9,156,141,15
12,19,12,11,329,171,158
12,19,12,23,62,71,-9
12,19,12,31,9399,8331,1068
12,19,12,33,130,121,9
12,19,12,35,112,138,-26
12,19,12,57,203,218,-15
12,19,12,69,84,133,-49
12,19,12,71,102,80,22
12,19,12,73,120,128,-8
12,19,12,81,76,75,1
12,19,12,83,136,178,-42
12,19,12,86,284,142,142
12,19,12,87,106,0,106
12,19,12,89,324,373,-49
12,19,12,91,0,75,-75
12,19,12,95,314,215,99
12,19,12,97,99,82,17
12,19,12,99,254,127,127
12,19,12,101,91,82,9
12,19,12,103,176,117,59
12,19,12,105,107,123,-16
12,19,12,107,549,481,68
12,19,12,109,840,1172,-332
12,19,12,111,81,0,81
12,19,12,113,0,63,-63
12,19,12,117,134,142,-8
12,19,12,127,144,218,-74
12,19,13,39,86,70,16
12,19,13,51,83,0,83
12,19,13,67,77,0,77
12,19,13,121,0,77,-77
12,19,13,135,77,83,-6
12,19,15,3,99,107,-8
12,19,17,31,99,0,99
12,19,24,3,99,0,99
12,19,24,37,0,128,-128
12,19,36,103,74,0,74
12,19,37,119,0,64,-64
12,19,37,133,0,82,-82
12,19,37,183,75,0,75
12,19,42,101,64,0,64
12,19,48,29,0,81,-81
12,19,48,201,99,84,15
12,19,48,439,63,0,63
12,19,51,59,89,82,7
12,19,51,550,85,93,-8
12,19,51,710,108,0,108
12,19,51,810,245,139,106
12,19,53,29,138,112,26
12,21,4,13,144,160,-16
12,21,6,37,150,154,-4
12,21,6,59,88,0,88
12,21,6,73,108,120,-12
12,21,6,75,48,0,48
12,21,6,85,54,0,54
12,21,8,5,0,66,-66
12,21,8,31,70,90,-20
12,21,8,35,59,0,59
12,21,8,41,84,91,-7
12,21,9,1,372,115,257
12,21,9,3,212,52,160
12,21,9,5,74,0,74
12,21,9,9,196,89,107
12,21,9,11,62,0,62
12,21,11,1,47,0,47
12,21,12,1,72,98,-26
12,21,12,9,92,120,-28
12,21,12,11,1111,635,476
12,21,12,15,103,212,-109
12,21,12,17,0,91,-91
12,21,12,31,115,141,-26
12,21,12,51,161,285,-124
12,21,12,53,0,55,-55
12,21,12,55,61,76,-15
12,21,12,57,416,506,-90
12,21,12,61,0,56,-56
12,21,12,69,0,116,-116
12,21,12,71,4904,6472,-1568
12,21,12,73,98,77,21
12,21,12,81,109,267,-158
12,21,12,83,0,128,-128
12,21,12,85,0,55,-55
12,21,12,86,1532,840,692
12,21,12,87,126,61,65
12,21,12,95,325,449,-124
12,21,12,97,0,63,-63
12,21,12,99,594,500,94
12,21,12,101,67,95,-28
12,21,12,103,242,278,-36
12,21,12,105,111,162,-51
12,21,12,109,0,121,-121
12,21,12,111,64,77,-13
12,21,12,115,164,315,-151
12,21,12,117,68,103,-35
12,21,12,119,0,65,-65
12,21,12,127,0,89,-89
12,21,13,67,0,63,-63
12,21,13,89,0,47,-47
12,21,13,121,97,93,4
12,21,17,31,683,315,368
12,21,17,43,324,91,233
12,21,17,89,110,0,110
12,21,17,97,271,62,209
12,21,17,111,70,0,70
12,21,17,197,180,0,180
12,21,18,57,100,0,100
12,21,18,97,115,0,115
12,21,20,91,129,0,129
12,21,21,67,54,0,54
12,21,21,111,125,74,51
12,21,23,5,0,75,-75
12,21,24,3,87,0,87
12,21,24,5,102,0,102
12,21,24,31,158,73,85
12,21,25,1,293,171,122
12,21,25,5,70,55,15
12,21,25,9,252,83,169
12,21,25,13,67,0,67
12,21,25,17,297,120,177
12,21,25,21,153,95,58
12,21,25,23,193,83,110
12,21,25,25,95,53,42
12,21,25,27,110,53,57
12,21,26,81,81,0,81
12,21,26,99,108,81,27
12,21,26,125,293,130,163
12,21,26,163,119,99,20
12,21,27,37,58,0,58
12,21,27,53,271,115,156
12,21,27,123,64,0,64
12,21,27,163,70,0,70
12,21,29,183,74,0,74
12,21,29,189,170,79,91
12,21,32,3,116,127,-11
12,21,33,11,88,0,88
12,21,33,15,104,0,104
12,21,34,3,178,54,124
12,21,34,5,54,0,54
12,21,34,9,51,0,51
12,21,34,13,110,0,110
12,21,34,17,86,0,86
12,21,34,21,62,0,62
12,21,34,23,115,0,115
12,21,34,25,225,63,162
12,21,34,27,171,50,121
12,21,34,29,155,72,83
12,21,34,31,71,0,71
12,21,34,35,64,0,64
12,21,36,5,52,0,52
12,21,36,29,91,0,91
12,21,36,47,101,58,43
12,21,36,55,102,0,102
12,21,36,59,213,74,139
12,21,36,61,203,129,74
12,21,36,71,71,0,71
12,21,36,81,185,54,131
12,21,36,85,83,0,83
12,21,36,91,58,0,58
12,21,36,103,350,98,252
12,21,36,119,166,0,166
12,21,37,21,0,65,-65
12,21,37,119,77,121,-44
12,21,37,183,90,61,29
12,21,39,35,166,74,92
12,21,39,49,176,95,81
12,21,39,61,113,75,38
12,21,39,153,112,0,112
12,21,42,3,167,74,93
12,21,42,17,127,0,127
12,21,42,29,112,0,112
12,21,42,45,71,0,71
12,21,42,91,113,75,38
12,21,42,101,48,44,4
12,21,44,7,75,67,8
12,21,44,9,79,0,79
12,21,45,13,58,0,58
12,21,45,19,0,54,-54
12,21,47,37,0,84,-84
12,21,48,29,65,57,8
12,21,48,113,80,62,18
12,21,48,201,169,132,37
12,21,48,439,74,61,13
12,21,48,453,80,92,-12
12,21,51,59,169,85,84
12,21,51,510,46,0,46
12,21,53,33,59,56,3
12,21,55,133,90,0,90
12,23,12,1,759,545,214
12,23,12,3,130,65,65
12,23,12,7,79,0,79
12,23,12,11,142,0,142
12,23,12,19,71,62,9
12,23,12,31,261,208,53
12,23,12,41,80,0,80
12,23,12,47,141,120,21
12,23,12,57,105,79,26
12,23,12,73,55,0,55
12,23,12,83,67,79,-12
12,23,12,86,102,0,102
12,23,12,95,86,66,20
12,23,12,97,67,0,67
12,23,12,99,128,0,128
12,23,12,105,79,0,79
12,23,12,121,699,759,-60
12,23,12,125,171,190,-19
12,23,12,127,75,0,75
12,23,13,185,0,62,-62
12,27,12,15,559,481,78
12,27,12,49,68,102,-34
12,27,12,55,0,85,-85
12,27,12,57,67,76,-9
12,27,12,71,129,80,49
12,27,12,81,132,132,0
12,27,12,105,79,0,79
12,27,12,115,231,204,27
12,29,12,1,72,59,13
12,29,12,41,128,124,4
12,29,12,75,142,173,-31
12,31,1,3,69,109,-40
12,31,1,73,179,132,47
12,31,1,81,76,0,76
12,31,1,89,72,106,-34
12,31,1,97,127,88,39
12,31,1,101,86,70,16
12,31,1,117,0,76,-76
12,31,2,20,71,0,71
12,31,4,13,301,358,-57
12,31,4,19,66,65,1
12,31,6,1,75,132,-57
12,31,6,13,63,0,63
12,31,6,37,355,316,39
12,31,6,59,161,140,21
12,31,6,65,173,96,77
12,31,6,67,86,0,86
12,31,6,71,106,66,40
12,31,6,73,1270,977,293
12,31,6,81,48,0,48
12,31,6,85,86,74,12
12,31,6,111,88,81,7
12,31,8,5,169,144,25
12,31,8,31,119,181,-62
12,31,8,35,78,56,22
12,31,8,41,203,178,25
12,31,8,59,0,111,-111
12,31,8,69,0,74,-74
12,31,9,1,144,57,87
12,31,9,3,173,98,75
12,31,9,9,153,66,87
12,31,9,11,109,0,109
12,31,10,3,110,0,110
12,31,11,1,100,133,-33
12,31,12,1,930,706,224
12,31,12,3,510,887,-377
12,31,12,5,292,156,136
12,31,12,7,181,277,-96
12,31,12,9,662,627,35
12,31,12,11,1649,853,796
12,31,12,15,79,95,-16
12,31,12,17,86,82,4
12,31,12,19,8331,9399,-1068
12,31,12,21,141,115,26
12,31,12,23,208,261,-53
12,31,12,33,591,480,111
12,31,12,35,567,448,119
12,31,12,53,84,96,-12
12,31,12,55,57,0,57
12,31,12,57,1164,1294,-130
12,31,12,61,141,121,20
12,31,12,69,313,246,67
12,31,12,71,329,298,31
12,31,12,73,904,488,416
12,31,12,81,205,137,68
12,31,12,83,370,429,-59
12,31,12,85,93,77,16
12,31,12,86,1784,790,994
12,31,12,87,193,135,58
12,31,12,89,1987,3260,-1273
12,31,12,91,211,183,28
12,31,12,95,1571,1621,-50
12,31,12,97,274,305,-31
12,31,12,99,870,669,201
12,31,12,101,240,333,-93
12,31,12,103,600,615,-15
12,31,12,105,509,549,-40
12,31,12,107,316,402,-86
12,31,12,109,6312,9180,-2868
12,31,12,111,207,210,-3
12,31,12,113,238,166,72
12,31,12,115,198,151,47
12,31,12,117,485,558,-73
12,31,12,119,68,85,-17
12,31,12,121,144,119,25
12,31,12,125,0,70,-70
12,31,12,127,972,853,119
12,31,13,21,88,0,88
12,31,13,31,76,0,76
12,31,13,39,584,613,-29
12,31,13,49,78,172,-94
12,31,13,51,392,372,20
12,31,13,57,81,87,-6
12,31,13,63,141,150,-9
12,31,13,67,389,375,14
12,31,13,69,63,0,63
12,31,13,89,340,382,-42
12,31,13,95,164,76,88
12,31,13,117,69,0,69
12,31,13,121,469,583,-114
12,31,13,127,294,141,153
12,31,13,135,359,374,-15
12,31,13,139,63,0,63
12,31,13,151,111,87,24
12,31,13,153,85,82,3
12,31,13,179,160,124,36
12,31,13,185,256,144,112
12,31,13,215,120,106,14
12,31,13,223,64,75,-11
12,31,13,245,146,95,51
12,31,13,299,79,98,-19
12,31,15,3,382,402,-20
12,31,17,31,402,307,95
12,31,17,43,104,0,104
12,31,17,89,78,0,78
12,31,17,97,189,133,56
12,31,17,197,77,0,77
12,31,18,89,72,0,72
12,31,18,97,199,128,71
12,31,19,153,50,0,50
12,31,20,91,80,56,24
12,31,20,173,63,0,63
12,31,21,67,48,59,-11
12,31,21,111,163,161,2
12,31,22,33,90,0,90
12,31,22,51,77,62,15
12,31,22,71,82,70,12
12,31,23,5,93,0,93
12,31,24,3,180,135,45
12,31,24,5,143,78,65
12,31,24,27,64,0,64
12,31,24,31,177,169,8
12,31,24,33,116,136,-20
12,31,24,37,137,173,-36
12,31,24,510,126,71,55
12,31,25,5,68,0,68
12,31,25,9,88,0,88
12,31,25,17,151,120,31
12,31,25,21,0,58,-58
12,31,25,25,112,90,22
12,31,25,27,96,61,35
12,31,26,81,78,0,78
12,31,26,99,91,53,38
12,31,26,125,149,67,82
12,31,26,163,133,152,-19
12,31,27,37,0,70,-70
12,31,27,53,79,107,-28
12,31,27,109,79,0,79
12,31,28,47,122,79,43
12,31,29,95,80,75,5
12,31,29,189,132,97,35
12,31,32,3,197,264,-67
12,31,32,31,0,52,-52
12,31,34,3,90,55,35
12,31,34,5,77,0,77
12,31,34,7,60,0,60
12,31,34,13,149,69,80
12,31,34,17,141,78,63
12,31,34,21,67,0,67
12,31,34,23,153,92,61
12,31,34,25,72,0,72
12,31,34,27,61,0,61
12,31,34,29,82,50,32
12,31,34,35,59,0,59
12,31,34,39,90,0,90
12,31,36,1,93,0,93
12,31,36,5,240,101,139
12,31,36,29,111,0,111
12,31,36,47,277,193,84
12,31,36,55,121,68,53
12,31,36,59,204,62,142
12,31,36,61,182,207,-25
12,31,36,67,116,0,116
12,31,36,71,64,0,64
12,31,36,81,266,104,162
12,31,36,103,217,91,126
12,31,36,119,151,0,151
12,31,37,21,55,128,-73
12,31,37,49,59,0,59
12,31,37,51,169,145,24
12,31,37,63,72,80,-8
12,31,37,67,0,72,-72
12,31,37,81,117,138,-21
12,31,37,119,386,486,-100
12,31,37,129,47,0,47
12,31,37,133,252,203,49
12,31,37,183,282,252,30
12,31,39,35,176,137,39
12,31,39,49,223,200,23
12,31,39,61,131,88,43
12,31,39,95,72,0,72
12,31,39,113,67,0,67
12,31,39,153,0,67,-67
12,31,40,109,88,76,12
12,31,40,143,66,74,-8
12,31,41,51,0,64,-64
12,31,42,3,187,127,60
12,31,42,11,58,0,58
12,31,42,29,81,0,81
12,31,42,41,59,0,59
12,31,42,45,47,0,47
12,31,42,71,57,0,57
12,31,42,77,69,0,69
12,31,42,79,69,0,69
12,31,42,91,106,0,106
12,31,42,101,245,140,105
12,31,42,133,62,0,62
12,31,44,5,99,89,10
12,31,44,7,63,0,63
12,31,45,3,76,53,23
12,31,45,13,192,92,100
12,31,45,15,174,202,-28
12,31,45,19,234,169,65
12,31,45,35,85,82,3
12,31,45,45,109,162,-53
12,31,45,51,131,70,61
12,31,45,63,79,0,79
12,31,45,79,130,135,-5
12,31,45,83,62,0,62
12,31,45,91,71,121,-50
12,31,47,37,179,219,-40
12,31,47,65,89,96,-7
12,31,47,93,119,101,18
12,31,47,125,149,68,81
12,31,47,149,56,75,-19
12,31,47,157,219,216,3
12,31,47,187,0,66,-66
12,31,48,27,113,128,-15
12,31,48,29,269,268,1
12,31,48,85,132,157,-25
12,31,48,113,307,342,-35
12,31,48,121,93,90,3
12,31,48,141,83,87,-4
12,31,48,201,372,442,-70
12,31,48,339,0,79,-79
12,31,48,355,122,0,122
12,31,48,439,213,253,-40
12,31,48,453,210,210,0
12,31,48,491,0,71,-71
12,31,49,35,81,79,2
12,31,51,13,94,66,28
12,31,51,41,0,59,-59
12,31,51,59,228,254,-26
12,31,51,87,75,69,6
12,31,51,107,92,96,-4
12,31,51,153,110,117,-7
12,31,51,179,60,0,60
12,31,51,510,65,70,-5
12,31,51,550,282,285,-3
12,31,51,650,192,90,102
12,31,51,700,160,78,82
12,31,51,710,546,315,231
12,31,51,740,154,65,89
12,31,51,760,60,0,60
12,31,51,800,94,81,13
12,31,51,810,702,557,145
12,31,53,29,120,291,-171
12,31,53,33,162,221,-59
12,31,53,35,156,102,54
12,31,53,53,109,118,-9
12,31,53,57,0,89,-89
12,31,53,61,102,91,11
12,31,55,79,101,70,31
12,33,1,3,927,1091,-164
12,33,1,53,384,342,42
12,33,1,69,0,65,-65
12,33,1,73,197,188,9
12,33,1,81,60,0,60
12,33,1,89,103,81,22
12,33,1,97,446,313,133
12,33,1,101,102,88,14
12,33,1,117,86,0,86
12,33,4,13,121,120,1
12,33,4,19,0,75,-75
12,33,6,31,74,112,-38
12,33,6,37,170,116,54
12,33,6,59,51,0,51
12,33,6,65,0,51,-51
12,33,6,73,487,739,-252
12,33,8,5,0,57,-57
12,33,8,31,0,43,-43
12,33,8,41,127,79,48
12,33,11,1,61,0,61
12,33,12,1,117,79,38
12,33,12,5,469,249,220
12,33,12,9,132,115,17
12,33,12,11,202,108,94
12,33,12,19,121,130,-9
12,33,12,31,480,591,-111
12,33,12,57,198,297,-99
12,33,12,69,58,65,-7
12,33,12,71,53,60,-7
12,33,12,73,258,233,25
12,33,12,81,0,56,-56
12,33,12,83,65,68,-3
12,33,12,86,198,109,89
12,33,12,91,836,723,113
12,33,12,95,232,245,-13
12,33,12,97,70,0,70
12,33,12,99,130,92,38
12,33,12,101,54,89,-35
12,33,12,103,170,147,23
12,33,12,105,78,104,-26
12,33,12,109,82,107,-25
12,33,12,113,4230,5172,-942
12,33,12,115,54,0,54
12,33,12,117,88,79,9
12,33,12,127,70,77,-7
12,33,12,131,110,153,-43
12,33,13,67,103,98,5
12,33,13,73,0,75,-75
12,33,13,89,83,119,-36
12,33,13,121,105,160,-55
12,33,13,135,104,103,1
12,33,13,245,0,102,-102
12,33,15,3,180,242,-62
12,33,17,31,88,54,34
12,33,22,15,0,88,-88
12,33,22,33,75,0,75
12,33,22,51,63,67,-4
12,33,22,71,46,72,-26
12,33,22,103,80,0,80
12,33,24,3,144,181,-37
12,33,24,37,67,0,67
12,33,28,47,166,146,20
12,33,28,59,81,60,21
12,33,29,189,63,0,63
12,33,31,153,0,76,-76
12,33,32,3,124,118,6
12,33,35,1,0,56,-56
12,33,36,103,50,0,50
12,33,37,49,55,0,55
12,33,37,119,57,77,-20
12,33,37,133,123,234,-111
12,33,37,183,51,0,51
12,33,37,191,0,70,-70
12,33,39,49,60,57,3
12,33,40,109,0,73,-73
12,33,45,13,0,57,-57
12,33,47,37,90,92,-2
12,33,47,157,176,78,98
12,33,48,29,249,262,-13
12,33,48,85,0,57,-57
12,33,48,113,74,106,-32
12,33,48,201,200,215,-15
12,33,48,355,57,230,-173
12,33,48,439,116,152,-36
12,33,48,453,73,78,-5
12,33,51,59,115,105,10
12,33,51,153,79,0,79
12,33,51,179,67,0,67
12,33,51,550,68,144,-76
12,33,51,710,103,266,-163
12,33,51,740,0,69,-69
12,33,51,810,294,346,-52
12,33,53,29,104,143,-39
12,33,53,33,60,59,1
12,33,53,35,88,59,29
12,33,53,53,0,67,-67
12,33,53,57,0,60,-60
12,35,6,37,68,0,68
12,35,9,1,86,0,86
12,35,9,3,58,0,58
12,35,12,1,108,66,42
12,35,12,9,91,114,-23
12,35,12,11,284,130,154
12,35,12,19,138,112,26
12,35,12,31,448,567,-119
12,35,12,57,120,127,-7
12,35,12,69,103,112,-9
12,35,12,71,82,54,28
12,35,12,73,52,53,-1
12,35,12,83,113,97,16
12,35,12,86,232,89,143
12,35,12,95,226,190,36
12,35,12,97,58,0,58
12,35,12,99,200,108,92
12,35,12,101,61,0,61
12,35,12,103,66,65,1
12,35,12,105,78,67,11
12,35,12,107,174,206,-32
12,35,12,109,678,714,-36
12,35,12,117,169,109,60
12,35,12,127,2332,1990,342
12,35,17,31,74,0,74
12,35,34,3,73,0,73
12,35,34,25,60,0,60
12,35,34,29,79,0,79
12,35,36,47,83,0,83
12,35,36,59,80,0,80
12,35,36,81,65,0,65
12,35,36,103,197,53,144
12,37,12,5,0,51,-51
12,37,12,73,105,88,17
12,37,12,129,65,0,65
12,39,12,63,160,170,-10
12,39,12,73,1606,1696,-90
12,39,12,129,0,60,-60
12,39,13,87,101,96,5
12,41,12,1,473,345,128
12,41,12,23,0,80,-80
12,41,12,29,124,128,-4
12,41,12,75,301,310,-9
12,43,12,51,409,261,148
12,43,12,55,0,80,-80
12,43,12,71,126,88,38
12,43,12,93,161,177,-16
12,43,12,99,0,70,-70
12,45,12,5,352,365,-13
12,45,12,73,0,60,-60
12,47,12,23,120,141,-21
12,47,12,121,146,90,56
12,47,13,185,86,116,-30
12,49,12,27,102,68,34
12,49,12,55,213,308,-95
12,49,12,57,101,137,-36
12,49,12,81,97,87,10
12,49,12,105,266,433,-167
12,51,12,11,187,126,61
12,51,12,21,285,161,124
12,51,12,43,261,409,-148
12,51,12,57,0,327,-327
12,51,12,71,623,670,-47
12,51,12,86,321,126,195
12,51,12,99,312,308,4
12,53,4,13,0,61,-61
12,53,12,1,57,78,-21
12,53,12,9,74,70,4
12,53,12,11,233,98,135
12,53,12,17,574,806,-232
12,53,12,21,55,0,55
12,53,12,31,96,84,12
12,53,12,57,2668,1469,1199
12,53,12,69,218,146,72
12,53,12,71,143,97,46
12,53,12,81,101,64,37
12,53,12,83,163,172,-9
12,53,12,86,230,114,116
12,53,12,95,265,233,32
12,53,12,97,87,95,-8
12,53,12,99,142,94,48
12,53,12,101,4963,3212,1751
12,53,12,103,1334,635,699
12,53,12,105,247,248,-1
12,53,12,115,66,74,-8
12,53,12,117,83,80,3
12,53,12,119,195,288,-93
12,53,12,127,99,80,19
12,53,17,31,104,0,104
12,53,25,5,71,0,71
12,53,25,27,67,0,67
12,53,26,163,62,0,62
12,53,32,3,0,62,-62
12,53,34,25,61,0,61
12,53,34,29,87,0,87
12,53,36,5,128,0,128
12,53,36,47,59,0,59
12,53,36,59,92,0,92
12,53,36,81,116,0,116
12,53,36,103,239,82,157
12,55,12,1,0,55,-55
12,55,12,9,64,87,-23
12,55,12,11,451,156,295
12,55,12,15,60,74,-14
12,55,12,21,76,61,15
12,55,12,27,85,0,85
12,55,12,31,0,57,-57
12,55,12,43,80,0,80
12,55,12,49,308,213,95
12,55,12,57,217,263,-46
12,55,12,69,0,86,-86
12,55,12,71,221,143,78
12,55,12,81,135,103,32
12,55,12,83,0,97,-97
12,55,12,86,490,124,366
12,55,12,87,70,0,70
12,55,12,93,155,94,61
12,55,12,95,217,271,-54
12,55,12,97,74,87,-13
12,55,12,99,261,149,112
12,55,12,103,89,112,-23
12,55,12,105,652,728,-76
12,55,12,111,92,61,31
12,55,12,115,69,95,-26
12,55,12,117,73,0,73
12,55,12,127,0,87,-87
12,55,41,67,62,0,62
12,57,1,3,96,0,96
12,57,1,69,0,71,-71
12,57,1,73,180,100,80
12,57,1,89,106,108,-2
12,57,1,97,109,82,27
12,57,1,101,72,82,-10
12,57,1,117,82,59,23
12,57,2,20,110,77,33
12,57,4,13,558,618,-60
12,57,4,19,144,70,74
12,57,5,7,86,67,19
12,57,5,119,87,0,87
12,57,6,1,150,178,-28
12,57,6,13,102,0,102
12,57,6,19,0,63,-63
12,57,6,37,679,544,135
12,57,6,53,0,84,-84
12,57,6,59,317,162,155
12,57,6,65,175,121,54
12,57,6,67,86,125,-39
12,57,6,71,129,88,41
12,57,6,73,608,495,113
12,57,6,75,65,97,-32
12,57,6,81,62,70,-8
12,57,6,85,139,169,-30
12,57,6,95,0,75,-75
12,57,6,111,302,0,302
12,57,8,1,128,97,31
12,57,8,5,214,218,-4
12,57,8,13,0,84,-84
12,57,8,31,180,280,-100
12,57,8,35,130,176,-46
12,57,8,41,462,406,56
12,57,8,59,148,157,-9
12,57,8,69,65,59,6
12,57,9,1,257,147,110
12,57,9,3,468,192,276
12,57,9,7,55,0,55
12,57,9,9,319,170,149
12,57,9,11,75,0,75
12,57,10,3,220,140,80
12,57,11,1,198,219,-21
12,57,12,1,730,559,171
12,57,12,5,369,142,227
12,57,12,9,764,633,131
12,57,12,11,2845,1421,1424
12,57,12,15,376,341,35
12,57,12,17,347,564,-217
12,57,12,19,218,203,15
12,57,12,21,506,416,90
12,57,12,23,79,105,-26
12,57,12,27,76,67,9
12,57,12,31,1294,1164,130
12,57,12,33,297,198,99
12,57,12,35,127,120,7
12,57,12,49,137,101,36
12,57,12,51,327,0,327
12,57,12,53,1469,2668,-1199
12,57,12,55,263,217,46
12,57,12,61,130,162,-32
12,57,12,69,532,546,-14
12,57,12,71,1416,983,433
12,57,12,73,808,511,297
12,57,12,75,77,80,-3
12,57,12,81,2996,2781,215
12,57,12,83,756,670,86
12,57,12,85,101,93,8
12,57,12,86,4321,2201,2120
12,57,12,87,172,137,35
12,57,12,89,66,56,10
12,57,12,91,342,289,53
12,57,12,95,2722,2531,191
12,57,12,97,819,687,132
12,57,12,99,1505,1025,480
12,57,12,101,10760,18242,-7482
12,57,12,103,12012,12602,-590
12,57,12,105,5675,6942,-1267
12,57,12,109,209,350,-141
12,57,12,111,390,232,158
12,57,12,113,185,151,34
12,57,12,115,1229,1263,-34
12,57,12,117,790,811,-21
12,57,12,119,191,330,-139
12,57,12,121,66,95,-29
12,57,12,127,692,558,134
12,57,12,131,0,66,-66
12,57,13,21,68,0,68
12,57,13,51,185,155,30
12,57,13,57,54,83,-29
12,57,13,63,106,166,-60
12,57,13,67,447,337,110
12,57,13,73,128,117,11
12,57,13,89,309,372,-63
12,57,13,95,63,0,63
12,57,13,97,81,62,19
12,57,13,117,91,107,-16
12,57,13,121,571,725,-154
12,57,13,135,348,471,-123
12,57,13,151,87,111,-24
12,57,13,153,127,106,21
12,57,13,179,113,69,44
12,57,13,185,130,112,18
12,57,13,215,85,114,-29
12,57,13,245,109,88,21
12,57,15,3,342,223,119
12,57,17,31,1151,656,495
12,57,17,43,284,149,135
12,57,17,89,133,0,133
12,57,17,97,201,115,86
12,57,17,111,78,0,78
12,57,17,163,109,112,-3
12,57,17,197,184,60,124
12,57,18,3,98,0,98
12,57,18,57,124,90,34
12,57,18,89,76,0,76
12,57,18,97,326,206,120
12,57,19,153,71,80,-9
12,57,20,91,85,108,-23
12,57,20,173,99,90,9
12,57,21,15,65,0,65
12,57,21,67,117,71,46
12,57,21,111,315,267,48
12,57,22,33,79,0,79
12,57,22,51,105,109,-4
12,57,22,55,65,0,65
12,57,22,71,87,96,-9
12,57,23,5,78,0,78
12,57,24,3,290,137,153
12,57,24,5,217,144,73
12,57,24,17,77,0,77
12,57,24,21,96,0,96
12,57,24,25,78,0,78
12,57,24,27,106,79,27
12,57,24,31,321,197,124
12,57,24,33,242,126,116
12,57,24,510,99,75,24
12,57,25,1,56,0,56
12,57,25,5,81,79,2
12,57,25,9,184,100,84
12,57,25,13,172,109,63
12,57,25,17,355,242,113
12,57,25,21,169,144,25
12,57,25,23,122,63,59
12,57,25,25,188,162,26
12,57,25,27,233,117,116
12,57,26,21,94,0,94
12,57,26,49,79,63,16
12,57,26,65,63,0,63
12,57,26,81,107,118,-11
12,57,26,99,112,75,37
12,57,26,125,271,172,99
12,57,26,159,0,106,-106
12,57,26,161,58,0,58
12,57,26,163,298,167,131
12,57,27,37,0,55,-55
12,57,27,53,262,164,98
12,57,27,123,76,0,76
12,57,28,47,88,0,88
12,57,29,77,65,0,65
12,57,29,95,150,94,56
12,57,29,183,129,0,129
12,57,29,189,243,176,67
12,57,29,510,71,77,-6
12,57,31,55,109,72,37
12,57,31,109,62,0,62
12,57,31,153,71,0,71
12,57,32,3,357,437,-80
12,57,33,11,130,90,40
12,57,33,15,109,0,109
12,57,34,1,77,63,14
12,57,34,3,256,103,153
12,57,34,5,212,122,90
12,57,34,7,127,84,43
12,57,34,13,283,105,178
12,57,34,17,520,191,329
12,57,34,21,110,71,39
12,57,34,23,577,214,363
12,57,34,25,174,79,95
12,57,34,27,187,64,123
12,57,34,29,165,75,90
12,57,34,31,216,86,130
12,57,34,35,132,0,132
12,57,34,39,217,75,142
12,57,35,1,137,95,42
12,57,36,1,93,0,93
12,57,36,5,619,247,372
12,57,36,27,67,0,67
12,57,36,29,288,159,129
12,57,36,45,72,59,13
12,57,36,47,676,302,374
12,57,36,55,345,135,210
12,57,36,59,378,95,283
12,57,36,61,519,334,185
12,57,36,65,78,0,78
12,57,36,67,158,71,87
12,57,36,71,162,72,90
12,57,36,81,826,288,538
12,57,36,85,158,0,158
12,57,36,87,80,0,80
12,57,36,91,56,0,56
12,57,36,93,88,0,88
12,57,36,103,592,194,398
12,57,36,119,244,115,129
12,57,37,21,59,136,-77
12,57,37,25,0,69,-69
12,57,37,39,0,56,-56
12,57,37,51,385,231,154
12,57,37,63,113,93,20
12,57,37,67,84,71,13
12,57,37,81,153,143,10
12,57,37,85,132,86,46
12,57,37,89,0,55,-55
12,57,37,119,464,516,-52
12,57,37,129,0,68,-68
12,57,37,133,286,213,73
12,57,37,183,364,365,-1
12,57,37,191,69,0,69
12,57,39,17,119,0,119
12,57,39,25,52,0,52
12,57,39,35,359,206,153
12,57,39,41,92,0,92
12,57,39,49,407,211,196
12,57,39,57,85,0,85
12,57,39,61,177,100,77
12,57,39,93,99,64,35
12,57,39,95,75,78,-3
12,57,39,113,149,77,72
12,57,39,151,65,0,65
12,57,39,153,98,58,40
12,57,39,165,66,0,66
12,57,40,109,138,78,60
12,57,40,143,97,0,97
12,57,41,51,106,95,11
12,57,41,67,99,71,28
12,57,42,3,242,173,69
12,57,42,11,131,90,41
12,57,42,17,163,98,65
12,57,42,29,88,85,3
12,57,42,41,79,0,79
12,57,42,43,91,0,91
12,57,42,45,71,71,0
12,57,42,49,60,0,60
12,57,42,71,145,101,44
12,57,42,77,142,92,50
12,57,42,79,143,0,143
12,57,42,89,66,0,66
12,57,42,91,223,92,131
12,57,42,95,97,0,97
12,57,42,101,318,234,84
12,57,42,133,67,0,67
12,57,44,7,148,140,8
12,57,45,13,81,65,16
12,57,45,15,0,110,-110
12,57,45,19,159,143,16
12,57,45,35,0,69,-69
12,57,45,45,118,176,-58
12,57,45,51,131,57,74
12,57,45,63,0,85,-85
12,57,45,79,184,113,71
12,57,45,85,82,0,82
12,57,45,91,71,95,-24
12,57,47,37,277,284,-7
12,57,47,65,99,114,-15
12,57,47,93,141,130,11
12,57,47,125,137,231,-94
12,57,47,149,71,86,-15
12,57,47,157,165,188,-23
12,57,47,187,0,92,-92
12,57,48,27,173,110,63
12,57,48,29,492,383,109
12,57,48,61,112,106,6
12,57,48,85,202,263,-61
12,57,48,113,441,446,-5
12,57,48,121,171,180,-9
12,57,48,135,0,67,-67
12,57,48,141,175,121,54
12,57,48,157,76,139,-63
12,57,48,201,779,657,122
12,57,48,329,0,65,-65
12,57,48,339,0,77,-77
12,57,48,355,61,0,61
12,57,48,439,390,304,86
12,57,48,453,462,370,92
12,57,48,491,97,89,8
12,57,49,35,110,139,-29
12,57,51,13,130,163,-33
12,57,51,41,114,73,41
12,57,51,59,723,442,281
12,57,51,87,113,65,48
12,57,51,107,215,157,58
12,57,51,153,324,148,176
12,57,51,179,94,0,94
12,57,51,199,85,0,85
12,57,51,510,124,114,10
12,57,51,550,124,92,32
12,57,51,650,0,58,-58
12,57,51,700,133,0,133
12,57,51,710,125,80,45
12,57,51,760,50,0,50
12,57,51,810,300,153,147
12,57,53,11,74,0,74
12,57,53,33,307,324,-17
12,57,53,35,60,0,60
12,57,53,53,219,112,107
12,57,53,61,103,64,39
12,57,53,63,66,0,66
12,57,53,67,0,64,-64
12,57,55,25,108,54,54
12,57,55,79,164,134,30
12,57,55,133,67,0,67
12,59,1,61,106,68,38
12,59,12,5,191,106,85
12,59,12,63,150,134,16
12,59,12,131,224,214,10
12,59,12,133,261,288,-27
12,61,4,13,57,0,57
12,61,6,37,59,0,59
12,61,6,73,61,0,61
12,61,9,1,238,0,238
12,61,9,3,141,0,141
12,61,9,9,71,0,71
12,61,12,1,73,0,73
12,61,12,9,1170,1106,64
12,61,12,11,583,219,364
12,61,12,21,56,0,56
12,61,12,31,121,141,-20
12,61,12,57,162,130,32
12,61,12,69,0,99,-99
12,61,12,71,84,114,-30
12,61,12,73,0,53,-53
12,61,12,83,0,66,-66
12,61,12,85,307,144,163
12,61,12,86,446,160,286
12,61,12,87,100,0,100
12,61,12,95,275,340,-65
12,61,12,97,94,70,24
12,61,12,99,707,370,337
12,61,12,101,0,57,-57
12,61,12,103,94,61,33
12,61,12,105,150,135,15
12,61,12,109,0,51,-51
12,61,12,111,2012,1622,390
12,61,12,115,0,81,-81
12,61,12,117,88,79,9
12,61,12,127,123,68,55
12,61,13,121,0,48,-48
12,61,17,31,98,48,50
12,61,25,1,59,0,59
12,61,25,9,55,0,55
12,61,25,17,64,0,64
12,61,25,23,48,0,48
12,61,34,3,69,0,69
12,61,34,25,90,0,90
12,61,34,29,117,0,117
12,61,36,59,76,0,76
12,61,36,61,75,0,75
12,61,36,103,211,72,139
12,61,36,119,84,0,84
12,61,37,119,71,0,71
12,63,1,69,182,221,-39
12,63,12,5,344,222,122
12,63,12,13,207,183,24
12,63,12,39,170,160,10
12,63,12,59,134,150,-16
12,63,12,73,166,227,-61
12,63,12,133,278,266,12
12,65,12,73,540,514,26
12,67,12,121,146,161,-15
12,69,4,13,127,96,31
12,69,6,37,84,50,34
12,69,6,59,61,0,61
12,69,6,65,77,0,77
12,69,6,73,117,0,117
12,69,8,41,68,0,68
12,69,9,3,130,0,130
12,69,9,9,131,0,131
12,69,12,1,236,213,23
12,69,12,9,361,395,-34
12,69,12,11,945,304,641
12,69,12,15,76,0,76
12,69,12,17,256,294,-38
12,69,12,19,133,84,49
12,69,12,21,116,0,116
12,69,12,31,246,313,-67
12,69,12,33,65,58,7
12,69,12,35,112,103,9
12,69,12,53,146,218,-72
12,69,12,55,86,0,86
12,69,12,57,546,532,14
12,69,12,61,99,0,99
12,69,12,71,282,213,69
12,69,12,73,133,135,-2
12,69,12,81,205,160,45
12,69,12,83,1729,2185,-456
12,69,12,85,60,0,60
12,69,12,86,757,179,578
12,69,12,87,82,0,82
12,69,12,91,71,77,-6
12,69,12,95,11385,5529,5856
12,69,12,97,1891,1134,757
12,69,12,99,511,263,248
12,69,12,101,308,227,81
12,69,12,103,334,324,10
12,69,12,105,1680,2335,-655
12,69,12,107,58,64,-6
12,69,12,109,97,115,-18
12,69,12,111,152,98,54
12,69,12,115,165,168,-3
12,69,12,117,2309,1150,1159
12,69,12,119,1638,1877,-239
12,69,12,127,1233,1128,105
12,69,13,67,56,76,-20
12,69,13,121,79,68,11
12,69,13,135,96,73,23
12,69,17,31,230,82,148
12,69,17,43,65,0,65
12,69,17,97,75,0,75
12,69,18,97,81,0,81
12,69,24,3,88,0,88
12,69,24,5,72,0,72
12,69,24,31,68,0,68
12,69,25,9,78,0,78
12,69,25,17,71,0,71
12,69,25,27,70,0,70
12,69,26,125,94,53,41
12,69,26,163,114,0,114
12,69,32,3,104,99,5
12,69,33,11,78,0,78
12,69,34,7,92,0,92
12,69,34,13,55,0,55
12,69,34,23,75,0,75
12,69,34,29,72,0,72
12,69,34,31,60,0,60
12,69,36,5,187,0,187
12,69,36,29,72,0,72
12,69,36,47,177,55,122
12,69,36,55,86,60,26
12,69,36,59,146,0,146
12,69,36,67,64,0,64
12,69,36,71,54,0,54
12,69,36,81,274,0,274
12,69,36,85,69,0,69
12,69,36,103,217,0,217
12,69,36,119,62,0,62
12,69,37,119,67,72,-5
12,69,37,183,84,51,33
12,69,39,49,74,0,74
12,69,42,3,56,0,56
12,69,42,17,77,0,77
12,69,42,77,64,0,64
12,69,42,91,50,0,50
12,69,42,101,75,0,75
12,69,44,7,66,0,66
12,69,45,51,0,61,-61
12,69,47,157,62,0,62
12,69,48,29,56,0,56
12,69,48,113,62,0,62
12,69,48,201,82,59,23
12,69,48,439,68,0,68
12,69,48,453,55,0,55
12,69,51,59,98,0,98
12,69,51,810,54,0,54
12,69,53,33,0,56,-56
12,71,4,13,238,268,-30
12,71,4,19,61,67,-6
12,71,6,37,246,187,59
12,71,6,59,108,85,23
12,71,6,65,72,58,14
12,71,6,73,192,157,35
12,71,6,75,0,42,-42
12,71,6,85,59,74,-15
12,71,8,1,82,0,82
12,71,8,5,94,72,22
12,71,8,31,70,148,-78
12,71,8,35,90,61,29
12,71,8,41,152,181,-29
12,71,8,59,119,91,28
12,71,8,69,64,64,0
12,71,9,1,298,111,187
12,71,9,3,283,132,151
12,71,9,5,70,0,70
12,71,9,7,97,0,97
12,71,9,9,310,106,204
12,71,9,11,77,54,23
12,71,10,3,111,0,111
12,71,10,5,86,0,86
12,71,11,1,58,57,1
12,71,12,1,189,209,-20
12,71,12,5,81,0,81
12,71,12,9,177,332,-155
12,71,12,11,2066,1189,877
12,71,12,15,1151,1758,-607
12,71,12,17,76,143,-67
12,71,12,19,80,102,-22
12,71,12,21,6472,4904,1568
12,71,12,27,80,129,-49
12,71,12,31,298,329,-31
12,71,12,33,60,53,7
12,71,12,35,54,82,-28
12,71,12,43,88,126,-38
12,71,12,51,670,623,47
12,71,12,53,97,143,-46
12,71,12,55,143,221,-78
12,71,12,57,983,1416,-433
12,71,12,61,114,84,30
12,71,12,69,213,282,-69
12,71,12,73,182,186,-4
12,71,12,81,349,520,-171
12,71,12,83,168,345,-177
12,71,12,85,126,59,67
12,71,12,86,3923,1496,2427
12,71,12,87,260,140,120
12,71,12,89,0,62,-62
12,71,12,91,111,82,29
12,71,12,95,683,1040,-357
12,71,12,97,165,208,-43
12,71,12,99,1046,830,216
12,71,12,101,251,327,-76
12,71,12,103,623,706,-83
12,71,12,105,426,509,-83
12,71,12,109,112,163,-51
12,71,12,111,196,192,4
12,71,12,113,0,74,-74
12,71,12,115,641,862,-221
12,71,12,117,217,254,-37
12,71,12,119,84,132,-48
12,71,12,127,233,240,-7
12,71,13,51,0,72,-72
12,71,13,57,0,70,-70
12,71,13,67,131,166,-35
12,71,13,89,81,96,-15
12,71,13,121,139,184,-45
12,71,13,135,159,191,-32
12,71,15,3,76,0,76
12,71,17,31,866,373,493
12,71,17,43,342,87,255
12,71,17,89,255,68,187
12,71,17,97,281,99,182
12,71,17,111,194,0,194
12,71,17,113,66,0,66
12,71,17,143,73,0,73
12,71,17,167,100,0,100
12,71,17,197,265,88,177
12,71,17,201,115,0,115
12,71,18,3,135,63,72
12,71,18,39,79,0,79
12,71,18,57,205,111,94
12,71,18,63,80,0,80
12,71,18,89,145,0,145
12,71,18,97,247,132,115
12,71,18,127,90,0,90
12,71,18,141,85,0,85
12,71,18,157,56,0,56
12,71,19,153,57,0,57
12,71,19,163,61,0,61
12,71,20,91,123,91,32
12,71,21,15,67,0,67
12,71,21,67,85,0,85
12,71,21,111,225,128,97
12,71,23,5,106,68,38
12,71,23,31,62,0,62
12,71,24,3,199,104,95
12,71,24,5,170,61,109
12,71,24,27,73,0,73
12,71,24,31,167,73,94
12,71,24,33,67,0,67
12,71,24,510,63,0,63
12,71,25,1,215,116,99
12,71,25,5,172,75,97
12,71,25,9,282,114,168
12,71,25,13,98,0,98
12,71,25,17,314,189,125
12,71,25,21,176,99,77
12,71,25,23,180,100,80
12,71,25,25,106,96,10
12,71,25,27,224,84,140
12,71,26,21,68,0,68
12,71,26,49,135,79,56
12,71,26,65,60,0,60
12,71,26,77,52,0,52
12,71,26,81,135,107,28
12,71,26,93,74,0,74
12,71,26,99,298,125,173
12,71,26,125,380,194,186
12,71,26,139,104,0,104
12,71,26,147,85,59,26
12,71,26,161,99,0,99
12,71,26,163,271,134,137
12,71,27,3,95,0,95
12,71,27,37,138,77,61
12,71,27,53,329,214,115
12,71,27,123,89,0,89
12,71,27,139,65,0,65
12,71,27,163,98,0,98
12,71,29,29,55,0,55
12,71,29,95,70,56,14
12,71,29,183,103,56,47
12,71,29,189,249,129,120
12,71,31,55,77,58,19
12,71,32,3,211,205,6
12,71,33,11,149,72,77
12,71,33,15,109,75,34
12,71,34,1,110,0,110
12,71,34,3,237,47,190
12,71,34,5,146,64,82
12,71,34,7,123,0,123
12,71,34,9,90,0,90
12,71,34,13,104,0,104
12,71,34,15,96,0,96
12,71,34,17,170,0,170
12,71,34,21,72,0,72
12,71,34,23,155,0,155
12,71,34,25,210,71,139
12,71,34,27,168,70,98
12,71,34,29,270,134,136
12,71,34,31,102,0,102
12,71,34,35,158,0,158
12,71,34,37,71,0,71
12,71,34,39,107,0,107
12,71,36,1,108,0,108
12,71,36,5,201,61,140
12,71,36,27,0,61,-61
12,71,36,29,258,104,154
12,71,36,47,274,116,158
12,71,36,55,189,125,64
12,71,36,59,310,110,200
12,71,36,61,190,125,65
12,71,36,65,81,0,81
12,71,36,67,149,75,74
12,71,36,71,87,0,87
12,71,36,81,279,116,163
12,71,36,85,142,0,142
12,71,36,87,96,0,96
12,71,36,91,63,0,63
12,71,36,103,538,210,328
12,71,36,119,220,0,220
12,71,37,21,83,114,-31
12,71,37,39,0,55,-55
12,71,37,51,68,0,68
12,71,37,67,0,83,-83
12,71,37,81,70,98,-28
12,71,37,89,0,78,-78
12,71,37,119,150,226,-76
12,71,37,129,55,0,55
12,71,37,133,66,0,66
12,71,37,183,104,198,-94
12,71,39,17,112,63,49
12,71,39,25,74,0,74
12,71,39,35,299,214,85
12,71,39,41,96,0,96
12,71,39,49,337,240,97
12,71,39,61,175,130,45
12,71,39,85,68,66,2
12,71,39,93,75,67,8
12,71,39,95,166,82,84
12,71,39,99,61,0,61
12,71,39,103,83,0,83
12,71,39,113,126,0,126
12,71,39,133,57,0,57
12,71,39,151,99,77,22
12,71,39,153,194,66,128
12,71,39,165,87,0,87
12,71,40,109,56,0,56
12,71,41,51,0,54,-54
12,71,42,3,271,120,151
12,71,42,11,66,0,66
12,71,42,17,170,85,85
12,71,42,29,122,83,39
12,71,42,43,53,0,53
12,71,42,45,114,0,114
12,71,42,49,98,0,98
12,71,42,71,88,86,2
12,71,42,77,74,0,74
12,71,42,79,87,0,87
12,71,42,91,214,116,98
12,71,42,95,77,0,77
12,71,42,101,105,108,-3
12,71,42,125,82,0,82
12,71,42,129,70,0,70
12,71,42,133,69,0,69
12,71,44,3,96,0,96
12,71,44,7,145,95,50
12,71,44,9,78,0,78
12,71,45,13,56,68,-12
12,71,45,19,0,50,-50
12,71,45,45,91,147,-56
12,71,45,51,62,88,-26
12,71,45,79,0,68,-68
12,71,45,83,0,64,-64
12,71,47,9,0,62,-62
12,71,47,37,128,153,-25
12,71,47,65,0,79,-79
12,71,47,93,80,161,-81
12,71,47,125,62,0,62
12,71,47,149,66,66,0
12,71,47,155,0,75,-75
12,71,47,157,0,64,-64
12,71,48,27,0,58,-58
12,71,48,29,118,100,18
12,71,48,85,92,60,32
12,71,48,113,137,178,-41
12,71,48,121,67,117,-50
12,71,48,201,249,230,19
12,71,48,339,69,0,69
12,71,48,439,122,139,-17
12,71,48,453,173,142,31
12,71,49,35,0,54,-54
12,71,50,7,70,0,70
12,71,51,13,62,0,62
12,71,51,41,73,0,73
12,71,51,59,208,110,98
12,71,51,87,0,65,-65
12,71,51,107,67,62,5
12,71,51,153,54,0,54
12,71,51,810,127,74,53
12,71,53,33,117,125,-8
12,71,53,53,58,0,58
12,71,55,25,142,72,70
12,71,55,79,157,63,94
12,71,55,133,138,76,62
12,73,1,69,74,0,74
12,73,1,73,82,0,82
12,73,4,13,47,69,-22
12,73,6,37,77,155,-78
12,73,6,73,69,89,-20
12,73,8,5,0,47,-47
12,73,8,31,0,87,-87
12,73,8,41,0,56,-56
12,73,11,1,67,81,-14
12,73,12,1,273,273,0
12,73,12,5,554,320,234
12,73,12,9,198,210,-12
12,73,12,11,705,639,66
12,73,12,13,60,0,60
12,73,12,19,128,120,8
12,73,12,21,77,98,-21
12,73,12,23,0,55,-55
12,73,12,31,488,904,-416
12,73,12,33,233,258,-25
12,73,12,35,53,52,1
12,73,12,37,88,105,-17
12,73,12,39,1696,1606,90
12,73,12,45,60,0,60
12,73,12,57,511,808,-297
12,73,12,61,53,0,53
12,73,12,63,227,166,61
12,73,12,65,514,540,-26
12,73,12,69,135,133,2
12,73,12,71,186,182,4
12,73,12,77,76,78,-2
12,73,12,79,97,85,12
12,73,12,81,132,131,1
12,73,12,83,132,141,-9
12,73,12,85,72,0,72
12,73,12,86,584,512,72
12,73,12,91,166,211,-45
12,73,12,95,549,746,-197
12,73,12,97,94,84,10
12,73,12,99,433,356,77
12,73,12,101,146,174,-28
12,73,12,103,346,391,-45
12,73,12,105,176,239,-63
12,73,12,109,88,273,-185
12,73,12,111,137,113,24
12,73,12,113,118,118,0
12,73,12,115,74,126,-52
12,73,12,117,167,241,-74
12,73,12,123,140,123,17
12,73,12,127,174,176,-2
12,73,12,129,927,1483,-556
12,73,12,131,58,113,-55
12,73,13,51,0,52,-52
12,73,13,67,69,170,-101
12,73,13,87,151,97,54
12,73,13,89,105,199,-94
12,73,13,95,85,0,85
12,73,13,121,132,267,-135
12,73,13,131,138,99,39
12,73,13,135,91,104,-13
12,73,13,185,105,76,29
12,73,13,275,279,231,48
12,73,17,31,115,132,-17
12,73,24,33,0,46,-46
12,73,25,17,0,67,-67
12,73,25,25,0,47,-47
12,73,32,3,0,53,-53
12,73,36,47,83,64,19
12,73,36,61,0,67,-67
12,73,37,21,0,57,-57
12,73,37,119,0,118,-118
12,73,37,183,0,103,-103
12,73,47,37,0,79,-79
12,73,47,93,0,65,-65
12,73,47,157,0,56,-56
12,73,48,29,0,60,-60
12,73,48,113,49,0,49
12,73,48,201,95,148,-53
12,73,48,453,114,100,14
12,73,51,59,0,79,-79
12,73,53,33,0,81,-81
12,75,12,1,750,694,56
12,75,12,11,88,0,88
12,75,12,17,198,213,-15
12,75,12,29,173,142,31
12,75,12,41,310,301,9
12,75,12,57,80,77,3
12,75,12,83,487,576,-89
12,75,12,95,71,0,71
12,75,12,99,63,0,63
12,75,12,101,72,0,72
12,75,12,103,70,0,70
12,77,12,13,107,108,-1
12,77,12,73,78,76,2
12,79,12,73,85,97,-12
12,79,12,121,0,57,-57
12,79,12,123,71,0,71
12,79,13,185,134,95,39
12,81,4,13,158,130,28
12,81,4,19,0,67,-67
12,81,6,37,116,121,-5
12,81,6,59,82,75,7
12,81,6,73,104,60,44
12,81,8,5,73,0,73
12,81,8,31,0,68,-68
12,81,8,41,110,59,51
12,81,9,1,134,0,134
12,81,9,3,194,0,194
12,81,9,9,136,0,136
12,81,12,1,121,113,8
12,81,12,5,56,0,56
12,81,12,9,164,113,51
12,81,12,11,497,277,220
12,81,12,15,369,420,-51
12,81,12,17,0,86,-86
12,81,12,19,75,76,-1
12,81,12,21,267,109,158
12,81,12,27,132,132,0
12,81,12,31,137,205,-68
12,81,12,33,56,0,56
12,81,12,49,87,97,-10
12,81,12,53,64,101,-37
12,81,12,55,103,135,-32
12,81,12,57,2781,2996,-215
12,81,12,69,160,205,-45
12,81,12,71,520,349,171
12,81,12,73,131,132,-1
12,81,12,83,119,156,-37
12,81,12,86,601,330,271
12,81,12,87,73,0,73
12,81,12,91,0,61,-61
12,81,12,95,593,442,151
12,81,12,97,107,117,-10
12,81,12,99,443,239,204
12,81,12,101,356,287,69
12,81,12,103,2165,1540,625
12,81,12,105,423,359,64
12,81,12,109,82,0,82
12,81,12,111,66,78,-12
12,81,12,115,7786,6795,991
12,81,12,117,204,134,70
12,81,12,119,85,78,7
12,81,12,127,119,119,0
12,81,13,57,56,0,56
12,81,13,67,114,78,36
12,81,13,89,0,50,-50
12,81,13,121,183,90,93
12,81,13,135,111,85,26
12,81,15,3,60,0,60
12,81,17,31,362,135,227
12,81,17,43,136,0,136
12,81,17,89,73,0,73
12,81,17,97,94,0,94
12,81,17,197,71,0,71
12,81,18,3,73,0,73
12,81,18,57,103,0,103
12,81,18,97,90,69,21
12,81,20,91,70,0,70
12,81,21,67,90,0,90
12,81,21,111,107,67,40
12,81,23,5,66,0,66
12,81,24,3,69,0,69
12,81,24,5,72,0,72
12,81,24,31,163,0,163
12,81,25,1,95,0,95
12,81,25,5,69,0,69
12,81,25,9,84,0,84
12,81,25,13,56,0,56
12,81,25,17,114,73,41
12,81,25,21,54,0,54
12,81,25,25,63,0,63
12,81,25,27,98,55,43
12,81,26,49,58,0,58
12,81,26,81,78,73,5
12,81,26,99,88,0,88
12,81,26,125,163,80,83
12,81,26,163,107,64,43
12,81,27,53,90,60,30
12,81,29,189,104,0,104
12,81,32,3,82,136,-54
12,81,33,11,96,64,32
12,81,33,15,71,0,71
12,81,34,3,97,0,97
12,81,34,5,57,0,57
12,81,34,13,68,0,68
12,81,34,23,80,0,80
12,81,34,25,133,0,133
12,81,34,27,120,0,120
12,81,34,29,90,0,90
12,81,34,39,57,0,57
12,81,36,29,109,60,49
12,81,36,47,83,54,29
12,81,36,55,119,49,70
12,81,36,59,139,0,139
12,81,36,61,95,0,95
12,81,36,67,71,0,71
12,81,36,81,105,0,105
12,81,36,91,53,0,53
12,81,36,103,253,0,253
12,81,36,119,132,0,132
12,81,37,119,76,100,-24
12,81,37,183,76,88,-12
12,81,39,17,71,0,71
12,81,39,35,79,79,0
12,81,39,49,168,86,82
12,81,39,61,75,0,75
12,81,39,95,53,0,53
12,81,39,153,68,0,68
12,81,42,3,168,60,108
12,81,42,17,87,0,87
12,81,42,49,0,56,-56
12,81,42,71,85,0,85
12,81,42,91,104,0,104
12,81,42,95,69,0,69
12,81,44,7,62,0,62
12,81,47,37,80,50,30
12,81,47,157,61,0,61
12,81,48,29,55,0,55
12,81,48,85,111,76,35
12,81,48,113,69,57,12
12,81,48,201,155,90,65
12,81,48,439,79,54,25
12,81,48,453,86,65,21
12,81,48,491,0,62,-62
12,81,51,59,223,80,143
12,81,51,107,102,0,102
12,81,51,153,76,0,76
12,81,51,810,0,53,-53
12,81,53,33,94,91,3
12,81,55,79,67,0,67
12,81,55,133,79,0,79
12,83,4,13,106,87,19
12,83,6,37,80,71,9
12,83,6,73,105,54,51
12,83,8,41,103,0,103
12,83,9,3,77,0,77
12,83,9,9,123,0,123
12,83,12,1,1179,1130,49
12,83,12,5,87,0,87
12,83,12,9,268,250,18
12,83,12,11,921,280,641
12,83,12,15,96,0,96
12,83,12,17,1207,1289,-82
12,83,12,19,178,136,42
12,83,12,21,128,0,128
12,83,12,23,79,67,12
12,83,12,31,429,370,59
12,83,12,33,68,65,3
12,83,12,35,97,113,-16
12,83,12,53,172,163,9
12,83,12,55,97,0,97
12,83,12,57,670,756,-86
12,83,12,61,66,0,66
12,83,12,69,2185,1729,456
12,83,12,71,345,168,177
12,83,12,73,141,132,9
12,83,12,75,576,487,89
12,83,12,81,156,119,37
12,83,12,85,65,0,65
12,83,12,86,812,229,583
12,83,12,87,100,0,100
12,83,12,89,64,0,64
12,83,12,91,86,54,32
12,83,12,95,938,774,164
12,83,12,97,328,169,159
12,83,12,99,658,279,379
12,83,12,101,423,331,92
12,83,12,103,500,393,107
12,83,12,105,449,326,123
12,83,12,107,170,198,-28
12,83,12,109,169,180,-11
12,83,12,111,171,175,-4
12,83,12,115,157,159,-2
12,83,12,117,364,259,105
12,83,12,119,1200,1063,137
12,83,12,127,495,462,33
12,83,13,67,81,0,81
12,83,13,121,57,0,57
12,83,13,135,74,0,74
12,83,17,31,118,64,54
12,83,25,9,59,0,59
12,83,25,13,63,0,63
12,83,25,27,75,0,75
12,83,26,125,62,0,62
12,83,26,163,97,0,97
12,83,32,3,79,0,79
12,83,33,11,55,0,55
12,83,33,15,59,0,59
12,83,34,23,60,0,60
12,83,34,29,60,0,60
12,83,36,5,134,0,134
12,83,36,29,61,0,61
12,83,36,47,123,0,123
12,83,36,59,105,0,105
12,83,36,67,59,0,59
12,83,36,71,63,0,63
12,83,36,81,201,76,125
12,83,36,91,60,0,60
12,83,36,103,237,84,153
12,83,36,119,55,0,55
12,83,37,51,62,0,62
12,83,37,119,71,0,71
12,83,37,183,84,92,-8
12,83,39,49,68,0,68
12,83,42,11,75,0,75
12,83,48,201,101,91,10
12,83,48,453,68,0,68
12,83,51,59,77,0,77
12,83,55,79,51,0,51
12,85,4,13,53,0,53
12,85,9,1,94,53,41
12,85,9,3,99,0,99
12,85,9,9,58,0,58
12,85,12,1,63,0,63
12,85,12,9,133,188,-55
12,85,12,11,691,338,353
12,85,12,21,55,0,55
12,85,12,31,77,93,-16
12,85,12,57,93,101,-8
12,85,12,61,144,307,-163
12,85,12,69,0,60,-60
12,85,12,71,59,126,-67
12,85,12,73,0,72,-72
12,85,12,83,0,65,-65
12,85,12,86,319,143,176
12,85,12,87,89,72,17
12,85,12,93,75,221,-146
12,85,12,95,176,207,-31
12,85,12,99,3795,2141,1654
12,85,12,101,0,57,-57
12,85,12,103,98,65,33
12,85,12,105,0,83,-83
12,85,12,109,0,58,-58
12,85,12,111,2892,3741,-849
12,85,12,115,52,0,52
12,85,12,117,0,93,-93
12,85,12,127,104,83,21
12,85,17,31,92,0,92
12,85,25,9,52,0,52
12,85,25,17,56,0,56
12,85,34,25,98,0,98
12,85,34,29,89,64,25
12,85,36,59,127,56,71
12,85,36,81,43,0,43
12,85,36,103,244,73,171
12,85,36,119,55,0,55
12,85,37,183,0,51,-51
12,85,42,91,52,0,52
12,86,1,73,0,103,-103
12,86,1,89,0,72,-72
12,86,1,101,0,73,-73
12,86,4,13,475,666,-191
12,86,4,19,126,108,18
12,86,5,119,0,62,-62
12,86,6,1,204,264,-60
12,86,6,13,123,131,-8
12,86,6,29,0,76,-76
12,86,6,37,1455,1751,-296
12,86,6,59,283,313,-30
12,86,6,65,242,139,103
12,86,6,67,97,75,22
12,86,6,71,159,138,21
12,86,6,73,532,643,-111
12,86,6,75,257,312,-55
12,86,6,81,115,217,-102
12,86,6,85,233,294,-61
12,86,6,97,0,55,-55
12,86,6,111,0,55,-55
12,86,8,1,74,112,-38
12,86,8,5,110,276,-166
12,86,8,13,0,121,-121
12,86,8,31,164,443,-279
12,86,8,35,0,69,-69
12,86,8,41,329,380,-51
12,86,8,59,83,101,-18
12,86,8,69,0,65,-65
12,86,9,1,432,210,222
12,86,9,3,191,117,74
12,86,9,9,148,136,12
12,86,9,11,49,61,-12
12,86,10,3,95,0,95
12,86,11,1,438,531,-93
12,86,12,1,425,876,-451
12,86,12,5,142,98,44
12,86,12,9,440,1004,-564
12,86,12,11,27955,47205,-19250
12,86,12,15,114,292,-178
12,86,12,17,0,161,-161
12,86,12,19,142,284,-142
12,86,12,21,840,1532,-692
12,86,12,23,0,102,-102
12,86,12,31,790,1784,-994
12,86,12,33,109,198,-89
12,86,12,35,89,232,-143
12,86,12,51,126,321,-195
12,86,12,53,114,230,-116
12,86,12,55,124,490,-366
12,86,12,57,2201,4321,-2120
12,86,12,61,160,446,-286
12,86,12,69,179,757,-578
12,86,12,71,1496,3923,-2427
12,86,12,73,512,584,-72
12,86,12,81,330,601,-271
12,86,12,83,229,812,-583
12,86,12,85,143,319,-176
12,86,12,87,1128,1197,-69
12,86,12,91,114,198,-84
12,86,12,93,0,57,-57
12,86,12,95,2299,5126,-2827
12,86,12,97,578,1555,-977
12,86,12,99,3754,6732,-2978
12,86,12,101,262,649,-387
12,86,12,103,580,1041,-461
12,86,12,105,543,1472,-929
12,86,12,107,0,58,-58
12,86,12,109,140,339,-199
12,86,12,111,568,1449,-881
12,86,12,113,0,59,-59
12,86,12,115,271,603,-332
12,86,12,117,475,1087,-612
12,86,12,119,0,128,-128
12,86,12,121,0,127,-127
12,86,12,127,361,860,-499
12,86,13,21,0,118,-118
12,86,13,45,0,71,-71
12,86,13,51,127,224,-97
12,86,13,57,0,160,-160
12,86,13,63,182,445,-263
12,86,13,67,301,573,-272
12,86,13,77,0,69,-69
12,86,13,89,306,693,-387
12,86,13,95,0,64,-64
12,86,13,97,0,109,-109
12,86,13,113,0,64,-64
12,86,13,117,0,98,-98
12,86,13,121,532,1063,-531
12,86,13,127,0,62,-62
12,86,13,135,380,955,-575
12,86,13,139,0,101,-101
12,86,13,151,78,210,-132
12,86,13,153,0,89,-89
12,86,13,179,0,95,-95
12,86,13,185,0,167,-167
12,86,13,215,0,91,-91
12,86,13,217,0,74,-74
12,86,13,223,0,98,-98
12,86,13,245,0,126,-126
12,86,13,247,0,84,-84
12,86,13,313,0,74,-74
12,86,15,3,195,163,32
12,86,17,31,1155,997,158
12,86,17,43,132,140,-8
12,86,17,97,125,74,51
12,86,18,17,0,67,-67
12,86,18,57,0,64,-64
12,86,18,97,157,257,-100
12,86,19,21,0,59,-59
12,86,20,91,63,90,-27
12,86,21,67,59,68,-9
12,86,21,111,346,831,-485
12,86,22,33,0,67,-67
12,86,22,51,187,151,36
12,86,22,71,104,131,-27
12,86,24,3,115,147,-32
12,86,24,5,139,81,58
12,86,24,31,409,420,-11
12,86,24,33,155,218,-63
12,86,24,45,0,46,-46
12,86,24,510,114,140,-26
12,86,25,1,0,65,-65
12,86,25,9,159,174,-15
12,86,25,17,427,365,62
12,86,25,21,174,146,28
12,86,25,23,76,86,-10
12,86,25,25,421,419,2
12,86,25,27,120,108,12
12,86,26,65,0,53,-53
12,86,26,81,79,106,-27
12,86,26,125,150,90,60
12,86,26,161,84,73,11
12,86,26,163,92,166,-74
12,86,27,53,155,214,-59
12,86,29,21,0,44,-44
12,86,29,95,118,142,-24
12,86,29,189,94,113,-19
12,86,29,510,0,48,-48
12,86,31,55,0,52,-52
12,86,31,79,100,163,-63
12,86,31,119,0,96,-96
12,86,31,141,0,83,-83
12,86,32,3,728,1202,-474
12,86,33,11,50,0,50
12,86,34,1,73,0,73
12,86,34,3,442,281,161
12,86,34,5,67,70,-3
12,86,34,7,0,61,-61
12,86,34,13,288,291,-3
12,86,34,17,701,503,198
12,86,34,21,74,58,16
12,86,34,23,212,181,31
12,86,34,25,130,96,34
12,86,34,27,123,94,29
12,86,34,29,91,59,32
12,86,34,31,162,151,11
12,86,34,35,65,0,65
12,86,34,39,321,175,146
12,86,35,1,105,83,22
12,86,35,15,0,50,-50
12,86,35,25,0,74,-74
12,86,36,5,614,467,147
12,86,36,29,100,79,21
12,86,36,47,1340,1081,259
12,86,36,55,103,68,35
12,86,36,59,517,282,235
12,86,36,61,2286,1513,773
12,86,36,67,64,75,-11
12,86,36,71,59,0,59
12,86,36,81,1389,779,610
12,86,36,85,116,0,116
12,86,36,87,84,66,18
12,86,36,103,315,268,47
12,86,36,119,413,287,126
12,86,37,21,0,182,-182
12,86,37,51,131,229,-98
12,86,37,63,87,148,-61
12,86,37,67,57,127,-70
12,86,37,81,75,175,-100
12,86,37,89,0,72,-72
12,86,37,97,0,100,-100
12,86,37,101,0,86,-86
12,86,37,119,346,818,-472
12,86,37,133,98,129,-31
12,86,37,135,0,75,-75
12,86,37,179,0,114,-114
12,86,37,183,261,690,-429
12,86,39,35,189,173,16
12,86,39,49,111,232,-121
12,86,39,61,73,111,-38
12,86,40,109,63,62,1
12,86,40,143,0,77,-77
12,86,41,51,101,117,-16
12,86,41,67,0,62,-62
12,86,42,3,216,173,43
12,86,42,11,70,0,70
12,86,42,17,72,63,9
12,86,42,29,66,60,6
12,86,42,45,69,0,69
12,86,42,71,118,68,50
12,86,42,77,81,67,14
12,86,42,91,137,138,-1
12,86,42,101,328,422,-94
12,86,44,7,150,157,-7
12,86,45,13,80,71,9
12,86,45,15,48,73,-25
12,86,45,19,91,123,-32
12,86,45,45,74,241,-167
12,86,45,63,0,101,-101
12,86,45,79,80,125,-45
12,86,45,83,58,94,-36
12,86,45,91,0,79,-79
12,86,47,37,231,351,-120
12,86,47,65,0,96,-96
12,86,47,93,57,145,-88
12,86,47,125,0,97,-97
12,86,47,149,0,129,-129
12,86,47,157,168,227,-59
12,86,47,187,0,84,-84
12,86,48,27,66,177,-111
12,86,48,29,320,420,-100
12,86,48,39,0,85,-85
12,86,48,85,172,301,-129
12,86,48,113,507,776,-269
12,86,48,121,127,232,-105
12,86,48,135,0,321,-321
12,86,48,141,161,173,-12
12,86,48,157,128,295,-167
12,86,48,167,54,58,-4
12,86,48,201,1397,2461,-1064
12,86,48,215,86,122,-36
12,86,48,329,0,159,-159
12,86,48,339,98,139,-41
12,86,48,355,0,78,-78
12,86,48,439,231,535,-304
12,86,48,453,809,772,37
12,86,48,491,59,217,-158
12,86,49,35,102,186,-84
12,86,51,13,193,191,2
12,86,51,41,0,95,-95
12,86,51,59,420,487,-67
12,86,51,87,76,73,3
12,86,51,107,172,195,-23
12,86,51,153,102,157,-55
12,86,51,510,117,131,-14
12,86,51,550,0,82,-82
12,86,51,700,0,66,-66
12,86,51,710,69,54,15
12,86,51,810,164,147,17
12,86,53,33,288,475,-187
12,86,53,53,94,116,-22
12,86,53,61,0,102,-102
12,86,55,25,60,66,-6
12,86,55,79,75,74,1
12,87,4,13,0,66,-66
12,87,6,73,90,90,0
12,87,12,1,58,55,3
12,87,12,9,81,151,-70
12,87,12,11,385,469,-84
12,87,12,15,0,85,-85
12,87,12,17,0,55,-55
12,87,12,19,0,106,-106
12,87,12,21,61,126,-65
12,87,12,31,135,193,-58
12,87,12,55,0,70,-70
12,87,12,57,137,172,-35
12,87,12,61,0,100,-100
12,87,12,69,0,82,-82
12,87,12,71,140,260,-120
12,87,12,81,0,73,-73
12,87,12,83,0,100,-100
12,87,12,85,72,89,-17
12,87,12,86,1197,1128,69
12,87,12,95,151,225,-74
12,87,12,99,250,358,-108
12,87,12,103,119,232,-113
12,87,12,105,0,139,-139
12,87,12,109,0,121,-121
12,87,12,111,0,57,-57
12,87,12,115,0,153,-153
12,87,12,127,85,143,-58
12,87,17,31,76,56,20
12,87,24,3,71,0,71
12,87,32,3,0,78,-78
12,87,36,103,58,0,58
12,87,51,810,79,83,-4
12,89,6,73,97,0,97
12,89,12,1,54,0,54
12,89,12,3,66,96,-30
12,89,12,9,73,0,73
12,89,12,11,138,0,138
12,89,12,19,373,324,49
12,89,12,31,3260,1987,1273
12,89,12,57,56,66,-10
12,89,12,71,62,0,62
12,89,12,83,0,64,-64
12,89,12,95,117,100,17
12,89,12,99,77,0,77
12,89,12,103,53,0,53
12,89,12,109,168,159,9
12,89,13,39,387,365,22
12,89,13,49,97,117,-20
12,89,13,67,65,0,65
12,89,13,121,65,0,65
12,89,13,127,55,0,55
12,89,45,19,49,0,49
12,91,1,3,143,125,18
12,91,1,39,132,144,-12
12,91,1,69,96,58,38
12,91,1,73,115,61,54
12,91,1,81,75,0,75
12,91,1,89,134,109,25
12,91,1,97,154,103,51
12,91,1,101,121,124,-3
12,91,1,117,56,0,56
12,91,2,20,122,109,13
12,91,4,13,129,245,-116
12,91,4,19,177,149,28
12,91,5,119,90,0,90
12,91,6,29,140,0,140
12,91,6,31,0,76,-76
12,91,6,37,165,98,67
12,91,6,53,81,0,81
12,91,6,65,0,59,-59
12,91,6,73,201,163,38
12,91,6,95,60,0,60
12,91,8,5,64,0,64
12,91,8,41,320,275,45
12,91,12,1,59,51,8
12,91,12,5,839,365,474
12,91,12,9,169,173,-4
12,91,12,11,139,119,20
12,91,12,17,0,50,-50
12,91,12,19,75,0,75
12,91,12,31,183,211,-28
12,91,12,33,723,836,-113
12,91,12,57,289,342,-53
12,91,12,69,77,71,6
12,91,12,71,82,111,-29
12,91,12,73,211,166,45
12,91,12,81,61,0,61
12,91,12,83,54,86,-32
12,91,12,86,198,114,84
12,91,12,95,206,222,-16
12,91,12,99,130,71,59
12,91,12,101,108,68,40
12,91,12,103,193,124,69
12,91,12,105,133,143,-10
12,91,12,113,1701,2389,-688
12,91,12,115,68,0,68
12,91,12,117,90,73,17
12,91,12,127,97,129,-32
12,91,12,131,1767,2393,-626
12,91,13,51,0,54,-54
12,91,13,67,78,68,10
12,91,13,89,55,0,55
12,91,13,121,115,73,42
12,91,13,135,86,0,86
12,91,13,153,117,96,21
12,91,13,185,103,0,103
12,91,13,215,78,0,78
12,91,15,3,171,149,22
12,91,17,31,66,0,66
12,91,17,163,122,0,122
12,91,18,97,78,62,16
12,91,22,15,90,0,90
12,91,24,3,81,0,81
12,91,24,31,0,66,-66
12,91,28,47,182,124,58
12,91,28,87,60,0,60
12,91,32,3,269,253,16
12,91,35,1,176,73,103
12,91,35,9,295,119,176
12,91,35,35,92,0,92
12,91,37,51,403,249,154
12,91,37,85,146,144,2
12,91,37,119,47,0,47
12,91,37,125,0,142,-142
12,91,37,133,0,71,-71
12,91,37,191,89,0,89
12,91,39,57,74,145,-71
12,91,39,113,86,122,-36
12,91,40,109,0,72,-72
12,91,45,19,65,0,65
12,91,45,79,77,0,77
12,91,45,85,68,0,68
12,91,47,37,0,67,-67
12,91,47,125,131,95,36
12,91,47,157,120,0,120
12,91,48,27,57,0,57
12,91,48,29,405,438,-33
12,91,48,113,0,67,-67
12,91,48,141,76,90,-14
12,91,48,201,111,92,19
12,91,48,439,99,164,-65
12,91,48,441,57,0,57
12,91,48,451,56,0,56
12,91,48,453,64,57,7
12,91,48,485,114,0,114
12,91,49,11,0,124,-124
12,91,51,59,198,197,1
12,91,51,153,76,0,76
12,91,51,510,0,60,-60
12,91,51,810,88,135,-47
12,91,53,53,84,97,-13
12,93,12,11,96,0,96
12,93,12,43,177,161,16
12,93,12,55,94,155,-61
12,93,12,85,221,75,146
12,93,12,86,57,0,57
12,93,12,99,442,193,249
12,93,12,111,334,252,82
12,95,1,3,103,58,45
12,95,1,73,159,132,27
12,95,1,89,122,102,20
12,95,1,97,53,85,-32
12,95,1,117,0,65,-65
12,95,4,13,498,526,-28
12,95,4,19,143,104,39
12,95,5,119,59,0,59
12,95,6,1,143,103,40
12,95,6,13,70,85,-15
12,95,6,29,66,0,66
12,95,6,37,870,1206,-336
12,95,6,59,299,457,-158
12,95,6,65,144,167,-23
12,95,6,67,81,137,-56
12,95,6,71,140,111,29
12,95,6,73,442,447,-5
12,95,6,75,106,91,15
12,95,6,81,110,69,41
12,95,6,85,218,184,34
12,95,6,111,0,69,-69
12,95,8,1,87,98,-11
12,95,8,5,148,237,-89
12,95,8,13,0,68,-68
12,95,8,31,157,331,-174
12,95,8,35,96,127,-31
12,95,8,41,245,239,6
12,95,8,59,105,142,-37
12,95,8,69,0,77,-77
12,95,9,1,417,188,229
12,95,9,3,350,250,100
12,95,9,9,387,189,198
12,95,9,11,79,0,79
12,95,10,3,138,104,34
12,95,11,1,148,184,-36
12,95,12,1,820,544,276
12,95,12,5,262,126,136
12,95,12,9,2900,3497,-597
12,95,12,11,4715,2641,2074
12,95,12,15,158,171,-13
12,95,12,17,192,245,-53
12,95,12,19,215,314,-99
12,95,12,21,449,325,124
12,95,12,23,66,86,-20
12,95,12,31,1621,1571,50
12,95,12,33,245,232,13
12,95,12,35,190,226,-36
12,95,12,53,233,265,-32
12,95,12,55,271,217,54
12,95,12,57,2531,2722,-191
12,95,12,61,340,275,65
12,95,12,69,5529,11385,-5856
12,95,12,71,1040,683,357
12,95,12,73,746,549,197
12,95,12,75,0,71,-71
12,95,12,81,442,593,-151
12,95,12,83,774,938,-164
12,95,12,85,207,176,31
12,95,12,86,5126,2299,2827
12,95,12,87,225,151,74
12,95,12,89,100,117,-17
12,95,12,91,222,206,16
12,95,12,97,13812,17747,-3935
12,95,12,99,2433,1753,680
12,95,12,101,576,804,-228
12,95,12,103,1149,1597,-448
12,95,12,105,4512,8002,-3490
12,95,12,107,100,97,3
12,95,12,109,325,365,-40
12,95,12,111,802,572,230
12,95,12,113,116,167,-51
12,95,12,115,375,502,-127
12,95,12,117,18165,21334,-3169
12,95,12,119,168,375,-207
12,95,12,127,2661,4311,-1650
12,95,12,131,65,0,65
12,95,13,51,216,200,16
12,95,13,57,101,89,12
12,95,13,63,91,218,-127
12,95,13,67,381,473,-92
12,95,13,77,0,52,-52
12,95,13,89,365,388,-23
12,95,13,97,0,66,-66
12,95,13,113,0,67,-67
12,95,13,117,67,120,-53
12,95,13,121,459,642,-183
12,95,13,135,464,499,-35
12,95,13,139,0,53,-53
12,95,13,151,109,154,-45
12,95,13,153,60,73,-13
12,95,13,179,112,63,49
12,95,13,185,97,105,-8
12,95,13,215,0,63,-63
12,95,13,245,59,103,-44
12,95,15,3,276,186,90
12,95,17,31,918,769,149
12,95,17,43,191,97,94
12,95,17,89,84,53,31
12,95,17,97,136,75,61
12,95,17,197,150,69,81
12,95,18,57,82,71,11
12,95,18,89,75,63,12
12,95,18,97,183,146,37
12,95,20,91,97,100,-3
12,95,20,173,59,0,59
12,95,21,67,81,0,81
12,95,21,111,179,169,10
12,95,22,33,104,0,104
12,95,22,51,78,71,7
12,95,22,71,93,63,30
12,95,23,5,57,0,57
12,95,24,3,139,98,41
12,95,24,5,187,101,86
12,95,24,21,89,0,89
12,95,24,25,94,0,94
12,95,24,27,74,70,4
12,95,24,31,334,240,94
12,95,24,33,189,149,40
12,95,24,37,75,0,75
12,95,24,510,93,67,26
12,95,25,1,59,0,59
12,95,25,5,128,99,29
12,95,25,9,266,116,150
12,95,25,13,198,194,4
12,95,25,17,332,274,58
12,95,25,21,123,122,1
12,95,25,23,110,63,47
12,95,25,25,275,263,12
12,95,25,27,278,150,128
12,95,26,81,103,97,6
12,95,26,99,72,61,11
12,95,26,125,333,189,144
12,95,26,161,82,53,29
12,95,26,163,200,139,61
12,95,27,37,73,0,73
12,95,27,53,126,149,-23
12,95,29,77,65,0,65
12,95,29,95,116,59,57
12,95,29,189,155,99,56
12,95,29,510,60,0,60
12,95,31,55,99,0,99
12,95,32,3,435,544,-109
12,95,32,31,0,86,-86
12,95,33,11,110,78,32
12,95,33,15,74,0,74
12,95,34,1,97,80,17
12,95,34,3,353,197,156
12,95,34,5,119,84,35
12,95,34,7,193,97,96
12,95,34,13,324,141,183
12,95,34,15,81,0,81
12,95,34,17,400,183,217
12,95,34,21,101,0,101
12,95,34,23,338,150,188
12,95,34,25,194,0,194
12,95,34,27,161,56,105
12,95,34,29,125,88,37
12,95,34,31,181,74,107
12,95,34,35,128,0,128
12,95,34,39,270,124,146
12,95,35,1,90,61,29
12,95,36,1,67,0,67
12,95,36,5,1062,428,634
12,95,36,7,70,0,70
12,95,36,27,90,0,90
12,95,36,29,173,166,7
12,95,36,47,1000,654,346
12,95,36,55,256,165,91
12,95,36,59,467,205,262
12,95,36,61,521,489,32
12,95,36,67,141,80,61
12,95,36,71,128,89,39
12,95,36,81,1396,558,838
12,95,36,85,260,0,260
12,95,36,87,85,0,85
12,95,36,103,601,208,393
12,95,36,119,325,145,180
12,95,37,21,49,147,-98
12,95,37,51,150,208,-58
12,95,37,63,79,129,-50
12,95,37,67,82,82,0
12,95,37,81,96,126,-30
12,95,37,89,0,67,-67
12,95,37,97,0,52,-52
12,95,37,119,397,608,-211
12,95,37,129,70,0,70
12,95,37,133,153,108,45
12,95,37,183,339,425,-86
12,95,39,17,74,0,74
12,95,39,35,233,220,13
12,95,39,41,0,57,-57
12,95,39,49,325,236,89
12,95,39,61,111,86,25
12,95,39,93,0,74,-74
12,95,39,99,69,0,69
12,95,39,113,82,86,-4
12,95,39,151,69,0,69
12,95,39,153,0,51,-51
12,95,40,109,84,115,-31
12,95,40,143,104,0,104
12,95,41,5,0,61,-61
12,95,41,51,75,111,-36
12,95,41,67,0,59,-59
12,95,42,3,287,194,93
12,95,42,11,94,100,-6
12,95,42,17,137,77,60
12,95,42,29,98,60,38
12,95,42,43,59,69,-10
12,95,42,45,93,0,93
12,95,42,49,67,0,67
12,95,42,71,101,97,4
12,95,42,77,214,89,125
12,95,42,79,78,84,-6
12,95,42,89,58,0,58
12,95,42,91,170,113,57
12,95,42,95,101,62,39
12,95,42,101,432,322,110
12,95,42,133,94,94,0
12,95,44,7,216,196,20
12,95,45,13,112,91,21
12,95,45,15,71,62,9
12,95,45,19,149,123,26
12,95,45,45,138,216,-78
12,95,45,51,101,67,34
12,95,45,63,0,83,-83
12,95,45,79,158,103,55
12,95,45,91,69,82,-13
12,95,47,9,0,48,-48
12,95,47,37,222,342,-120
12,95,47,65,75,123,-48
12,95,47,93,79,105,-26
12,95,47,125,94,103,-9
12,95,47,149,0,79,-79
12,95,47,155,0,60,-60
12,95,47,157,262,185,77
12,95,47,165,61,0,61
12,95,47,187,65,100,-35
12,95,47,189,0,54,-54
12,95,48,27,139,194,-55
12,95,48,29,264,340,-76
12,95,48,85,216,315,-99
12,95,48,113,452,438,14
12,95,48,121,159,198,-39
12,95,48,141,140,137,3
12,95,48,157,88,117,-29
12,95,48,201,617,689,-72
12,95,48,339,78,112,-34
12,95,48,439,373,407,-34
12,95,48,453,405,311,94
12,95,48,479,84,0,84
12,95,48,491,88,136,-48
12,95,49,35,160,163,-3
12,95,49,49,112,0,112
12,95,51,13,117,116,1
12,95,51,41,99,61,38
12,95,51,59,440,287,153
12,95,51,87,68,57,11
12,95,51,107,152,120,32
12,95,51,153,176,96,80
12,95,51,510,95,55,40
12,95,51,550,90,0,90
12,95,51,700,91,0,91
12,95,51,710,87,68,19
12,95,51,760,58,0,58
12,95,51,810,184,121,63
12,95,53,11,0,57,-57
12,95,53,33,312,441,-129
12,95,53,35,63,0,63
12,95,53,53,161,112,49
12,95,53,61,91,84,7
12,95,55,25,80,73,7
12,95,55,79,167,121,46
12,97,4,13,103,95,8
12,97,6,37,174,141,33
12,97,6,59,69,69,0
12,97,6,73,88,55,33
12,97,8,5,0,62,-62
12,97,8,41,65,68,-3
12,97,9,1,110,0,110
12,97,9,3,149,111,38
12,97,9,9,150,0,150
12,97,12,1,89,117,-28
12,97,12,5,70,0,70
12,97,12,9,579,952,-373
12,97,12,11,1091,551,540
12,97,12,17,0,171,-171
12,97,12,19,82,99,-17
12,97,12,21,63,0,63
12,97,12,23,0,67,-67
12,97,12,31,305,274,31
12,97,12,33,0,70,-70
12,97,12,35,0,58,-58
12,97,12,53,95,87,8
12,97,12,55,87,74,13
12,97,12,57,687,819,-132
12,97,12,61,70,94,-24
12,97,12,69,1134,1891,-757
12,97,12,71,208,165,43
12,97,12,73,84,94,-10
12,97,12,81,117,107,10
12,97,12,83,169,328,-159
12,97,12,86,1555,578,977
12,97,12,95,17747,13812,3935
12,97,12,99,500,301,199
12,97,12,101,189,191,-2
12,97,12,103,199,340,-141
12,97,12,105,4735,8137,-3402
12,97,12,109,0,62,-62
12,97,12,111,159,164,-5
12,97,12,115,87,95,-8
12,97,12,117,1183,1244,-61
12,97,12,119,0,80,-80
12,97,12,127,332,497,-165
12,97,13,67,0,75,-75
12,97,13,89,72,54,18
12,97,13,121,67,98,-31
12,97,13,135,94,86,8
12,97,15,3,83,51,32
12,97,17,31,274,181,93
12,97,17,43,67,0,67
12,97,18,97,72,0,72
12,97,24,5,75,0,75
12,97,24,31,0,52,-52
12,97,24,33,67,0,67
12,97,25,9,115,67,48
12,97,25,13,153,131,22
12,97,25,17,106,58,48
12,97,25,21,63,0,63
12,97,25,25,76,0,76
12,97,25,27,122,0,122
12,97,26,163,72,0,72
12,97,32,3,102,110,-8
12,97,33,11,65,0,65
12,97,34,3,148,0,148
12,97,34,7,83,0,83
12,97,34,13,146,60,86
12,97,34,17,234,65,169
12,97,34,23,192,104,88
12,97,34,29,62,0,62
12,97,34,31,201,72,129
12,97,34,39,119,0,119
12,97,36,5,687,192,495
12,97,36,29,100,0,100
12,97,36,47,555,164,391
12,97,36,55,78,0,78
12,97,36,59,178,73,105
12,97,36,61,229,96,133
12,97,36,71,82,0,82
12,97,36,81,639,296,343
12,97,36,85,77,0,77
12,97,36,103,292,115,177
12,97,36,119,117,0,117
12,97,37,51,0,79,-79
12,97,37,119,78,79,-1
12,97,37,183,86,81,5
12,97,39,35,64,84,-20
12,97,42,3,54,0,54
12,97,42,11,72,0,72
12,97,42,77,118,0,118
12,97,42,95,69,0,69
12,97,42,101,142,114,28
12,97,44,7,96,82,14
12,97,47,37,0,63,-63
12,97,48,29,72,73,-1
12,97,48,113,66,87,-21
12,97,48,201,179,134,45
12,97,48,439,100,75,25
12,97,48,453,92,65,27
12,97,51,59,78,66,12
12,97,51,153,72,0,72
12,97,53,33,0,47,-47
12,97,55,79,82,82,0
12,99,1,73,78,123,-45
12,99,1,89,69,70,-1
12,99,4,13,359,503,-144
12,99,4,19,70,130,-60
12,99,6,1,116,127,-11
12,99,6,13,90,85,5
12,99,6,37,760,659,101
12,99,6,41,77,0,77
12,99,6,59,257,272,-15
12,99,6,65,126,97,29
12,99,6,67,85,0,85
12,99,6,71,70,53,17
12,99,6,73,475,355,120
12,99,6,75,110,134,-24
12,99,6,81,80,55,25
12,99,6,85,169,183,-14
12,99,6,111,75,68,7
12,99,8,1,0,55,-55
12,99,8,5,121,178,-57
12,99,8,13,0,133,-133
12,99,8,31,156,263,-107
12,99,8,35,83,95,-12
12,99,8,41,161,191,-30
12,99,8,59,87,169,-82
12,99,8,69,0,91,-91
12,99,9,1,1070,424,646
12,99,9,3,614,291,323
12,99,9,5,85,0,85
12,99,9,7,102,60,42
12,99,9,9,454,234,220
12,99,9,11,64,94,-30
12,99,9,13,60,0,60
12,99,10,1,0,62,-62
12,99,10,3,153,146,7
12,99,10,5,80,82,-2
12,99,11,1,213,168,45
12,99,12,1,426,469,-43
12,99,12,5,91,97,-6
12,99,12,9,737,1010,-273
12,99,12,11,21869,14915,6954
12,99,12,15,116,287,-171
12,99,12,17,102,191,-89
12,99,12,19,127,254,-127
12,99,12,21,500,594,-94
12,99,12,23,0,128,-128
12,99,12,31,669,870,-201
12,99,12,33,92,130,-38
12,99,12,35,108,200,-92
12,99,12,43,70,0,70
12,99,12,51,308,312,-4
12,99,12,53,94,142,-48
12,99,12,55,149,261,-112
12,99,12,57,1025,1505,-480
12,99,12,61,370,707,-337
12,99,12,69,263,511,-248
12,99,12,71,830,1046,-216
12,99,12,73,356,433,-77
12,99,12,75,0,63,-63
12,99,12,81,239,443,-204
12,99,12,83,279,658,-379
12,99,12,85,2141,3795,-1654
12,99,12,86,6732,3754,2978
12,99,12,87,358,250,108
12,99,12,89,0,77,-77
12,99,12,91,71,130,-59
12,99,12,93,193,442,-249
12,99,12,95,1753,2433,-680
12,99,12,97,301,500,-199
12,99,12,101,284,458,-174
12,99,12,103,606,664,-58
12,99,12,105,382,691,-309
12,99,12,109,214,387,-173
12,99,12,111,2569,6027,-3458
12,99,12,113,62,0,62
12,99,12,115,279,375,-96
12,99,12,117,513,656,-143
12,99,12,119,83,188,-105
12,99,12,121,0,71,-71
12,99,12,127,410,620,-210
12,99,13,51,120,112,8
12,99,13,57,73,134,-61
12,99,13,63,69,126,-57
12,99,13,67,265,376,-111
12,99,13,89,194,314,-120
12,99,13,97,0,70,-70
12,99,13,117,77,93,-16
12,99,13,121,430,619,-189
12,99,13,135,264,438,-174
12,99,13,139,0,76,-76
12,99,13,151,0,69,-69
12,99,13,185,0,68,-68
12,99,15,3,120,120,0
12,99,17,31,1044,691,353
12,99,17,43,209,138,71
12,99,17,89,90,0,90
12,99,17,97,272,132,140
12,99,17,197,109,0,109
12,99,18,3,63,0,63
12,99,18,57,69,85,-16
12,99,18,97,94,140,-46
12,99,20,91,98,92,6
12,99,21,67,68,0,68
12,99,21,111,150,187,-37
12,99,22,51,58,0,58
12,99,22,71,57,62,-5
12,99,23,5,67,93,-26
12,99,23,31,0,49,-49
12,99,24,3,193,99,94
12,99,24,5,288,160,128
12,99,24,21,70,0,70
12,99,24,25,0,51,-51
12,99,24,27,81,70,11
12,99,24,31,548,335,213
12,99,24,33,157,97,60
12,99,24,37,0,82,-82
12,99,24,45,0,88,-88
12,99,24,510,120,93,27
12,99,25,1,182,140,42
12,99,25,3,63,47,16
12,99,25,5,186,97,89
12,99,25,9,352,216,136
12,99,25,13,129,101,28
12,99,25,17,671,463,208
12,99,25,21,335,215,120
12,99,25,23,166,122,44
12,99,25,25,330,237,93
12,99,25,27,228,153,75
12,99,26,81,82,94,-12
12,99,26,99,99,56,43
12,99,26,125,301,227,74
12,99,26,161,0,69,-69
12,99,26,163,214,117,97
12,99,27,53,147,95,52
12,99,27,123,0,47,-47
12,99,29,95,58,0,58
12,99,29,189,140,153,-13
12,99,31,55,58,0,58
12,99,32,3,410,393,17
12,99,32,31,53,60,-7
12,99,33,11,135,120,15
12,99,33,15,82,57,25
12,99,34,1,204,110,94
12,99,34,3,894,378,516
12,99,34,5,212,139,73
12,99,34,7,196,97,99
12,99,34,9,72,0,72
12,99,34,13,472,284,188
12,99,34,15,78,0,78
12,99,34,17,345,171,174
12,99,34,19,65,0,65
12,99,34,21,126,107,19
12,99,34,23,575,284,291
12,99,34,25,781,261,520
12,99,34,27,531,208,323
12,99,34,29,427,243,184
12,99,34,31,345,118,227
12,99,34,35,270,86,184
12,99,34,37,86,50,36
12,99,34,39,324,150,174
12,99,35,1,54,50,4
12,99,36,1,85,74,11
12,99,36,5,381,243,138
12,99,36,27,158,95,63
12,99,36,29,231,176,55
12,99,36,47,1003,554,449
12,99,36,55,203,127,76
12,99,36,59,1981,747,1234
12,99,36,61,1327,966,361
12,99,36,67,97,87,10
12,99,36,71,179,85,94
12,99,36,79,109,0,109
12,99,36,81,1322,505,817
12,99,36,85,338,74,264
12,99,36,87,382,120,262
12,99,36,91,87,78,9
12,99,36,93,57,0,57
12,99,36,103,1754,784,970
12,99,36,105,59,51,8
12,99,36,111,96,55,41
12,99,36,119,990,411,579
12,99,37,19,0,60,-60
12,99,37,21,115,215,-100
12,99,37,51,97,170,-73
12,99,37,63,95,92,3
12,99,37,67,47,82,-35
12,99,37,81,64,113,-49
12,99,37,87,0,60,-60
12,99,37,89,0,117,-117
12,99,37,97,0,102,-102
12,99,37,119,395,506,-111
12,99,37,129,0,67,-67
12,99,37,133,85,96,-11
12,99,37,135,0,59,-59
12,99,37,179,0,91,-91
12,99,37,183,299,505,-206
12,99,39,35,250,203,47
12,99,39,41,69,0,69
12,99,39,49,213,203,10
12,99,39,61,138,93,45
12,99,39,95,78,0,78
12,99,39,153,93,65,28
12,99,40,109,44,65,-21
12,99,40,143,0,54,-54
12,99,41,51,63,85,-22
12,99,41,67,56,57,-1
12,99,42,3,270,234,36
12,99,42,11,90,65,25
12,99,42,17,321,153,168
12,99,42,29,204,132,72
12,99,42,43,68,61,7
12,99,42,45,169,105,64
12,99,42,71,89,70,19
12,99,42,77,105,77,28
12,99,42,79,106,59,47
12,99,42,89,77,0,77
12,99,42,91,389,226,163
12,99,42,95,60,89,-29
12,99,42,101,318,263,55
12,99,44,3,83,60,23
12,99,44,5,66,46,20
12,99,44,7,273,164,109
12,99,44,9,102,63,39
12,99,45,3,0,56,-56
12,99,45,13,82,92,-10
12,99,45,15,0,66,-66
12,99,45,19,98,141,-43
12,99,45,45,119,229,-110
12,99,45,51,127,116,11
12,99,45,63,0,57,-57
12,99,45,79,62,145,-83
12,99,45,83,0,69,-69
12,99,45,91,0,89,-89
12,99,47,9,0,71,-71
12,99,47,37,109,236,-127
12,99,47,65,0,94,-94
12,99,47,93,64,166,-102
12,99,47,125,47,90,-43
12,99,47,149,57,94,-37
12,99,47,157,89,145,-56
12,99,47,187,98,151,-53
12,99,48,27,0,88,-88
12,99,48,29,154,188,-34
12,99,48,39,0,70,-70
12,99,48,85,199,198,1
12,99,48,113,378,348,30
12,99,48,121,139,176,-37
12,99,48,141,62,0,62
12,99,48,157,90,131,-41
12,99,48,201,457,550,-93
12,99,48,215,0,64,-64
12,99,48,339,0,115,-115
12,99,48,439,218,234,-16
12,99,48,453,422,416,6
12,99,48,491,74,143,-69
12,99,49,35,77,86,-9
12,99,50,7,59,0,59
12,99,51,13,128,66,62
12,99,51,41,65,67,-2
12,99,51,59,333,302,31
12,99,51,87,64,81,-17
12,99,51,107,121,108,13
12,99,51,153,159,88,71
12,99,51,510,96,63,33
12,99,51,810,158,82,76
12,99,53,33,194,347,-153
12,99,53,53,70,51,19
12,99,53,61,64,95,-31
12,99,55,25,52,76,-24
12,99,55,79,103,73,30
12,101,4,13,191,152,39
12,101,4,19,0,50,-50
12,101,6,37,167,99,68
12,101,6,59,70,0,70
12,101,6,73,148,136,12
12,101,8,5,97,0,97
12,101,8,41,119,127,-8
12,101,9,1,105,0,105
12,101,9,3,209,77,132
12,101,9,9,127,56,71
12,101,12,1,208,156,52
12,101,12,5,105,96,9
12,101,12,9,262,236,26
12,101,12,11,822,310,512
12,101,12,15,90,109,-19
12,101,12,17,378,602,-224
12,101,12,19,82,91,-9
12,101,12,21,95,67,28
12,101,12,31,333,240,93
12,101,12,33,89,54,35
12,101,12,35,0,61,-61
12,101,12,53,3212,4963,-1751
12,101,12,57,18242,10760,7482
12,101,12,61,57,0,57
12,101,12,69,227,308,-81
12,101,12,71,327,251,76
12,101,12,73,174,146,28
12,101,12,75,0,72,-72
12,101,12,81,287,356,-69
12,101,12,83,331,423,-92
12,101,12,85,57,0,57
12,101,12,86,649,262,387
12,101,12,91,68,108,-40
12,101,12,95,804,576,228
12,101,12,97,191,189,2
12,101,12,99,458,284,174
12,101,12,103,9972,6264,3708
12,101,12,105,885,1053,-168
12,101,12,109,73,105,-32
12,101,12,111,124,76,48
12,101,12,115,232,235,-3
12,101,12,117,268,250,18
12,101,12,119,188,235,-47
12,101,12,127,210,200,10
12,101,13,57,70,0,70
12,101,13,67,121,78,43
12,101,13,121,73,77,-4
12,101,13,135,132,84,48
12,101,15,3,0,66,-66
12,101,17,31,312,163,149
12,101,17,43,111,0,111
12,101,17,97,96,0,96
12,101,17,197,102,0,102
12,101,18,97,141,67,74
12,101,21,111,107,0,107
12,101,23,5,85,0,85
12,101,23,19,52,0,52
12,101,23,31,71,0,71
12,101,24,3,94,0,94
12,101,24,5,71,0,71
12,101,24,31,69,0,69
12,101,25,5,72,0,72
12,101,25,9,85,50,35
12,101,25,17,109,80,29
12,101,25,21,65,0,65
12,101,25,27,109,61,48
12,101,26,49,89,0,89
12,101,26,81,74,0,74
12,101,26,99,140,49,91
12,101,26,125,130,101,29
12,101,26,163,169,68,101
12,101,29,189,78,0,78
12,101,32,3,165,147,18
12,101,33,11,117,0,117
12,101,33,15,80,0,80
12,101,34,3,107,0,107
12,101,34,5,70,0,70
12,101,34,13,73,0,73
12,101,34,17,94,0,94
12,101,34,23,104,0,104
12,101,34,25,105,0,105
12,101,34,27,91,0,91
12,101,34,29,116,0,116
12,101,34,31,87,0,87
12,101,34,39,73,0,73
12,101,36,5,176,0,176
12,101,36,27,67,0,67
12,101,36,29,108,68,40
12,101,36,47,150,83,67
12,101,36,55,108,64,44
12,101,36,59,225,0,225
12,101,36,61,98,0,98
12,101,36,65,57,0,57
12,101,36,67,94,0,94
12,101,36,71,98,0,98
12,101,36,81,311,95,216
12,101,36,85,96,0,96
12,101,36,103,415,128,287
12,101,36,119,77,0,77
12,101,37,51,75,96,-21
12,101,37,119,106,112,-6
12,101,37,133,57,0,57
12,101,37,183,122,96,26
12,101,39,17,66,0,66
12,101,39,35,108,62,46
12,101,39,49,184,117,67
12,101,39,61,79,58,21
12,101,39,113,75,0,75
12,101,42,3,131,69,62
12,101,42,77,72,0,72
12,101,42,91,57,0,57
12,101,42,101,76,0,76
12,101,44,7,95,0,95
12,101,45,45,0,85,-85
12,101,47,37,75,71,4
12,101,47,93,0,93,-93
12,101,47,125,0,68,-68
12,101,47,155,0,71,-71
12,101,47,157,78,0,78
12,101,48,29,101,93,8
12,101,48,85,0,60,-60
12,101,48,113,77,57,20
12,101,48,201,150,144,6
12,101,48,439,105,101,4
12,101,48,453,106,70,36
12,101,51,59,122,66,56
12,101,51,153,101,0,101
12,101,51,810,66,0,66
12,101,53,33,66,69,-3
12,101,53,53,79,61,18
12,101,55,79,0,60,-60
12,103,1,3,0,52,-52
12,103,1,73,82,79,3
12,103,1,89,80,74,6
12,103,1,97,52,0,52
12,103,2,20,69,0,69
12,103,4,13,368,359,9
12,103,4,19,88,93,-5
12,103,6,1,94,81,13
12,103,6,13,72,0,72
12,103,6,37,547,460,87
12,103,6,59,152,146,6
12,103,6,65,74,85,-11
12,103,6,67,74,84,-10
12,103,6,71,70,88,-18
12,103,6,73,375,271,104
12,103,6,75,100,74,26
12,103,6,85,141,82,59
12,103,6,111,65,0,65
12,103,8,1,57,70,-13
12,103,8,5,147,118,29
12,103,8,13,0,70,-70
12,103,8,31,162,194,-32
12,103,8,35,91,92,-1
12,103,8,41,266,202,64
12,103,8,59,105,131,-26
12,103,8,69,75,78,-3
12,103,9,1,333,120,213
12,103,9,3,302,157,145
12,103,9,5,55,0,55
12,103,9,7,52,0,52
12,103,9,9,203,91,112
12,103,9,11,135,68,67
12,103,9,13,55,0,55
12,103,10,3,100,0,100
12,103,10,5,47,0,47
12,103,11,1,121,101,20
12,103,12,1,513,317,196
12,103,12,5,137,100,37
12,103,12,9,448,375,73
12,103,12,11,1011,619,392
12,103,12,15,214,214,0
12,103,12,17,354,729,-375
12,103,12,19,117,176,-59
12,103,12,21,278,242,36
12,103,12,31,615,600,15
12,103,12,33,147,170,-23
12,103,12,35,65,66,-1
12,103,12,53,635,1334,-699
12,103,12,55,112,89,23
12,103,12,57,12602,12012,590
12,103,12,61,61,94,-33
12,103,12,69,324,334,-10
12,103,12,71,706,623,83
12,103,12,73,391,346,45
12,103,12,75,0,70,-70
12,103,12,81,1540,2165,-625
12,103,12,83,393,500,-107
12,103,12,85,65,98,-33
12,103,12,86,1041,580,461
12,103,12,87,232,119,113
12,103,12,89,0,53,-53
12,103,12,91,124,193,-69
12,103,12,95,1597,1149,448
12,103,12,97,340,199,141
12,103,12,99,664,606,58
12,103,12,101,6264,9972,-3708
12,103,12,105,938,844,94
12,103,12,109,134,145,-11
12,103,12,111,210,98,112
12,103,12,113,100,65,35
12,103,12,115,796,808,-12
12,103,12,117,530,377,153
12,103,12,119,125,230,-105
12,103,12,127,360,384,-24
12,103,12,131,0,63,-63
12,103,13,51,122,64,58
12,103,13,57,72,71,1
12,103,13,67,269,200,69
12,103,13,77,60,0,60
12,103,13,89,268,183,85
12,103,13,117,67,0,67
12,103,13,121,342,296,46
12,103,13,135,238,213,25
12,103,13,185,69,61,8
12,103,15,3,163,116,47
12,103,17,19,75,0,75
12,103,17,31,879,443,436
12,103,17,43,270,105,165
12,103,17,89,121,60,61
12,103,17,97,176,72,104
12,103,17,111,96,0,96
12,103,17,143,66,0,66
12,103,17,167,55,0,55
12,103,17,197,123,0,123
12,103,17,201,84,0,84
12,103,18,3,83,60,23
12,103,18,57,107,79,28
12,103,18,63,97,0,97
12,103,18,89,50,0,50
12,103,18,97,304,156,148
12,103,18,127,69,0,69
12,103,18,141,68,0,68
12,103,19,153,51,0,51
12,103,20,91,129,70,59
12,103,21,67,102,56,46
12,103,21,111,291,151,140
12,103,22,33,63,0,63
12,103,22,51,58,0,58
12,103,22,71,50,0,50
12,103,23,5,80,79,1
12,103,23,19,53,0,53
12,103,23,31,76,50,26
12,103,24,3,200,69,131
12,103,24,5,180,0,180
12,103,24,21,71,0,71
12,103,24,25,61,0,61
12,103,24,27,69,0,69
12,103,24,31,193,99,94
12,103,24,33,102,52,50
12,103,24,510,69,53,16
12,103,25,1,91,68,23
12,103,25,5,102,64,38
12,103,25,9,167,85,82
12,103,25,13,112,60,52
12,103,25,17,280,168,112
12,103,25,21,130,90,40
12,103,25,23,133,78,55
12,103,25,25,107,79,28
12,103,25,27,170,110,60
12,103,26,49,88,76,12
12,103,26,65,61,0,61
12,103,26,77,50,0,50
12,103,26,81,156,76,80
12,103,26,99,172,81,91
12,103,26,125,232,150,82
12,103,26,161,66,0,66
12,103,26,163,250,190,60
12,103,27,37,62,0,62
12,103,27,53,179,139,40
12,103,27,123,65,0,65
12,103,29,47,56,0,56
12,103,29,77,72,0,72
12,103,29,95,133,65,68
12,103,29,183,122,56,66
12,103,29,189,232,143,89
12,103,29,510,46,0,46
12,103,31,55,83,45,38
12,103,32,3,271,275,-4
12,103,33,11,158,122,36
12,103,33,13,49,0,49
12,103,33,15,131,60,71
12,103,34,1,74,55,19
12,103,34,3,193,88,105
12,103,34,5,88,70,18
12,103,34,7,124,59,65
12,103,34,9,71,0,71
12,103,34,13,104,0,104
12,103,34,15,78,0,78
12,103,34,17,201,58,143
12,103,34,21,52,0,52
12,103,34,23,192,63,129
12,103,34,25,191,63,128
12,103,34,27,96,70,26
12,103,34,29,159,83,76
12,103,34,31,91,0,91
12,103,34,35,111,0,111
12,103,34,37,59,0,59
12,103,34,39,83,0,83
12,103,35,1,95,88,7
12,103,36,1,79,54,25
12,103,36,5,137,88,49
12,103,36,27,70,53,17
12,103,36,29,297,137,160
12,103,36,47,312,170,142
12,103,36,55,270,112,158
12,103,36,59,276,102,174
12,103,36,61,331,186,145
12,103,36,63,81,0,81
12,103,36,65,67,0,67
12,103,36,67,121,86,35
12,103,36,71,106,58,48
12,103,36,81,356,159,197
12,103,36,85,61,0,61
12,103,36,87,93,0,93
12,103,36,91,77,50,27
12,103,36,103,418,155,263
12,103,36,119,152,70,82
12,103,37,21,122,219,-97
12,103,37,51,118,72,46
12,103,37,63,0,56,-56
12,103,37,67,59,82,-23
12,103,37,81,53,104,-51
12,103,37,87,0,56,-56
12,103,37,89,0,87,-87
12,103,37,113,0,59,-59
12,103,37,119,243,294,-51
12,103,37,129,88,0,88
12,103,37,133,85,83,2
12,103,37,183,202,212,-10
12,103,39,17,87,66,21
12,103,39,25,63,0,63
12,103,39,35,227,162,65
12,103,39,41,58,0,58
12,103,39,49,419,160,259
12,103,39,61,227,124,103
12,103,39,85,52,0,52
12,103,39,93,69,0,69
12,103,39,95,75,80,-5
12,103,39,113,124,98,26
12,103,39,151,96,65,31
12,103,39,153,131,86,45
12,103,39,165,100,0,100
12,103,40,109,100,0,100
12,103,40,143,69,0,69
12,103,41,51,128,79,49
12,103,41,67,51,0,51
12,103,42,3,316,187,129
12,103,42,11,101,0,101
12,103,42,17,153,91,62
12,103,42,29,145,80,65
12,103,42,41,0,51,-51
12,103,42,45,96,55,41
12,103,42,49,90,0,90
12,103,42,69,54,0,54
12,103,42,71,107,0,107
12,103,42,77,105,72,33
12,103,42,79,93,0,93
12,103,42,89,77,0,77
12,103,42,91,199,87,112
12,103,42,95,53,0,53
12,103,42,101,190,118,72
12,103,42,125,65,0,65
12,103,42,129,63,56,7
12,103,42,133,126,81,45
12,103,44,3,55,0,55
12,103,44,7,114,116,-2
12,103,45,13,68,0,68
12,103,45,19,116,71,45
12,103,45,45,81,129,-48
12,103,45,51,85,75,10
12,103,45,63,80,61,19
12,103,45,79,93,0,93
12,103,45,91,0,62,-62
12,103,47,9,0,58,-58
12,103,47,37,232,199,33
12,103,47,65,53,104,-51
12,103,47,93,143,225,-82
12,103,47,125,0,75,-75
12,103,47,149,81,82,-1
12,103,47,155,0,89,-89
12,103,47,157,160,107,53
12,103,47,165,0,64,-64
12,103,48,27,57,76,-19
12,103,48,29,140,170,-30
12,103,48,85,143,118,25
12,103,48,113,252,210,42
12,103,48,121,138,100,38
12,103,48,141,94,0,94
12,103,48,201,340,240,100
12,103,48,339,0,77,-77
12,103,48,439,169,132,37
12,103,48,453,254,179,75
12,103,48,491,71,57,14
12,103,49,35,131,72,59
12,103,50,7,64,0,64
12,103,51,13,91,70,21
12,103,51,41,68,0,68
12,103,51,59,401,203,198
12,103,51,87,58,0,58
12,103,51,107,118,73,45
12,103,51,153,101,0,101
12,103,51,179,63,0,63
12,103,51,510,63,62,1
12,103,51,710,74,0,74
12,103,51,810,125,66,59
12,103,53,11,0,59,-59
12,103,53,33,234,278,-44
12,103,53,53,96,77,19
12,103,53,61,79,58,21
12,103,53,67,0,56,-56
12,103,55,25,97,66,31
12,103,55,79,132,96,36
12,103,55,133,107,0,107
12,105,1,73,67,69,-2
12,105,4,13,157,148,9
12,105,4,19,68,0,68
12,105,6,37,154,98,56
12,105,6,59,65,72,-7
12,105,6,65,61,0,61
12,105,6,71,67,0,67
12,105,6,73,127,111,16
12,105,8,5,68,0,68
12,105,8,41,160,88,72
12,105,9,1,106,54,52
12,105,9,3,244,105,139
12,105,9,9,246,100,146
12,105,9,11,71,0,71
12,105,10,3,99,0,99
12,105,12,1,181,204,-23
12,105,12,5,109,82,27
12,105,12,9,446,550,-104
12,105,12,11,1207,582,625
12,105,12,15,116,176,-60
12,105,12,17,110,202,-92
12,105,12,19,123,107,16
12,105,12,21,162,111,51
12,105,12,23,0,79,-79
12,105,12,27,0,79,-79
12,105,12,31,549,509,40
12,105,12,33,104,78,26
12,105,12,35,67,78,-11
12,105,12,49,433,266,167
12,105,12,53,248,247,1
12,105,12,55,728,652,76
12,105,12,57,6942,5675,1267
12,105,12,61,135,150,-15
12,105,12,69,2335,1680,655
12,105,12,71,509,426,83
12,105,12,73,239,176,63
12,105,12,81,359,423,-64
12,105,12,83,326,449,-123
12,105,12,85,83,0,83
12,105,12,86,1472,543,929
12,105,12,87,139,0,139
12,105,12,91,143,133,10
12,105,12,95,8002,4512,3490
12,105,12,97,8137,4735,3402
12,105,12,99,691,382,309
12,105,12,101,1053,885,168
12,105,12,103,844,938,-94
12,105,12,107,62,0,62
12,105,12,109,73,147,-74
12,105,12,111,211,219,-8
12,105,12,115,251,245,6
12,105,12,117,914,713,201
12,105,12,119,71,195,-124
12,105,12,127,489,510,-21
12,105,13,51,78,0,78
12,105,13,67,91,117,-26
12,105,13,89,107,64,43
12,105,13,121,118,114,4
12,105,13,135,139,136,3
12,105,13,185,0,87,-87
12,105,15,3,0,88,-88
12,105,17,31,341,159,182
12,105,17,43,65,0,65
12,105,17,97,58,0,58
12,105,17,197,132,0,132
12,105,17,201,62,0,62
12,105,18,89,0,64,-64
12,105,18,97,133,56,77
12,105,21,111,77,0,77
12,105,23,5,60,0,60
12,105,23,19,53,0,53
12,105,24,3,109,0,109
12,105,24,5,77,0,77
12,105,24,31,80,55,25
12,105,25,5,110,0,110
12,105,25,9,115,0,115
12,105,25,13,105,90,15
12,105,25,17,107,65,42
12,105,25,23,62,0,62
12,105,25,27,186,77,109
12,105,26,49,66,0,66
12,105,26,81,105,0,105
12,105,26,99,101,0,101
12,105,26,125,136,77,59
12,105,26,163,138,100,38
12,105,27,53,55,0,55
12,105,29,183,57,0,57
12,105,29,189,68,0,68
12,105,32,3,191,154,37
12,105,33,11,75,0,75
12,105,33,15,76,0,76
12,105,34,1,58,0,58
12,105,34,3,90,0,90
12,105,34,7,71,0,71
12,105,34,13,146,0,146
12,105,34,15,65,0,65
12,105,34,17,131,0,131
12,105,34,23,168,56,112
12,105,34,25,77,0,77
12,105,34,29,91,0,91
12,105,34,31,115,0,115
12,105,34,39,91,0,91
12,105,36,5,334,97,237
12,105,36,29,181,72,109
12,105,36,47,354,80,274
12,105,36,55,155,96,59
12,105,36,59,134,0,134
12,105,36,61,109,42,67
12,105,36,67,91,0,91
12,105,36,71,70,0,70
12,105,36,81,381,111,270
12,105,36,85,63,0,63
12,105,36,103,280,56,224
12,105,36,119,129,0,129
12,105,37,21,0,57,-57
12,105,37,51,95,62,33
12,105,37,67,0,57,-57
12,105,37,81,0,66,-66
12,105,37,89,0,64,-64
12,105,37,119,114,145,-31
12,105,37,133,90,0,90
12,105,37,183,122,99,23
12,105,39,35,137,68,69
12,105,39,49,138,79,59
12,105,39,113,61,0,61
12,105,39,153,53,0,53
12,105,42,3,71,62,9
12,105,42,11,128,0,128
12,105,42,17,79,0,79
12,105,42,43,71,0,71
12,105,42,49,60,0,60
12,105,42,71,95,0,95
12,105,42,77,161,72,89
12,105,42,79,60,0,60
12,105,42,91,99,71,28
12,105,42,95,118,0,118
12,105,42,101,169,68,101
12,105,42,133,88,0,88
12,105,44,7,124,79,45
12,105,45,45,73,64,9
12,105,45,51,71,66,5
12,105,45,63,0,61,-61
12,105,47,37,91,109,-18
12,105,47,65,0,53,-53
12,105,47,93,74,105,-31
12,105,47,157,93,0,93
12,105,48,27,59,90,-31
12,105,48,29,105,100,5
12,105,48,85,59,0,59
12,105,48,113,81,100,-19
12,105,48,183,0,147,-147
12,105,48,201,230,155,75
12,105,48,439,115,170,-55
12,105,48,453,114,112,2
12,105,51,41,66,0,66
12,105,51,59,99,79,20
12,105,51,153,110,0,110
12,105,51,810,69,0,69
12,105,53,33,61,59,2
12,105,53,53,0,83,-83
12,105,55,79,105,69,36
12,107,12,1,503,527,-24
12,107,12,7,79,122,-43
12,107,12,9,56,0,56
12,107,12,11,54,0,54
12,107,12,19,481,549,-68
12,107,12,31,402,316,86
12,107,12,35,206,174,32
12,107,12,69,64,58,6
12,107,12,83,198,170,28
12,107,12,86,58,0,58
12,107,12,95,97,100,-3
12,107,12,105,0,62,-62
12,107,12,109,656,542,114
12,107,12,127,374,319,55
12,109,4,13,120,86,34
12,109,6,37,145,99,46
12,109,6,59,121,84,37
12,109,6,73,327,85,242
12,109,8,41,0,73,-73
12,109,8,59,61,0,61
12,109,9,1,123,0,123
12,109,9,3,86,0,86
12,109,9,9,80,0,80
12,109,12,1,342,200,142
12,109,12,9,264,201,63
12,109,12,11,666,145,521
12,109,12,17,59,0,59
12,109,12,19,1172,840,332
12,109,12,21,121,0,121
12,109,12,31,9180,6312,2868
12,109,12,33,107,82,25
12,109,12,35,714,678,36
12,109,12,57,350,209,141
12,109,12,61,51,0,51
12,109,12,69,115,97,18
12,109,12,71,163,112,51
12,109,12,73,273,88,185
12,109,12,81,0,82,-82
12,109,12,83,180,169,11
12,109,12,85,58,0,58
12,109,12,86,339,140,199
12,109,12,87,121,0,121
12,109,12,89,159,168,-9
12,109,12,95,365,325,40
12,109,12,97,62,0,62
12,109,12,99,387,214,173
12,109,12,101,105,73,32
12,109,12,103,145,134,11
12,109,12,105,147,73,74
12,109,12,107,542,656,-114
12,109,12,115,56,86,-30
12,109,12,117,272,92,180
12,109,12,127,429,319,110
12,109,13,51,90,87,3
12,109,13,57,98,0,98
12,109,13,67,155,74,81
12,109,13,89,75,0,75
12,109,13,117,0,80,-80
12,109,13,121,192,129,63
12,109,13,127,59,0,59
12,109,13,135,215,58,157
12,109,15,3,90,0,90
12,109,17,31,173,82,91
12,109,17,97,104,0,104
12,109,24,3,117,0,117
12,109,24,31,87,0,87
12,109,24,33,63,0,63
12,109,25,17,81,0,81
12,109,32,3,85,81,4
12,109,34,13,82,0,82
12,109,34,25,135,0,135
12,109,34,27,86,0,86
12,109,34,29,77,0,77
12,109,36,47,87,0,87
12,109,36,59,141,0,141
12,109,36,61,79,67,12
12,109,36,71,68,0,68
12,109,36,81,84,0,84
12,109,36,103,224,0,224
12,109,37,119,130,79,51
12,109,37,183,141,85,56
12,109,39,49,58,0,58
12,109,42,3,91,0,91
12,109,42,29,71,0,71
12,109,45,13,91,0,91
12,109,45,19,71,0,71
12,109,47,37,82,0,82
12,109,47,157,79,0,79
12,109,48,85,96,0,96
12,109,48,201,90,0,90
12,109,48,439,90,0,90
12,109,48,453,67,53,14
12,109,51,59,216,75,141
12,109,51,107,76,0,76
12,109,51,550,93,0,93
12,109,51,810,170,0,170
12,109,53,33,89,0,89
12,111,4,13,92,92,0
12,111,6,37,104,64,40
12,111,6,73,83,77,6
12,111,8,41,0,74,-74
12,111,9,1,178,94,84
12,111,9,3,178,92,86
12,111,9,9,142,0,142
12,111,12,1,127,120,7
12,111,12,9,444,544,-100
12,111,12,11,3230,1268,1962
12,111,12,17,0,90,-90
12,111,12,19,0,81,-81
12,111,12,21,77,64,13
12,111,12,31,210,207,3
12,111,12,55,61,92,-31
12,111,12,57,232,390,-158
12,111,12,61,1622,2012,-390
12,111,12,69,98,152,-54
12,111,12,71,192,196,-4
12,111,12,73,113,137,-24
12,111,12,81,78,66,12
12,111,12,83,175,171,4
12,111,12,85,3741,2892,849
12,111,12,86,1449,568,881
12,111,12,87,57,0,57
12,111,12,93,252,334,-82
12,111,12,95,572,802,-230
12,111,12,97,164,159,5
12,111,12,99,6027,2569,3458
12,111,12,101,76,124,-48
12,111,12,103,98,210,-112
12,111,12,105,219,211,8
12,111,12,115,0,80,-80
12,111,12,117,173,195,-22
12,111,12,119,0,56,-56
12,111,12,127,177,225,-48
12,111,13,67,69,68,1
12,111,13,121,90,101,-11
12,111,13,135,66,71,-5
12,111,17,31,120,70,50
12,111,24,31,76,0,76
12,111,25,5,66,0,66
12,111,25,9,81,0,81
12,111,25,17,76,0,76
12,111,25,27,79,0,79
12,111,26,163,56,0,56
12,111,32,3,60,103,-43
12,111,33,11,72,0,72
12,111,34,3,108,0,108
12,111,34,5,61,0,61
12,111,34,13,65,0,65
12,111,34,23,86,0,86
12,111,34,25,105,0,105
12,111,34,29,131,61,70
12,111,36,5,132,0,132
12,111,36,29,55,0,55
12,111,36,47,189,83,106
12,111,36,55,67,0,67
12,111,36,59,202,52,150
12,111,36,61,64,0,64
12,111,36,71,62,0,62
12,111,36,81,278,97,181
12,111,36,85,66,0,66
12,111,36,103,458,107,351
12,111,36,119,137,0,137
12,111,37,119,0,55,-55
12,111,37,183,70,63,7
12,111,39,35,68,0,68
12,111,42,3,65,0,65
12,111,42,101,72,0,72
12,111,44,7,85,0,85
12,111,45,45,0,63,-63
12,111,48,29,0,60,-60
12,111,48,113,0,68,-68
12,111,48,201,98,130,-32
12,111,48,439,0,78,-78
12,111,48,453,79,0,79
12,111,51,59,59,0,59
12,111,53,33,0,44,-44
12,113,1,3,231,230,1
12,113,1,53,166,126,40
12,113,1,73,83,0,83
12,113,1,81,64,0,64
12,113,1,89,75,0,75
12,113,1,97,138,123,15
12,113,1,101,86,87,-1
12,113,4,13,90,80,10
12,113,5,119,71,0,71
12,113,6,37,77,0,77
12,113,6,73,252,386,-134
12,113,8,41,113,110,3
12,113,12,5,330,125,205
12,113,12,9,66,0,66
12,113,12,11,94,0,94
12,113,12,19,63,0,63
12,113,12,31,166,238,-72
12,113,12,33,5172,4230,942
12,113,12,57,151,185,-34
12,113,12,71,74,0,74
12,113,12,73,118,118,0
12,113,12,86,59,0,59
12,113,12,91,2389,1701,688
12,113,12,95,167,116,51
12,113,12,99,0,62,-62
12,113,12,103,65,100,-35
12,113,12,117,61,0,61
12,113,12,131,115,143,-28
12,113,13,67,57,0,57
12,113,13,135,67,0,67
12,113,15,3,117,89,28
12,113,17,31,83,0,83
12,113,24,3,95,0,95
12,113,28,47,98,72,26
12,113,28,59,67,0,67
12,113,32,3,85,107,-22
12,113,35,1,65,0,65
12,113,35,9,151,0,151
12,113,37,133,94,121,-27
12,113,47,157,0,67,-67
12,113,48,29,133,123,10
12,113,48,201,82,0,82
12,113,48,355,100,120,-20
12,113,48,439,75,0,75
12,113,51,59,75,99,-24
12,113,51,153,68,0,68
12,113,51,710,0,85,-85
12,113,51,810,101,93,8
12,113,53,53,74,0,74
12,115,1,73,60,0,60
12,115,4,13,154,151,3
12,115,4,19,0,56,-56
12,115,6,37,197,146,51
12,115,6,59,103,63,40
12,115,6,65,69,0,69
12,115,6,67,78,0,78
12,115,6,73,142,113,29
12,115,6,85,72,0,72
12,115,8,5,81,73,8
12,115,8,13,63,0,63
12,115,8,31,82,73,9
12,115,8,41,81,69,12
12,115,8,59,67,61,6
12,115,9,1,347,93,254
12,115,9,3,254,87,167
12,115,9,9,206,51,155
12,115,9,11,102,0,102
12,115,10,5,57,0,57
12,115,11,1,68,50,18
12,115,12,1,111,163,-52
12,115,12,5,66,0,66
12,115,12,9,129,138,-9
12,115,12,11,535,233,302
12,115,12,15,3677,3569,108
12,115,12,17,58,83,-25
12,115,12,21,315,164,151
12,115,12,27,204,231,-27
12,115,12,31,151,198,-47
12,115,12,33,0,54,-54
12,115,12,53,74,66,8
12,115,12,55,95,69,26
12,115,12,57,1263,1229,34
12,115,12,61,81,0,81
12,115,12,69,168,165,3
12,115,12,71,862,641,221
12,115,12,73,126,74,52
12,115,12,81,6795,7786,-991
12,115,12,83,159,157,2
12,115,12,85,0,52,-52
12,115,12,86,603,271,332
12,115,12,87,153,0,153
12,115,12,91,0,68,-68
12,115,12,95,502,375,127
12,115,12,97,95,87,8
12,115,12,99,375,279,96
12,115,12,101,235,232,3
12,115,12,103,808,796,12
12,115,12,105,245,251,-6
12,115,12,109,86,56,30
12,115,12,111,80,0,80
12,115,12,117,159,100,59
12,115,12,119,92,63,29
12,115,12,127,123,105,18
12,115,13,51,56,0,56
12,115,13,67,115,92,23
12,115,13,89,79,45,34
12,115,13,121,153,138,15
12,115,13,135,81,0,81
12,115,17,31,580,225,355
12,115,17,43,202,49,153
12,115,17,89,95,0,95
12,115,17,97,192,0,192
12,115,17,111,73,0,73
12,115,17,197,120,0,120
12,115,18,57,102,0,102
12,115,18,97,137,55,82
12,115,20,91,70,0,70
12,115,21,111,134,53,81
12,115,23,5,115,63,52
12,115,23,31,61,0,61
12,115,24,3,145,57,88
12,115,24,5,103,0,103
12,115,24,27,56,0,56
12,115,24,31,156,67,89
12,115,25,1,133,68,65
12,115,25,3,54,0,54
12,115,25,5,149,53,96
12,115,25,9,185,75,110
12,115,25,13,104,0,104
12,115,25,15,59,0,59
12,115,25,17,243,136,107
12,115,25,21,108,59,49
12,115,25,23,105,56,49
12,115,25,25,98,58,40
12,115,25,27,137,79,58
12,115,26,49,63,0,63
12,115,26,81,80,51,29
12,115,26,93,65,0,65
12,115,26,99,73,0,73
12,115,26,125,244,106,138
12,115,26,163,160,55,105
12,115,27,53,113,60,53
12,115,29,189,137,0,137
12,115,32,3,143,157,-14
12,115,33,11,171,0,171
12,115,33,15,156,70,86
12,115,34,1,57,0,57
12,115,34,3,167,0,167
12,115,34,5,88,0,88
12,115,34,7,68,0,68
12,115,34,9,57,0,57
12,115,34,13,95,0,95
12,115,34,17,76,0,76
12,115,34,21,69,0,69
12,115,34,23,137,0,137
12,115,34,25,149,51,98
12,115,34,27,163,0,163
12,115,34,29,224,72,152
12,115,34,31,59,0,59
12,115,34,39,74,0,74
12,115,36,1,76,0,76
12,115,36,5,67,0,67
12,115,36,27,75,0,75
12,115,36,29,202,69,133
12,115,36,47,141,89,52
12,115,36,55,162,54,108
12,115,36,59,215,52,163
12,115,36,61,154,144,10
12,115,36,67,110,0,110
12,115,36,71,109,0,109
12,115,36,81,152,54,98
12,115,36,85,82,0,82
12,115,36,91,87,56,31
12,115,36,103,299,110,189
12,115,36,111,82,0,82
12,115,36,119,146,69,77
12,115,37,21,67,119,-52
12,115,37,119,99,116,-17
12,115,37,183,93,120,-27
12,115,39,35,159,87,72
12,115,39,41,68,0,68
12,115,39,49,238,101,137
12,115,39,61,165,86,79
12,115,39,85,56,0,56
12,115,39,95,53,0,53
12,115,39,113,89,73,16
12,115,39,151,87,0,87
12,115,39,153,72,62,10
12,115,41,51,0,51,-51
12,115,42,3,176,46,130
12,115,42,17,111,62,49
12,115,42,29,71,0,71
12,115,42,71,63,0,63
12,115,42,91,107,0,107
12,115,42,95,66,0,66
12,115,42,101,95,0,95
12,115,44,3,63,0,63
12,115,44,7,109,0,109
12,115,44,9,80,0,80
12,115,45,45,74,70,4
12,115,45,51,57,57,0
12,115,47,37,73,56,17
12,115,47,93,55,111,-56
12,115,48,29,55,0,55
12,115,48,113,108,72,36
12,115,48,201,110,98,12
12,115,48,439,81,0,81
12,115,48,453,86,106,-20
12,115,51,59,196,68,128
12,115,51,107,58,0,58
12,115,51,153,82,0,82
12,115,53,33,109,64,45
12,115,55,25,77,0,77
12,115,55,79,71,0,71
12,115,55,133,82,0,82
12,117,4,13,177,208,-31
12,117,6,1,72,0,72
12,117,6,37,265,195,70
12,117,6,59,87,81,6
12,117,6,73,180,137,43
12,117,6,85,0,61,-61
12,117,8,5,0,77,-77
12,117,8,31,0,64,-64
12,117,8,41,79,120,-41
12,117,8,59,0,57,-57
12,117,9,1,115,56,59
12,117,9,3,132,68,64
12,117,9,9,91,0,91
12,117,10,3,65,0,65
12,117,11,1,0,46,-46
12,117,12,1,271,215,56
12,117,12,5,80,0,80
12,117,12,9,813,1099,-286
12,117,12,11,1122,712,410
12,117,12,15,62,81,-19
12,117,12,17,106,117,-11
12,117,12,19,142,134,8
12,117,12,21,103,68,35
12,117,12,31,558,485,73
12,117,12,33,79,88,-9
12,117,12,35,109,169,-60
12,117,12,53,80,83,-3
12,117,12,55,0,73,-73
12,117,12,57,811,790,21
12,117,12,61,79,88,-9
12,117,12,69,1150,2309,-1159
12,117,12,71,254,217,37
12,117,12,73,241,167,74
12,117,12,81,134,204,-70
12,117,12,83,259,364,-105
12,117,12,85,93,0,93
12,117,12,86,1087,475,612
12,117,12,91,73,90,-17
12,117,12,95,21334,18165,3169
12,117,12,97,1244,1183,61
12,117,12,99,656,513,143
12,117,12,101,250,268,-18
12,117,12,103,377,530,-153
12,117,12,105,713,914,-201
12,117,12,109,92,272,-180
12,117,12,111,195,173,22
12,117,12,113,0,61,-61
12,117,12,115,100,159,-59
12,117,12,119,69,96,-27
12,117,12,127,4394,7202,-2808
12,117,13,63,65,0,65
12,117,13,67,127,144,-17
12,117,13,89,83,112,-29
12,117,13,121,164,208,-44
12,117,13,135,142,179,-37
12,117,15,3,68,0,68
12,117,17,31,300,180,120
12,117,17,43,67,0,67
12,117,20,91,0,70,-70
12,117,24,5,78,0,78
12,117,24,31,59,0,59
12,117,24,33,0,50,-50
12,117,25,13,0,57,-57
12,117,25,17,127,65,62
12,117,25,27,80,0,80
12,117,26,125,91,0,91
12,117,26,163,63,0,63
12,117,27,53,68,0,68
12,117,32,3,83,153,-70
12,117,34,3,95,0,95
12,117,34,5,93,0,93
12,117,34,13,97,0,97
12,117,34,17,110,0,110
12,117,34,23,156,0,156
12,117,34,25,67,0,67
12,117,34,31,83,0,83
12,117,36,5,271,111,160
12,117,36,29,61,0,61
12,117,36,47,237,108,129
12,117,36,55,79,56,23
12,117,36,59,171,0,171
12,117,36,61,119,129,-10
12,117,36,71,62,0,62
12,117,36,81,359,158,201
12,117,36,103,203,72,131
12,117,36,119,85,0,85
12,117,37,21,0,86,-86
12,117,37,51,65,0,65
12,117,37,67,0,66,-66
12,117,37,81,0,55,-55
12,117,37,119,146,170,-24
12,117,37,133,66,0,66
12,117,37,183,141,186,-45
12,117,39,35,92,65,27
12,117,39,49,154,0,154
12,117,42,3,75,0,75
12,117,42,17,64,0,64
12,117,42,101,64,0,64
12,117,45,45,0,95,-95
12,117,47,37,63,76,-13
12,117,47,65,63,0,63
12,117,47,93,59,0,59
12,117,47,157,90,0,90
12,117,47,187,0,65,-65
12,117,48,29,91,84,7
12,117,48,85,75,130,-55
12,117,48,113,129,122,7
12,117,48,121,74,94,-20
12,117,48,201,203,177,26
12,117,48,439,94,123,-29
12,117,48,453,93,77,16
12,117,51,59,118,111,7
12,117,51,153,91,0,91
12,117,53,33,83,134,-51
12,119,4,13,60,0,60
12,119,6,37,45,0,45
12,119,9,1,52,0,52
12,119,9,3,61,0,61
12,119,9,9,56,0,56
12,119,12,1,62,67,-5
12,119,12,9,102,74,28
12,119,12,11,291,74,217
12,119,12,17,262,324,-62
12,119,12,21,65,0,65
12,119,12,31,85,68,17
12,119,12,53,288,195,93
12,119,12,57,330,191,139
12,119,12,69,1877,1638,239
12,119,12,71,132,84,48
12,119,12,81,78,85,-7
12,119,12,83,1063,1200,-137
12,119,12,86,128,0,128
12,119,12,95,375,168,207
12,119,12,97,80,0,80
12,119,12,99,188,83,105
12,119,12,101,235,188,47
12,119,12,103,230,125,105
12,119,12,105,195,71,124
12,119,12,111,56,0,56
12,119,12,115,63,92,-29
12,119,12,117,96,69,27
12,119,12,127,64,93,-29
12,119,17,31,118,0,118
12,119,17,43,66,0,66
12,119,25,17,101,59,42
12,119,26,99,64,0,64
12,119,26,125,92,54,38
12,119,26,163,69,0,69
12,119,32,3,66,0,66
12,119,34,3,53,0,53
12,119,34,5,65,0,65
12,119,34,29,70,0,70
12,119,36,55,57,0,57
12,119,36,59,94,0,94
12,119,36,103,208,50,158
12,119,39,35,51,0,51
12,119,39,49,65,0,65
12,119,42,3,71,0,71
12,119,48,373,191,0,191
12,119,51,59,97,0,97
12,119,53,33,51,0,51
12,119,55,133,53,0,53
12,121,12,1,135,133,2
12,121,12,11,64,0,64
12,121,12,23,759,699,60
12,121,12,31,119,144,-25
12,121,12,47,90,146,-56
12,121,12,57,95,66,29
12,121,12,67,161,146,15
12,121,12,79,57,0,57
12,121,12,86,127,0,127
12,121,12,99,71,0,71
12,123,12,73,123,140,-17
12,123,12,79,0,71,-71
12,125,12,1,216,141,75
12,125,12,3,74,0,74
12,125,12,7,216,156,60
12,125,12,23,190,171,19
12,125,12,31,70,0,70
12,127,1,89,0,65,-65
12,127,4,13,184,170,14
12,127,4,19,0,69,-69
12,127,6,37,191,153,38
12,127,6,59,69,0,69
12,127,6,65,65,0,65
12,127,6,73,161,129,32
12,127,8,31,48,62,-14
12,127,8,41,131,66,65
12,127,8,59,78,0,78
12,127,9,1,124,0,124
12,127,9,3,180,75,105
12,127,9,9,155,73,82
12,127,9,11,52,0,52
12,127,10,3,57,0,57
12,127,11,1,44,0,44
12,127,12,1,284,276,8
12,127,12,5,88,0,88
12,127,12,9,992,811,181
12,127,12,11,886,495,391
12,127,12,15,60,54,6
12,127,12,17,104,114,-10
12,127,12,19,218,144,74
12,127,12,21,89,0,89
12,127,12,23,0,75,-75
12,127,12,31,853,972,-119
12,127,12,33,77,70,7
12,127,12,35,1990,2332,-342
12,127,12,53,80,99,-19
12,127,12,55,87,0,87
12,127,12,57,558,692,-134
12,127,12,61,68,123,-55
12,127,12,69,1128,1233,-105
12,127,12,71,240,233,7
12,127,12,73,176,174,2
12,127,12,81,119,119,0
12,127,12,83,462,495,-33
12,127,12,85,83,104,-21
12,127,12,86,860,361,499
12,127,12,87,143,85,58
12,127,12,91,129,97,32
12,127,12,95,4311,2661,1650
12,127,12,97,497,332,165
12,127,12,99,620,410,210
12,127,12,101,200,210,-10
12,127,12,103,384,360,24
12,127,12,105,510,489,21
12,127,12,107,319,374,-55
12,127,12,109,319,429,-110
12,127,12,111,225,177,48
12,127,12,115,105,123,-18
12,127,12,117,7202,4394,2808
12,127,12,119,93,64,29
12,127,13,51,86,91,-5
12,127,13,67,100,154,-54
12,127,13,89,64,108,-44
12,127,13,121,108,129,-21
12,127,13,135,160,100,60
12,127,15,3,108,53,55
12,127,17,31,255,176,79
12,127,17,43,50,0,50
12,127,17,197,69,0,69
12,127,18,97,81,0,81
12,127,21,111,71,67,4
12,127,24,3,101,51,50
12,127,24,5,59,0,59
12,127,24,31,66,0,66
12,127,24,33,53,0,53
12,127,25,5,67,56,11
12,127,25,9,72,0,72
12,127,25,13,88,58,30
12,127,25,17,129,67,62
12,127,25,21,48,0,48
12,127,25,23,93,0,93
12,127,25,27,119,115,4
12,127,26,49,55,0,55
12,127,26,99,60,0,60
12,127,26,125,64,72,-8
12,127,26,163,133,59,74
12,127,32,3,159,125,34
12,127,33,11,68,56,12
12,127,34,3,82,0,82
12,127,34,5,61,0,61
12,127,34,13,86,0,86
12,127,34,17,67,0,67
12,127,34,23,94,0,94
12,127,34,25,89,0,89
12,127,34,27,57,0,57
12,127,34,29,124,0,124
12,127,34,31,83,0,83
12,127,34,39,65,0,65
12,127,36,5,210,0,210
12,127,36,7,53,0,53
12,127,36,29,74,49,25
12,127,36,47,188,91,97
12,127,36,55,84,91,-7
12,127,36,59,148,63,85
12,127,36,61,102,47,55
12,127,36,65,75,0,75
12,127,36,67,92,48,44
12,127,36,71,103,0,103
12,127,36,81,230,90,140
12,127,36,85,61,0,61
12,127,36,91,68,0,68
12,127,36,103,289,125,164
12,127,36,119,106,0,106
12,127,37,21,49,87,-38
12,127,37,51,61,77,-16
12,127,37,81,0,55,-55
12,127,37,89,0,63,-63
12,127,37,97,0,54,-54
12,127,37,119,132,120,12
12,127,37,183,66,99,-33
12,127,39,35,79,67,12
12,127,39,49,111,84,27
12,127,39,61,77,0,77
12,127,39,113,80,0,80
12,127,39,153,73,45,28
12,127,42,3,138,81,57
12,127,42,17,67,0,67
12,127,42,79,66,0,66
12,127,42,89,55,0,55
12,127,42,91,66,63,3
12,127,42,101,139,62,77
12,127,44,7,84,0,84
12,127,45,13,0,55,-55
12,127,45,19,58,0,58
12,127,45,45,59,83,-24
12,127,45,51,46,59,-13
12,127,45,63,55,0,55
12,127,47,37,77,68,9
12,127,47,65,0,59,-59
12,127,47,93,65,95,-30
12,127,47,125,62,0,62
12,127,48,29,0,65,-65
12,127,48,113,81,79,2
12,127,48,201,163,95,68
12,127,48,439,77,62,15
12,127,48,453,121,96,25
12,127,51,41,52,0,52
12,127,51,59,155,81,74
12,127,51,153,72,0,72
12,127,51,810,55,0,55
12,127,53,33,59,85,-26
12,127,54,39,80,0,80
12,129,12,5,62,0,62
12,129,12,37,0,65,-65
12,129,12,39,60,0,60
12,129,12,73,1483,927,556
12,131,1,3,60,77,-17
12,131,1,39,76,87,-11
12,131,1,73,85,0,85
12,131,1,117,52,0,52
12,131,12,5,737,456,281
12,131,12,33,153,110,43
12,131,12,57,66,0,66
12,131,12,59,214,224,-10
12,131,12,73,113,58,55
12,131,12,91,2393,1767,626
12,131,12,95,0,65,-65
12,131,12,103,63,0,63
12,131,12,113,143,115,28
12,131,13,67,140,0,140
12,131,13,121,196,83,113
12,131,32,3,64,0,64
12,131,48,201,60,0,60
12,133,12,5,888,497,391
12,133,12,59,288,261,27
12,133,12,63,266,278,-12
13,1,13,161,165,105,60
13,1,13,305,79,106,-27
13,3,13,69,219,241,-22
13,5,13,69,100,125,-25
13,5,13,299,0,67,-67
13,7,13,95,0,71,-71
13,9,13,21,138,233,-95
13,9,13,89,76,58,18
13,9,13,121,60,77,-17
13,9,13,135,61,0,61
13,9,13,141,154,109,45
13,9,13,151,0,56,-56
13,9,13,153,97,72,25
13,9,13,169,114,167,-53
13,9,13,175,56,0,56
13,9,13,237,286,273,13
13,9,13,303,70,68,2
13,9,13,319,187,174,13
13,11,13,119,66,90,-24
13,11,13,135,86,0,86
13,11,13,137,255,378,-123
13,11,13,139,422,232,190
13,11,13,157,589,443,146
13,11,13,195,75,71,4
13,13,13,57,57,54,3
13,13,13,59,595,433,162
13,13,13,67,109,77,32
13,13,13,89,247,154,93
13,13,13,117,150,92,58
13,13,13,121,137,94,43
13,13,13,135,4280,1739,2541
13,13,13,139,646,555,91
13,13,13,157,747,932,-185
13,13,13,195,0,71,-71
13,13,13,217,107,0,107
13,13,13,219,261,279,-18
13,13,13,247,77,0,77
13,13,13,297,595,599,-4
13,15,13,45,70,0,70
13,15,13,57,1341,669,672
13,15,13,67,1936,1100,836
13,15,13,89,106,113,-7
13,15,13,97,88,80,8
13,15,13,115,549,767,-218
13,15,13,117,66,0,66
13,15,13,121,215,177,38
13,15,13,129,687,860,-173
13,15,13,135,189,122,67
13,15,13,213,82,0,82
13,15,13,223,750,545,205
13,15,13,227,79,76,3
13,15,13,233,281,339,-58
13,15,13,313,111,107,4
13,15,47,65,58,0,58
13,17,13,69,65,0,65
13,17,13,155,177,264,-87
13,17,13,277,87,118,-31
13,19,13,75,137,176,-39
13,19,13,173,141,0,141
13,19,13,185,332,311,21
13,19,13,277,219,176,43
13,21,12,11,58,0,58
13,21,12,31,0,88,-88
13,21,12,57,0,68,-68
13,21,12,86,118,0,118
13,21,13,9,233,138,95
13,21,13,51,89,104,-15
13,21,13,59,47,0,47
13,21,13,63,203,205,-2
13,21,13,67,169,254,-85
13,21,13,79,247,257,-10
13,21,13,89,216,287,-71
13,21,13,95,72,57,15
13,21,13,121,297,329,-32
13,21,13,135,218,224,-6
13,21,13,151,177,329,-152
13,21,13,153,1554,1898,-344
13,21,13,169,809,859,-50
13,21,13,175,116,81,35
13,21,13,185,62,0,62
13,21,13,207,688,871,-183
13,21,13,215,54,82,-28
13,21,13,225,306,354,-48
13,21,13,237,80,73,7
13,21,13,245,56,68,-12
13,21,13,289,270,260,10
13,21,13,319,71,0,71
13,21,48,201,67,0,67
13,23,13,91,188,128,60
13,23,13,153,114,155,-41
13,23,13,175,69,0,69
13,23,13,235,94,0,94
13,25,13,39,0,72,-72
13,25,13,127,367,188,179
13,25,13,229,163,161,2
13,25,13,299,222,212,10
13,25,13,305,0,83,-83
13,27,13,71,71,79,-8
13,27,13,185,527,623,-96
13,27,13,275,151,122,29
13,29,8,41,87,0,87
13,29,13,31,190,301,-111
13,29,13,51,1816,1070,746
13,29,13,103,266,359,-93
13,29,13,179,365,407,-42
13,29,13,183,0,90,-90
13,29,37,51,85,0,85
13,29,48,27,0,77,-77
13,29,48,141,102,0,102
13,31,12,31,0,76,-76
13,31,13,29,301,190,111
13,31,13,43,198,260,-62
13,31,13,51,641,550,91
13,31,13,67,60,89,-29
13,31,13,89,0,127,-127
13,31,13,103,403,287,116
13,31,13,107,184,116,68
13,31,13,109,118,136,-18
13,31,13,121,57,99,-42
13,31,13,135,0,101,-101
13,31,13,151,0,65,-65
13,31,13,153,0,58,-58
13,31,13,165,170,95,75
13,31,13,179,135,55,80
13,31,13,245,83,137,-54
13,31,13,251,320,224,96
13,31,13,267,136,113,23
13,31,13,279,72,70,2
13,33,13,73,85,104,-19
13,33,13,163,70,0,70
13,33,13,165,74,74,0
13,33,13,245,612,788,-176
13,33,45,3,72,60,12
13,35,13,63,150,0,150
13,35,13,121,63,0,63
13,35,13,151,930,509,421
13,35,13,159,91,73,18
13,35,13,171,0,82,-82
13,35,13,207,84,124,-40
13,35,13,217,161,100,61
13,35,13,255,236,195,41
13,37,13,99,0,92,-92
13,39,6,73,112,188,-76
13,39,9,11,231,198,33
13,39,12,9,0,97,-97
13,39,12,19,70,86,-16
13,39,12,31,613,584,29
13,39,12,89,365,387,-22
13,39,13,25,72,0,72
13,39,13,49,112,116,-4
13,39,13,51,67,56,11
13,39,13,127,397,266,131
13,39,15,3,115,103,12
13,39,37,133,0,105,-105
13,39,45,15,161,141,20
13,39,51,550,101,120,-19
13,39,51,740,0,102,-102
13,39,51,810,116,146,-30
13,39,53,35,202,171,31
13,43,13,31,260,198,62
13,43,13,107,76,73,3
13,45,1,15,101,88,13
13,45,1,29,134,149,-15
13,45,1,111,157,176,-19
13,45,12,86,71,0,71
13,45,13,15,0,70,-70
13,45,13,57,85,91,-6
13,45,13,63,84,118,-34
13,45,13,67,508,468,40
13,45,13,77,307,311,-4
13,45,13,89,166,177,-11
13,45,13,97,2034,1410,624
13,45,13,115,0,75,-75
13,45,13,121,263,352,-89
13,45,13,135,181,169,12
13,45,13,143,945,996,-51
13,45,13,149,178,192,-14
13,45,13,151,63,72,-9
13,45,13,223,902,753,149
13,45,13,233,99,130,-31
13,45,13,285,104,72,32
13,47,13,67,52,0,52
13,47,13,83,66,0,66
13,47,13,129,80,0,80
13,47,13,213,96,109,-13
13,47,13,295,1557,1419,138
13,47,13,313,518,416,102
13,47,47,11,99,196,-97
13,47,47,65,1981,1733,248
13,47,47,115,0,59,-59
13,49,12,31,172,78,94
13,49,12,89,117,97,20
13,49,13,39,116,112,4
13,51,1,31,0,73,-73
13,51,1,45,85,0,85
13,51,1,73,61,0,61
13,51,4,3,0,61,-61
13,51,4,13,119,97,22
13,51,6,37,200,187,13
13,51,6,59,0,82,-82
13,51,6,71,0,67,-67
13,51,6,73,122,102,20
13,51,8,31,61,51,10
13,51,8,41,131,160,-29
13,51,11,1,46,0,46
13,51,12,9,107,92,15
13,51,12,11,158,141,17
13,51,12,19,0,83,-83
13,51,12,31,372,392,-20
13,51,12,57,155,185,-30
13,51,12,71,72,0,72
13,51,12,73,52,0,52
13,51,12,86,224,127,97
13,51,12,91,54,0,54
13,51,12,95,200,216,-16
13,51,12,99,112,120,-8
13,51,12,103,64,122,-58
13,51,12,105,0,78,-78
13,51,12,109,87,90,-3
13,51,12,115,0,56,-56
13,51,12,127,91,86,5
13,51,13,21,104,89,15
13,51,13,29,1070,1816,-746
13,51,13,31,550,641,-91
13,51,13,39,56,67,-11
13,51,13,57,63,91,-28
13,51,13,59,81,76,5
13,51,13,63,149,239,-90
13,51,13,67,314,386,-72
13,51,13,73,158,169,-11
13,51,13,77,0,83,-83
13,51,13,89,325,406,-81
13,51,13,95,81,0,81
13,51,13,97,70,0,70
13,51,13,103,1548,3048,-1500
13,51,13,109,0,66,-66
13,51,13,113,0,80,-80
13,51,13,121,477,620,-143
13,51,13,127,318,199,119
13,51,13,135,321,398,-77
13,51,13,139,0,76,-76
13,51,13,151,112,166,-54
13,51,13,153,124,130,-6
13,51,13,175,58,0,58
13,51,13,179,852,943,-91
13,51,13,183,148,91,57
13,51,13,185,109,57,52
13,51,13,191,60,83,-23
13,51,13,215,124,198,-74
13,51,13,245,157,210,-53
13,51,13,251,0,97,-97
13,51,13,267,67,60,7
13,51,13,305,0,63,-63
13,51,15,3,137,118,19
13,51,17,31,119,85,34
13,51,20,61,103,0,103
13,51,21,111,0,55,-55
13,51,24,3,69,0,69
13,51,24,31,56,52,4
13,51,32,3,0,81,-81
13,51,36,45,0,81,-81
13,51,36,47,92,88,4
13,51,36,59,51,0,51
13,51,36,61,94,67,27
13,51,36,81,60,50,10
13,51,36,103,58,0,58
13,51,37,21,0,88,-88
13,51,37,51,221,185,36
13,51,37,63,0,56,-56
13,51,37,67,0,55,-55
13,51,37,81,99,93,6
13,51,37,119,118,228,-110
13,51,37,129,55,0,55
13,51,37,133,72,0,72
13,51,37,183,92,128,-36
13,51,39,49,55,65,-10
13,51,45,13,518,566,-48
13,51,45,15,84,62,22
13,51,45,19,186,185,1
13,51,45,35,78,77,1
13,51,45,45,61,120,-59
13,51,45,51,59,68,-9
13,51,45,53,179,127,52
13,51,45,63,61,66,-5
13,51,45,79,123,132,-9
13,51,47,37,90,101,-11
13,51,47,93,0,69,-69
13,51,47,125,163,137,26
13,51,47,157,57,0,57
13,51,48,27,130,129,1
13,51,48,29,62,100,-38
13,51,48,113,67,85,-18
13,51,48,141,164,123,41
13,51,48,201,129,103,26
13,51,48,439,69,59,10
13,51,48,453,91,47,44
13,51,51,59,97,112,-15
13,51,51,153,54,0,54
13,51,51,700,78,66,12
13,51,51,810,64,58,6
13,51,53,33,68,139,-71
13,51,53,53,85,103,-18
13,53,1,81,70,79,-9
13,53,1,113,91,139,-48
13,53,8,41,143,127,16
13,53,13,179,71,0,71
13,53,13,215,502,642,-140
13,53,15,3,0,76,-76
13,53,36,71,54,0,54
13,53,37,51,0,80,-80
13,53,47,125,0,93,-93
13,53,48,27,0,78,-78
13,53,48,141,81,92,-11
13,53,53,53,0,90,-90
13,55,1,19,0,82,-82
13,55,13,115,251,211,40
13,55,13,295,315,273,42
13,57,4,13,80,65,15
13,57,6,37,102,0,102
13,57,6,59,70,0,70
13,57,12,9,87,0,87
13,57,12,11,210,84,126
13,57,12,31,87,81,6
13,57,12,57,83,54,29
13,57,12,71,70,0,70
13,57,12,81,0,56,-56
13,57,12,86,160,0,160
13,57,12,95,89,101,-12
13,57,12,99,134,73,61
13,57,12,101,0,70,-70
13,57,12,103,71,72,-1
13,57,12,109,0,98,-98
13,57,13,13,54,57,-3
13,57,13,15,669,1341,-672
13,57,13,45,91,85,6
13,57,13,51,91,63,28
13,57,13,59,78,75,3
13,57,13,63,113,104,9
13,57,13,67,7459,4770,2689
13,57,13,77,86,83,3
13,57,13,85,79,142,-63
13,57,13,89,637,515,122
13,57,13,97,143,142,1
13,57,13,111,62,69,-7
13,57,13,113,121,0,121
13,57,13,115,111,91,20
13,57,13,117,1241,871,370
13,57,13,121,3794,2102,1692
13,57,13,123,225,228,-3
13,57,13,129,82,93,-11
13,57,13,135,1077,609,468
13,57,13,139,156,120,36
13,57,13,151,192,76,116
13,57,13,153,70,57,13
13,57,13,157,55,0,55
13,57,13,187,58,0,58
13,57,13,217,80,0,80
13,57,13,223,628,949,-321
13,57,13,227,801,947,-146
13,57,17,31,82,0,82
13,57,36,103,77,0,77
13,57,37,119,79,90,-11
13,57,47,65,0,55,-55
13,57,48,201,94,65,29
13,59,6,37,66,50,16
13,59,13,13,433,595,-162
13,59,13,21,0,47,-47
13,59,13,51,76,81,-5
13,59,13,57,75,78,-3
13,59,13,67,233,265,-32
13,59,13,73,0,64,-64
13,59,13,89,327,479,-152
13,59,13,105,111,136,-25
13,59,13,113,59,0,59
13,59,13,117,84,81,3
13,59,13,119,71,61,10
13,59,13,121,388,501,-113
13,59,13,127,59,0,59
13,59,13,133,105,63,42
13,59,13,135,654,634,20
13,59,13,139,202,183,19
13,59,13,147,74,62,12
13,59,13,151,63,63,0
13,59,13,157,506,824,-318
13,59,13,185,54,0,54
13,59,13,195,532,823,-291
13,59,13,211,92,79,13
13,59,13,217,98,0,98
13,59,13,219,880,1430,-550
13,59,13,221,328,516,-188
13,59,13,245,50,88,-38
13,59,13,297,349,282,67
13,59,17,31,61,0,61
13,59,37,119,0,78,-78
13,59,37,183,0,54,-54
13,59,47,37,56,47,9
13,59,48,453,0,48,-48
13,63,1,73,101,64,37
13,63,1,89,0,54,-54
13,63,1,97,0,91,-91
13,63,1,101,111,64,47
13,63,4,13,0,66,-66
13,63,6,37,155,92,63
13,63,6,73,77,62,15
13,63,12,11,342,155,187
13,63,12,31,150,141,9
13,63,12,57,166,106,60
13,63,12,86,445,182,263
13,63,12,95,218,91,127
13,63,12,99,126,69,57
13,63,12,117,0,65,-65
13,63,13,21,205,203,2
13,63,13,35,0,150,-150
13,63,13,45,118,84,34
13,63,13,51,239,149,90
13,63,13,57,104,113,-9
13,63,13,67,1459,1378,81
13,63,13,77,328,508,-180
13,63,13,89,5087,4037,1050
13,63,13,95,140,82,58
13,63,13,97,472,656,-184
13,63,13,113,837,1398,-561
13,63,13,117,0,67,-67
13,63,13,121,11224,9364,1860
13,63,13,135,1361,1472,-111
13,63,13,139,0,112,-112
13,63,13,151,4274,7221,-2947
13,63,13,153,102,105,-3
13,63,13,171,0,76,-76
13,63,13,185,89,91,-2
13,63,13,215,215,187,28
13,63,13,217,271,357,-86
13,63,13,223,134,197,-63
13,63,13,245,135,101,34
13,63,13,247,325,395,-70
13,63,13,255,515,687,-172
13,63,13,285,0,100,-100
13,63,13,297,0,53,-53
13,63,17,31,210,135,75
13,63,18,97,79,69,10
13,63,22,71,71,0,71
13,63,24,33,73,0,73
13,63,24,510,60,0,60
13,63,26,163,116,95,21
13,63,32,3,88,106,-18
13,63,34,13,120,0,120
13,63,36,5,101,69,32
13,63,36,47,243,98,145
13,63,36,59,92,0,92
13,63,36,61,75,0,75
13,63,36,81,159,76,83
13,63,37,51,66,67,-1
13,63,37,81,62,0,62
13,63,37,119,107,88,19
13,63,37,183,71,0,71
13,63,39,35,76,0,76
13,63,39,49,94,67,27
13,63,42,101,96,0,96
13,63,45,79,0,64,-64
13,63,47,37,47,0,47
13,63,47,157,144,94,50
13,63,48,27,64,0,64
13,63,48,113,90,106,-16
13,63,48,201,120,130,-10
13,63,48,439,63,59,4
13,63,48,453,70,0,70
13,67,1,3,0,128,-128
13,67,1,15,63,0,63
13,67,1,73,317,241,76
13,67,1,81,113,137,-24
13,67,1,89,99,150,-51
13,67,1,97,117,63,54
13,67,1,101,195,83,112
13,67,1,117,87,96,-9
13,67,1,125,91,0,91
13,67,4,13,293,356,-63
13,67,4,19,58,78,-20
13,67,6,1,139,105,34
13,67,6,13,88,70,18
13,67,6,37,633,510,123
13,67,6,59,223,160,63
13,67,6,65,144,106,38
13,67,6,67,69,61,8
13,67,6,71,84,0,84
13,67,6,73,223,254,-31
13,67,6,75,45,75,-30
13,67,6,81,0,56,-56
13,67,6,85,139,178,-39
13,67,8,5,83,101,-18
13,67,8,31,60,117,-57
13,67,8,35,0,86,-86
13,67,8,41,90,114,-24
13,67,8,59,0,81,-81
13,67,9,1,137,87,50
13,67,9,3,133,0,133
13,67,9,9,101,0,101
13,67,10,3,69,0,69
13,67,11,1,88,117,-29
13,67,12,1,127,0,127
13,67,12,5,135,103,32
13,67,12,9,130,143,-13
13,67,12,11,792,407,385
13,67,12,19,0,77,-77
13,67,12,21,63,0,63
13,67,12,31,375,389,-14
13,67,12,33,98,103,-5
13,67,12,57,337,447,-110
13,67,12,69,76,56,20
13,67,12,71,166,131,35
13,67,12,73,170,69,101
13,67,12,81,78,114,-36
13,67,12,83,0,81,-81
13,67,12,86,573,301,272
13,67,12,89,0,65,-65
13,67,12,91,68,78,-10
13,67,12,95,473,381,92
13,67,12,97,75,0,75
13,67,12,99,376,265,111
13,67,12,101,78,121,-43
13,67,12,103,200,269,-69
13,67,12,105,117,91,26
13,67,12,109,74,155,-81
13,67,12,111,68,69,-1
13,67,12,113,0,57,-57
13,67,12,115,92,115,-23
13,67,12,117,144,127,17
13,67,12,127,154,100,54
13,67,12,131,0,140,-140
13,67,13,13,77,109,-32
13,67,13,15,1100,1936,-836
13,67,13,21,254,169,85
13,67,13,31,89,60,29
13,67,13,45,468,508,-40
13,67,13,47,0,52,-52
13,67,13,51,386,314,72
13,67,13,57,4770,7459,-2689
13,67,13,59,265,233,32
13,67,13,63,1378,1459,-81
13,67,13,73,154,115,39
13,67,13,77,359,395,-36
13,67,13,89,5794,4747,1047
13,67,13,95,133,86,47
13,67,13,97,2955,4242,-1287
13,67,13,111,0,126,-126
13,67,13,113,424,371,53
13,67,13,115,241,251,-10
13,67,13,117,727,1355,-628
13,67,13,121,14865,13504,1361
13,67,13,123,75,182,-107
13,67,13,127,80,123,-43
13,67,13,129,91,166,-75
13,67,13,133,0,87,-87
13,67,13,135,3805,3486,319
13,67,13,139,308,344,-36
13,67,13,143,46,105,-59
13,67,13,151,815,721,94
13,67,13,153,198,153,45
13,67,13,157,0,68,-68
13,67,13,179,74,0,74
13,67,13,185,116,88,28
13,67,13,187,0,58,-58
13,67,13,215,287,199,88
13,67,13,217,219,230,-11
13,67,13,219,63,71,-8
13,67,13,223,4248,8020,-3772
13,67,13,227,117,243,-126
13,67,13,233,86,161,-75
13,67,13,245,252,176,76
13,67,13,247,283,204,79
13,67,13,255,0,96,-96
13,67,13,285,64,59,5
13,67,13,291,0,83,-83
13,67,13,297,99,92,7
13,67,13,313,92,97,-5
13,67,15,3,100,0,100
13,67,17,31,700,407,293
13,67,17,43,133,80,53
13,67,17,97,86,0,86
13,67,18,57,0,76,-76
13,67,18,89,60,0,60
13,67,18,97,138,76,62
13,67,20,91,87,0,87
13,67,21,67,62,0,62
13,67,21,111,135,89,46
13,67,22,33,95,0,95
13,67,22,51,88,0,88
13,67,22,71,99,69,30
13,67,24,3,76,0,76
13,67,24,5,111,59,52
13,67,24,31,160,122,38
13,67,24,33,171,96,75
13,67,24,510,83,0,83
13,67,25,9,65,0,65
13,67,25,17,145,97,48
13,67,25,21,58,54,4
13,67,25,25,72,55,17
13,67,26,81,110,0,110
13,67,26,125,115,125,-10
13,67,26,163,214,142,72
13,67,27,53,99,103,-4
13,67,28,49,100,0,100
13,67,29,95,56,66,-10
13,67,29,189,132,133,-1
13,67,32,3,175,242,-67
13,67,34,3,125,60,65
13,67,34,5,54,0,54
13,67,34,13,210,0,210
13,67,34,17,88,58,30
13,67,34,23,133,74,59
13,67,34,27,59,0,59
13,67,34,31,86,0,86
13,67,34,39,88,0,88
13,67,36,5,176,82,94
13,67,36,29,77,0,77
13,67,36,47,279,169,110
13,67,36,55,87,63,24
13,67,36,59,165,51,114
13,67,36,61,206,158,48
13,67,36,71,54,0,54
13,67,36,81,264,101,163
13,67,36,103,153,0,153
13,67,36,119,85,0,85
13,67,37,21,72,92,-20
13,67,37,51,91,0,91
13,67,37,63,68,0,68
13,67,37,67,87,0,87
13,67,37,81,128,81,47
13,67,37,119,431,400,31
13,67,37,133,66,0,66
13,67,37,183,298,273,25
13,67,39,35,174,131,43
13,67,39,49,136,156,-20
13,67,39,61,99,101,-2
13,67,40,109,69,0,69
13,67,40,143,0,63,-63
13,67,42,3,105,120,-15
13,67,42,91,60,0,60
13,67,42,101,144,92,52
13,67,44,7,59,0,59
13,67,45,3,77,0,77
13,67,45,13,72,131,-59
13,67,45,15,63,58,5
13,67,45,19,129,173,-44
13,67,45,45,161,204,-43
13,67,45,51,60,104,-44
13,67,45,63,81,0,81
13,67,45,79,149,142,7
13,67,45,91,0,70,-70
13,67,47,37,199,279,-80
13,67,47,65,237,219,18
13,67,47,93,112,123,-11
13,67,47,149,88,85,3
13,67,47,157,276,191,85
13,67,47,187,0,81,-81
13,67,47,189,0,63,-63
13,67,48,27,0,63,-63
13,67,48,29,175,115,60
13,67,48,85,100,176,-76
13,67,48,113,256,332,-76
13,67,48,121,86,147,-61
13,67,48,157,97,86,11
13,67,48,201,467,402,65
13,67,48,339,0,60,-60
13,67,48,439,176,263,-87
13,67,48,453,205,213,-8
13,67,48,491,0,80,-80
13,67,49,35,70,101,-31
13,67,51,13,51,51,0
13,67,51,41,74,0,74
13,67,51,59,189,168,21
13,67,51,87,94,75,19
13,67,51,153,92,0,92
13,67,51,650,54,0,54
13,67,51,810,95,82,13
13,67,53,33,174,320,-146
13,67,53,53,0,71,-71
13,67,55,79,105,98,7
13,69,12,31,0,63,-63
13,69,13,3,241,219,22
13,69,13,5,125,100,25
13,69,13,17,0,65,-65
13,69,13,155,65,0,65
13,69,13,161,58,89,-31
13,69,13,185,74,0,74
13,69,13,299,0,101,-101
13,71,13,27,79,71,8
13,71,13,75,0,70,-70
13,71,13,95,109,97,12
13,71,13,185,96,186,-90
13,71,13,205,89,86,3
13,71,13,275,260,194,66
13,71,13,277,220,168,52
13,71,13,321,89,135,-46
13,73,4,3,107,0,107
13,73,4,13,53,62,-9
13,73,6,53,124,0,124
13,73,6,73,83,71,12
13,73,8,41,181,137,44
13,73,12,33,75,0,75
13,73,12,57,117,128,-11
13,73,13,33,104,85,19
13,73,13,51,169,158,11
13,73,13,59,64,0,64
13,73,13,67,115,154,-39
13,73,13,89,123,120,3
13,73,13,121,111,197,-86
13,73,13,135,182,195,-13
13,73,13,163,89,89,0
13,73,13,179,110,0,110
13,73,13,181,102,157,-55
13,73,13,189,400,380,20
13,73,13,215,72,0,72
13,73,13,245,5801,3706,2095
13,73,15,3,298,211,87
13,73,24,3,390,232,158
13,73,24,27,0,85,-85
13,73,24,31,0,71,-71
13,73,37,51,223,123,100
13,73,37,85,0,89,-89
13,73,37,119,0,117,-117
13,73,45,3,677,697,-20
13,73,45,19,0,74,-74
13,73,45,37,90,144,-54
13,73,45,45,0,84,-84
13,73,45,63,99,80,19
13,73,45,65,0,77,-77
13,73,45,79,166,128,38
13,73,47,125,133,100,33
13,73,48,27,211,115,96
13,73,48,29,184,218,-34
13,73,48,141,148,134,14
13,73,51,59,116,134,-18
13,73,53,53,117,88,29
13,75,13,19,176,137,39
13,75,13,71,70,0,70
13,75,13,185,358,369,-11
13,75,13,277,161,122,39
13,77,1,81,123,68,55
13,77,4,13,64,69,-5
13,77,6,37,60,0,60
13,77,12,5,0,62,-62
13,77,12,11,70,0,70
13,77,12,86,69,0,69
13,77,12,95,52,0,52
13,77,12,103,0,60,-60
13,77,13,45,311,307,4
13,77,13,51,83,0,83
13,77,13,57,83,86,-3
13,77,13,63,508,328,180
13,77,13,67,395,359,36
13,77,13,89,306,230,76
13,77,13,97,189,135,54
13,77,13,113,2221,1412,809
13,77,13,117,89,0,89
13,77,13,121,1282,1239,43
13,77,13,135,269,212,57
13,77,13,145,0,54,-54
13,77,13,149,175,192,-17
13,77,13,151,518,312,206
13,77,13,199,369,473,-104
13,77,13,215,151,119,32
13,77,13,223,61,101,-40
13,77,13,231,63,97,-34
13,77,13,255,225,200,25
13,77,13,285,419,629,-210
13,79,13,21,257,247,10
13,79,13,153,247,156,91
13,79,13,225,185,173,12
13,81,13,93,193,198,-5
13,81,13,153,111,151,-40
13,81,13,261,66,0,66
13,81,13,315,0,63,-63
13,83,1,49,59,85,-26
13,83,1,71,112,125,-13
13,83,13,47,0,66,-66
13,83,13,295,120,153,-33
13,83,47,65,269,283,-14
13,85,13,57,142,79,63
13,85,13,117,1193,769,424
13,85,13,121,193,66,127
13,85,13,135,193,0,193
13,85,13,139,241,263,-22
13,85,13,187,271,380,-109
13,85,13,227,67,66,1
13,87,12,39,96,101,-5
13,87,12,73,97,151,-54
13,87,13,131,121,90,31
13,87,13,201,102,115,-13
13,87,13,253,138,119,19
13,89,1,3,52,66,-14
13,89,1,73,343,264,79
13,89,1,81,105,76,29
13,89,1,89,74,129,-55
13,89,1,97,178,90,88
13,89,1,101,150,76,74
13,89,1,113,60,0,60
13,89,1,117,74,0,74
13,89,1,125,54,0,54
13,89,4,13,244,319,-75
13,89,4,19,0,94,-94
13,89,5,119,82,0,82
13,89,6,1,150,118,32
13,89,6,13,92,0,92
13,89,6,37,703,667,36
13,89,6,59,104,161,-57
13,89,6,65,85,0,85
13,89,6,67,76,77,-1
13,89,6,71,66,88,-22
13,89,6,73,237,199,38
13,89,6,75,109,117,-8
13,89,6,81,0,64,-64
13,89,6,85,144,202,-58
13,89,8,5,76,116,-40
13,89,8,31,116,167,-51
13,89,8,41,53,64,-11
13,89,9,1,143,60,83
13,89,9,3,160,78,82
13,89,9,9,93,51,42
13,89,10,3,79,0,79
13,89,11,1,227,221,6
13,89,12,1,167,62,105
13,89,12,5,55,79,-24
13,89,12,9,107,112,-5
13,89,12,11,586,455,131
13,89,12,21,47,0,47
13,89,12,31,382,340,42
13,89,12,33,119,83,36
13,89,12,57,372,309,63
13,89,12,71,96,81,15
13,89,12,73,199,105,94
13,89,12,81,50,0,50
13,89,12,86,693,306,387
13,89,12,91,0,55,-55
13,89,12,95,388,365,23
13,89,12,97,54,72,-18
13,89,12,99,314,194,120
13,89,12,103,183,268,-85
13,89,12,105,64,107,-43
13,89,12,109,0,75,-75
13,89,12,115,45,79,-34
13,89,12,117,112,83,29
13,89,12,127,108,64,44
13,89,13,9,58,76,-18
13,89,13,13,154,247,-93
13,89,13,15,113,106,7
13,89,13,21,287,216,71
13,89,13,31,127,0,127
13,89,13,45,177,166,11
13,89,13,51,406,325,81
13,89,13,57,515,637,-122
13,89,13,59,479,327,152
13,89,13,63,4037,5087,-1050
13,89,13,67,4747,5794,-1047
13,89,13,73,120,123,-3
13,89,13,77,230,306,-76
13,89,13,95,190,85,105
13,89,13,97,636,736,-100
13,89,13,111,0,50,-50
13,89,13,113,375,368,7
13,89,13,115,61,0,61
13,89,13,117,605,1257,-652
13,89,13,121,22741,22591,150
13,89,13,127,107,102,5
13,89,13,135,12644,17820,-5176
13,89,13,139,372,450,-78
13,89,13,151,1506,2657,-1151
13,89,13,153,144,140,4
13,89,13,157,54,117,-63
13,89,13,179,73,0,73
13,89,13,185,139,75,64
13,89,13,215,246,222,24
13,89,13,217,1216,1824,-608
13,89,13,219,60,76,-16
13,89,13,223,246,337,-91
13,89,13,227,0,64,-64
13,89,13,245,295,250,45
13,89,13,247,1839,2859,-1020
13,89,13,255,152,170,-18
13,89,13,285,63,68,-5
13,89,13,297,298,489,-191
13,89,13,313,56,0,56
13,89,15,3,79,98,-19
13,89,17,31,672,518,154
13,89,17,43,77,0,77
13,89,17,97,62,0,62
13,89,18,3,0,75,-75
13,89,18,97,141,209,-68
13,89,19,153,0,71,-71
13,89,21,67,0,61,-61
13,89,21,111,163,184,-21
13,89,22,17,58,0,58
13,89,22,33,111,57,54
13,89,22,51,95,68,27
13,89,22,71,217,124,93
13,89,24,3,68,67,1
13,89,24,5,91,96,-5
13,89,24,31,154,189,-35
13,89,24,33,172,184,-12
13,89,24,510,145,98,47
13,89,25,17,121,149,-28
13,89,25,21,56,0,56
13,89,25,25,153,116,37
13,89,26,125,113,118,-5
13,89,26,161,65,61,4
13,89,26,163,218,184,34
13,89,27,53,103,153,-50
13,89,27,123,61,107,-46
13,89,28,47,0,66,-66
13,89,28,49,91,0,91
13,89,29,95,56,0,56
13,89,29,189,163,112,51
13,89,29,510,64,0,64
13,89,32,3,223,223,0
13,89,34,3,87,57,30
13,89,34,13,208,90,118
13,89,34,17,114,76,38
13,89,34,23,129,0,129
13,89,34,39,86,0,86
13,89,36,5,265,125,140
13,89,36,29,122,100,22
13,89,36,47,602,318,284
13,89,36,55,86,0,86
13,89,36,59,141,71,70
13,89,36,61,343,297,46
13,89,36,67,78,0,78
13,89,36,81,389,168,221
13,89,36,103,128,0,128
13,89,36,119,145,87,58
13,89,37,21,68,152,-84
13,89,37,51,59,93,-34
13,89,37,63,112,117,-5
13,89,37,67,86,65,21
13,89,37,81,125,141,-16
13,89,37,119,450,486,-36
13,89,37,129,62,0,62
13,89,37,133,63,0,63
13,89,37,183,221,246,-25
13,89,39,17,0,66,-66
13,89,39,35,129,171,-42
13,89,39,49,276,298,-22
13,89,39,61,181,169,12
13,89,39,113,67,67,0
13,89,39,153,0,97,-97
13,89,41,51,58,85,-27
13,89,42,3,173,178,-5
13,89,42,91,67,80,-13
13,89,42,101,214,213,1
13,89,44,7,65,0,65
13,89,45,3,57,0,57
13,89,45,13,85,75,10
13,89,45,19,189,198,-9
13,89,45,45,201,139,62
13,89,45,51,52,59,-7
13,89,45,63,51,0,51
13,89,45,79,185,157,28
13,89,45,83,0,52,-52
13,89,45,91,59,0,59
13,89,47,37,387,288,99
13,89,47,65,138,160,-22
13,89,47,93,114,190,-76
13,89,47,125,61,0,61
13,89,47,149,71,0,71
13,89,47,157,312,222,90
13,89,47,187,0,59,-59
13,89,48,29,114,104,10
13,89,48,85,90,125,-35
13,89,48,113,383,395,-12
13,89,48,121,65,84,-19
13,89,48,157,69,0,69
13,89,48,201,431,435,-4
13,89,48,439,172,207,-35
13,89,48,453,269,153,116
13,89,49,35,47,55,-8
13,89,51,13,56,68,-12
13,89,51,41,73,0,73
13,89,51,59,196,156,40
13,89,51,87,117,76,41
13,89,51,107,75,65,10
13,89,51,153,62,0,62
13,89,51,510,56,0,56
13,89,51,700,73,0,73
13,89,51,710,105,55,50
13,89,51,760,69,0,69
13,89,51,810,73,72,1
13,89,53,33,236,352,-116
13,89,53,53,56,62,-6
13,89,55,25,54,59,-5
13,89,55,79,136,131,5
13,91,13,23,128,188,-60
13,91,13,153,95,120,-25
13,91,13,175,83,121,-38
13,91,13,271,134,149,-15
13,93,13,81,198,193,5
13,93,13,153,0,172,-172
13,95,12,31,76,164,-88
13,95,12,57,0,63,-63
13,95,12,73,0,85,-85
13,95,12,86,64,0,64
13,95,13,7,71,0,71
13,95,13,21,57,72,-15
13,95,13,51,0,81,-81
13,95,13,63,82,140,-58
13,95,13,67,86,133,-47
13,95,13,71,97,109,-12
13,95,13,89,85,190,-105
13,95,13,121,148,188,-40
13,95,13,135,107,117,-10
13,95,13,151,0,108,-108
13,95,13,153,60,134,-74
13,95,13,177,1030,1570,-540
13,95,13,185,0,85,-85
13,95,13,205,273,281,-8
13,95,13,215,76,157,-81
13,95,13,261,81,104,-23
13,95,13,273,204,197,7
13,95,13,275,63,0,63
13,95,13,277,84,61,23
13,95,13,321,311,242,69
13,97,1,15,0,72,-72
13,97,1,73,62,51,11
13,97,4,13,0,65,-65
13,97,6,37,104,0,104
13,97,12,11,147,82,65
13,97,12,57,62,81,-19
13,97,12,86,109,0,109
13,97,12,95,66,0,66
13,97,12,99,70,0,70
13,97,13,15,80,88,-8
13,97,13,45,1410,2034,-624
13,97,13,51,0,70,-70
13,97,13,57,142,143,-1
13,97,13,63,656,472,184
13,97,13,67,4242,2955,1287
13,97,13,77,135,189,-54
13,97,13,89,736,636,100
13,97,13,113,76,134,-58
13,97,13,117,0,98,-98
13,97,13,121,2579,2152,427
13,97,13,135,435,548,-113
13,97,13,143,121,273,-152
13,97,13,151,223,241,-18
13,97,13,215,70,0,70
13,97,13,217,56,68,-12
13,97,13,223,1597,1796,-199
13,97,13,233,0,76,-76
13,97,13,247,90,62,28
13,97,17,31,102,0,102
13,97,36,47,92,0,92
13,97,36,81,84,0,84
13,99,1,69,0,84,-84
13,99,13,37,92,0,92
13,101,13,185,171,144,27
13,103,13,29,359,266,93
13,103,13,31,287,403,-116
13,103,13,51,3048,1548,1500
13,103,13,179,91,98,-7
13,103,13,251,84,81,3
13,103,45,13,164,96,68
13,103,45,53,83,0,83
13,105,13,59,136,111,25
13,105,13,119,74,71,3
13,105,13,147,189,223,-34
13,105,13,195,85,72,13
13,107,13,31,116,184,-68
13,107,13,43,73,76,-3
13,107,13,167,0,74,-74
13,107,13,175,68,75,-7
13,107,13,279,115,80,35
13,109,13,31,136,118,18
13,109,13,51,66,0,66
13,109,13,267,126,128,-2
13,111,13,57,69,62,7
13,111,13,67,126,0,126
13,111,13,89,50,0,50
13,111,13,121,89,0,89
13,111,13,123,138,131,7
13,111,13,135,58,0,58
13,111,13,291,128,195,-67
13,111,47,139,99,140,-41
13,113,6,37,241,84,157
13,113,12,11,83,0,83
13,113,12,86,64,0,64
13,113,12,95,67,0,67
13,113,13,51,80,0,80
13,113,13,57,0,121,-121
13,113,13,59,0,59,-59
13,113,13,63,1398,837,561
13,113,13,67,371,424,-53
13,113,13,77,1412,2221,-809
13,113,13,89,368,375,-7
13,113,13,97,134,76,58
13,113,13,117,0,124,-124
13,113,13,121,1700,1425,275
13,113,13,135,218,247,-29
13,113,13,151,611,503,108
13,113,13,199,0,97,-97
13,113,13,223,62,0,62
13,113,13,231,0,103,-103
13,113,13,255,210,335,-125
13,113,17,31,94,0,94
13,113,26,125,0,91,-91
13,113,48,201,0,67,-67
13,115,1,19,139,201,-62
13,115,13,15,767,549,218
13,115,13,45,75,0,75
13,115,13,55,211,251,-40
13,115,13,57,91,111,-20
13,115,13,67,251,241,10
13,115,13,89,0,61,-61
13,115,13,121,138,153,-15
13,115,13,129,388,365,23
13,115,13,135,93,83,10
13,115,13,223,200,116,84
13,115,13,233,758,635,123
13,115,13,313,0,73,-73
13,115,47,65,0,100,-100
13,117,1,73,84,0,84
13,117,4,13,137,118,19
13,117,6,1,69,0,69
13,117,6,37,162,67,95
13,117,6,59,82,0,82
13,117,6,65,64,0,64
13,117,6,73,76,0,76
13,117,12,5,0,51,-51
13,117,12,11,236,81,155
13,117,12,31,0,69,-69
13,117,12,57,107,91,16
13,117,12,86,98,0,98
13,117,12,95,120,67,53
13,117,12,99,93,77,16
13,117,12,103,0,67,-67
13,117,12,109,80,0,80
13,117,13,13,92,150,-58
13,117,13,15,0,66,-66
13,117,13,57,871,1241,-370
13,117,13,59,81,84,-3
13,117,13,63,67,0,67
13,117,13,67,1355,727,628
13,117,13,77,0,89,-89
13,117,13,85,769,1193,-424
13,117,13,89,1257,605,652
13,117,13,97,98,0,98
13,117,13,113,124,0,124
13,117,13,121,7495,3699,3796
13,117,13,123,0,75,-75
13,117,13,135,3504,2122,1382
13,117,13,139,929,1142,-213
13,117,13,151,171,0,171
13,117,13,157,102,134,-32
13,117,13,187,302,484,-182
13,117,13,215,59,0,59
13,117,13,217,84,0,84
13,117,13,223,127,78,49
13,117,13,227,96,196,-100
13,117,13,297,0,55,-55
13,117,13,311,69,97,-28
13,117,17,31,163,0,163
13,117,17,113,86,0,86
13,117,34,23,96,0,96
13,117,36,81,75,0,75
13,117,37,119,80,95,-15
13,117,37,183,80,79,1
13,117,47,65,68,62,6
13,117,48,85,0,118,-118
13,117,48,113,70,72,-2
13,117,48,201,115,73,42
13,117,51,59,76,0,76
13,117,53,33,67,79,-12
13,119,13,11,90,66,24
13,119,13,59,61,71,-10
13,119,13,105,71,74,-3
13,119,13,135,118,0,118
13,119,13,137,0,68,-68
13,119,13,139,71,0,71
13,119,13,147,408,488,-80
13,119,13,157,235,124,111
13,119,13,195,0,86,-86
13,119,13,257,300,268,32
13,121,1,3,59,73,-14
13,121,1,69,60,0,60
13,121,1,73,616,448,168
13,121,1,81,208,140,68
13,121,1,89,234,138,96
13,121,1,97,169,112,57
13,121,1,101,268,107,161
13,121,1,113,67,0,67
13,121,1,117,192,93,99
13,121,1,125,152,60,92
13,121,4,13,521,429,92
13,121,4,19,61,65,-4
13,121,5,7,80,0,80
13,121,5,119,89,61,28
13,121,6,1,297,316,-19
13,121,6,13,178,123,55
13,121,6,37,1356,1157,199
13,121,6,59,343,367,-24
13,121,6,65,129,120,9
13,121,6,67,81,135,-54
13,121,6,71,107,101,6
13,121,6,73,354,378,-24
13,121,6,75,238,352,-114
13,121,6,81,80,174,-94
13,121,6,85,332,491,-159
13,121,6,111,66,0,66
13,121,8,5,102,131,-29
13,121,8,13,47,62,-15
13,121,8,31,202,365,-163
13,121,8,35,0,69,-69
13,121,8,41,64,84,-20
13,121,8,59,0,76,-76
13,121,9,1,245,123,122
13,121,9,3,196,86,110
13,121,9,9,144,64,80
13,121,10,3,110,80,30
13,121,11,1,495,449,46
13,121,12,1,259,96,163
13,121,12,5,114,90,24
13,121,12,9,146,156,-10
13,121,12,11,1039,630,409
13,121,12,19,77,0,77
13,121,12,21,93,97,-4
13,121,12,31,583,469,114
13,121,12,33,160,105,55
13,121,12,57,725,571,154
13,121,12,61,48,0,48
13,121,12,69,68,79,-11
13,121,12,71,184,139,45
13,121,12,73,267,132,135
13,121,12,81,90,183,-93
13,121,12,83,0,57,-57
13,121,12,86,1063,532,531
13,121,12,89,0,65,-65
13,121,12,91,73,115,-42
13,121,12,95,642,459,183
13,121,12,97,98,67,31
13,121,12,99,619,430,189
13,121,12,101,77,73,4
13,121,12,103,296,342,-46
13,121,12,105,114,118,-4
13,121,12,109,129,192,-63
13,121,12,111,101,90,11
13,121,12,115,138,153,-15
13,121,12,117,208,164,44
13,121,12,127,129,108,21
13,121,12,131,83,196,-113
13,121,13,9,77,60,17
13,121,13,13,94,137,-43
13,121,13,15,177,215,-38
13,121,13,21,329,297,32
13,121,13,31,99,57,42
13,121,13,35,0,63,-63
13,121,13,45,352,263,89
13,121,13,51,620,477,143
13,121,13,57,2102,3794,-1692
13,121,13,59,501,388,113
13,121,13,63,9364,11224,-1860
13,121,13,67,13504,14865,-1361
13,121,13,73,197,111,86
13,121,13,77,1239,1282,-43
13,121,13,85,66,193,-127
13,121,13,89,22591,22741,-150
13,121,13,95,188,148,40
13,121,13,97,2152,2579,-427
13,121,13,111,0,89,-89
13,121,13,113,1425,1700,-275
13,121,13,115,153,138,15
13,121,13,117,3699,7495,-3796
13,121,13,123,0,94,-94
13,121,13,127,171,165,6
13,121,13,133,0,101,-101
13,121,13,135,9455,9535,-80
13,121,13,137,0,52,-52
13,121,13,139,487,596,-109
13,121,13,151,2086,2259,-173
13,121,13,153,244,156,88
13,121,13,157,119,142,-23
13,121,13,179,104,0,104
13,121,13,185,146,104,42
13,121,13,187,76,126,-50
13,121,13,199,82,71,11
13,121,13,215,464,296,168
13,121,13,217,451,563,-112
13,121,13,219,94,76,18
13,121,13,223,700,801,-101
13,121,13,227,69,183,-114
13,121,13,237,0,82,-82
13,121,13,241,0,82,-82
13,121,13,245,257,262,-5
13,121,13,247,717,533,184
13,121,13,255,201,289,-88
13,121,13,275,56,0,56
13,121,13,285,219,116,103
13,121,13,291,0,63,-63
13,121,13,297,187,189,-2
13,121,13,313,58,0,58
13,121,15,3,121,102,19
13,121,17,19,63,0,63
13,121,17,31,1385,1069,316
13,121,17,43,214,144,70
13,121,17,89,71,0,71
13,121,17,97,145,72,73
13,121,17,143,58,0,58
13,121,17,197,155,53,102
13,121,18,57,82,0,82
13,121,18,89,85,0,85
13,121,18,97,185,144,41
13,121,18,141,0,52,-52
13,121,20,91,88,66,22
13,121,21,67,100,66,34
13,121,21,111,253,139,114
13,121,22,33,150,0,150
13,121,22,51,160,69,91
13,121,22,71,195,217,-22
13,121,24,3,143,85,58
13,121,24,5,217,114,103
13,121,24,27,78,82,-4
13,121,24,31,328,249,79
13,121,24,33,361,204,157
13,121,24,510,194,149,45
13,121,25,9,87,81,6
13,121,25,17,344,304,40
13,121,25,21,137,98,39
13,121,25,23,65,0,65
13,121,25,25,237,202,35
13,121,25,27,84,52,32
13,121,26,65,53,0,53
13,121,26,77,53,0,53
13,121,26,81,65,0,65
13,121,26,99,74,0,74
13,121,26,125,283,183,100
13,121,26,161,102,93,9
13,121,26,163,336,190,146
13,121,27,53,304,185,119
13,121,27,123,61,64,-3
13,121,28,49,138,68,70
13,121,28,89,66,0,66
13,121,29,95,95,58,37
13,121,29,189,238,152,86
13,121,29,510,131,69,62
13,121,31,55,120,61,59
13,121,32,3,288,296,-8
13,121,32,31,0,62,-62
13,121,34,3,232,105,127
13,121,34,5,62,0,62
13,121,34,7,66,0,66
13,121,34,13,251,113,138
13,121,34,17,220,205,15
13,121,34,21,92,58,34
13,121,34,23,291,144,147
13,121,34,25,63,61,2
13,121,34,27,111,64,47
13,121,34,35,82,0,82
13,121,34,39,90,0,90
13,121,35,1,61,67,-6
13,121,36,1,58,0,58
13,121,36,5,276,122,154
13,121,36,29,111,80,31
13,121,36,47,722,478,244
13,121,36,55,136,117,19
13,121,36,59,255,93,162
13,121,36,61,924,948,-24
13,121,36,67,83,0,83
13,121,36,81,424,211,213
13,121,36,103,252,87,165
13,121,36,119,248,110,138
13,121,37,21,118,130,-12
13,121,37,51,117,103,14
13,121,37,63,147,193,-46
13,121,37,67,138,81,57
13,121,37,81,280,83,197
13,121,37,119,941,794,147
13,121,37,129,65,58,7
13,121,37,133,62,0,62
13,121,37,135,90,0,90
13,121,37,183,584,412,172
13,121,39,35,284,189,95
13,121,39,49,253,193,60
13,121,39,61,214,153,61
13,121,39,113,90,0,90
13,121,39,153,100,0,100
13,121,39,165,85,0,85
13,121,40,109,100,59,41
13,121,40,143,48,0,48
13,121,41,51,93,199,-106
13,121,41,67,78,77,1
13,121,42,3,279,216,63
13,121,42,17,61,0,61
13,121,42,29,99,64,35
13,121,42,43,68,0,68
13,121,42,45,71,71,0
13,121,42,91,122,124,-2
13,121,42,101,335,278,57
13,121,44,7,74,0,74
13,121,45,3,82,0,82
13,121,45,7,52,0,52
13,121,45,13,126,204,-78
13,121,45,15,91,108,-17
13,121,45,19,309,356,-47
13,121,45,35,48,58,-10
13,121,45,45,285,314,-29
13,121,45,51,66,0,66
13,121,45,63,78,74,4
13,121,45,73,0,63,-63
13,121,45,77,62,0,62
13,121,45,79,310,197,113
13,121,45,83,71,0,71
13,121,45,91,47,69,-22
13,121,47,37,607,553,54
13,121,47,65,274,279,-5
13,121,47,93,235,171,64
13,121,47,125,53,108,-55
13,121,47,149,90,80,10
13,121,47,157,500,261,239
13,121,47,187,136,151,-15
13,121,47,189,0,51,-51
13,121,48,27,71,74,-3
13,121,48,29,211,155,56
13,121,48,85,299,353,-54
13,121,48,113,617,625,-8
13,121,48,121,148,158,-10
13,121,48,157,113,122,-9
13,121,48,201,879,613,266
13,121,48,339,0,50,-50
13,121,48,439,273,267,6
13,121,48,453,475,368,107
13,121,48,491,0,66,-66
13,121,49,35,109,136,-27
13,121,51,3,62,0,62
13,121,51,13,175,130,45
13,121,51,41,94,0,94
13,121,51,59,358,307,51
13,121,51,87,150,97,53
13,121,51,107,147,110,37
13,121,51,153,74,101,-27
13,121,51,510,111,122,-11
13,121,51,710,60,75,-15
13,121,51,760,99,90,9
13,121,51,810,185,66,119
13,121,53,33,461,753,-292
13,121,53,53,77,57,20
13,121,53,61,97,58,39
13,121,55,25,114,50,64
13,121,55,79,210,110,100
13,123,13,57,228,225,3
13,123,13,67,182,75,107
13,123,13,111,131,138,-7
13,123,13,117,75,0,75
13,123,13,121,94,0,94
13,123,13,213,0,102,-102
13,123,13,227,253,202,51
13,127,12,31,141,294,-153
13,127,12,86,62,0,62
13,127,12,89,0,55,-55
13,127,12,109,0,59,-59
13,127,13,25,188,367,-179
13,127,13,39,266,397,-131
13,127,13,51,199,318,-119
13,127,13,59,0,59,-59
13,127,13,67,123,80,43
13,127,13,89,102,107,-5
13,127,13,121,165,171,-6
13,127,13,135,77,74,3
13,127,13,179,0,110,-110
13,127,13,185,70,0,70
13,127,13,191,286,373,-87
13,127,13,229,0,72,-72
13,127,13,245,0,58,-58
13,127,13,299,100,83,17
13,127,13,305,167,169,-2
13,129,13,15,860,687,173
13,129,13,47,0,80,-80
13,129,13,57,93,82,11
13,129,13,67,166,91,75
13,129,13,115,365,388,-23
13,129,13,213,259,230,29
13,129,13,227,105,94,11
13,129,13,313,425,466,-41
13,131,12,73,99,138,-39
13,131,13,87,90,121,-31
13,131,13,205,118,89,29
13,131,13,275,394,375,19
13,133,13,59,63,105,-42
13,133,13,67,87,0,87
13,133,13,121,101,0,101
13,133,13,135,111,0,111
13,133,13,211,114,98,16
13,133,13,237,153,135,18
13,135,1,3,0,62,-62
13,135,1,73,196,185,11
13,135,1,81,137,101,36
13,135,1,89,140,145,-5
13,135,1,97,117,90,27
13,135,1,101,157,95,62
13,135,1,117,108,83,25
13,135,4,13,276,319,-43
13,135,4,19,57,62,-5
13,135,5,119,60,0,60
13,135,6,1,120,84,36
13,135,6,13,66,71,-5
13,135,6,37,765,400,365
13,135,6,59,369,161,208
13,135,6,65,144,120,24
13,135,6,67,78,82,-4
13,135,6,71,128,114,14
13,135,6,73,196,176,20
13,135,6,75,0,65,-65
13,135,6,85,168,110,58
13,135,8,1,0,65,-65
13,135,8,5,78,83,-5
13,135,8,31,0,78,-78
13,135,8,35,0,113,-113
13,135,8,41,110,114,-4
13,135,9,1,135,70,65
13,135,9,3,135,0,135
13,135,9,9,123,65,58
13,135,10,3,91,0,91
13,135,11,1,71,81,-10
13,135,12,1,117,57,60
13,135,12,5,105,153,-48
13,135,12,9,121,155,-34
13,135,12,11,903,490,413
13,135,12,15,0,54,-54
13,135,12,19,83,77,6
13,135,12,31,374,359,15
13,135,12,33,103,104,-1
13,135,12,57,471,348,123
13,135,12,69,73,96,-23
13,135,12,71,191,159,32
13,135,12,73,104,91,13
13,135,12,81,85,111,-26
13,135,12,83,0,74,-74
13,135,12,86,955,380,575
13,135,12,91,0,86,-86
13,135,12,95,499,464,35
13,135,12,97,86,94,-8
13,135,12,99,438,264,174
13,135,12,101,84,132,-48
13,135,12,103,213,238,-25
13,135,12,105,136,139,-3
13,135,12,109,58,215,-157
13,135,12,111,71,66,5
13,135,12,113,0,67,-67
13,135,12,115,0,81,-81
13,135,12,117,179,142,37
13,135,12,127,100,160,-60
13,135,13,9,0,61,-61
13,135,13,11,0,86,-86
13,135,13,13,1739,4280,-2541
13,135,13,15,122,189,-67
13,135,13,21,224,218,6
13,135,13,31,101,0,101
13,135,13,45,169,181,-12
13,135,13,51,398,321,77
13,135,13,57,609,1077,-468
13,135,13,59,634,654,-20
13,135,13,63,1472,1361,111
13,135,13,67,3486,3805,-319
13,135,13,73,195,182,13
13,135,13,77,212,269,-57
13,135,13,85,0,193,-193
13,135,13,89,17820,12644,5176
13,135,13,95,117,107,10
13,135,13,97,548,435,113
13,135,13,111,0,58,-58
13,135,13,113,247,218,29
13,135,13,115,83,93,-10
13,135,13,117,2122,3504,-1382
13,135,13,119,0,118,-118
13,135,13,121,9535,9455,80
13,135,13,127,74,77,-3
13,135,13,133,0,111,-111
13,135,13,137,106,192,-86
13,135,13,139,2650,4461,-1811
13,135,13,147,0,148,-148
13,135,13,151,873,880,-7
13,135,13,153,198,158,40
13,135,13,157,759,2366,-1607
13,135,13,185,118,75,43
13,135,13,187,60,96,-36
13,135,13,195,0,57,-57
13,135,13,211,0,112,-112
13,135,13,215,277,193,84
13,135,13,217,671,992,-321
13,135,13,219,123,290,-167
13,135,13,223,240,421,-181
13,135,13,227,0,166,-166
13,135,13,237,0,77,-77
13,135,13,241,0,61,-61
13,135,13,245,215,224,-9
13,135,13,247,859,1048,-189
13,135,13,255,65,178,-113
13,135,13,257,0,90,-90
13,135,13,285,84,0,84
13,135,13,291,0,82,-82
13,135,13,297,1753,3876,-2123
13,135,13,311,54,107,-53
13,135,13,313,0,58,-58
13,135,15,3,117,85,32
13,135,17,31,636,278,358
13,135,17,43,117,85,32
13,135,17,97,107,0,107
13,135,17,197,122,0,122
13,135,18,89,57,0,57
13,135,18,97,121,123,-2
13,135,21,111,166,76,90
13,135,22,33,62,0,62
13,135,22,51,130,0,130
13,135,22,71,0,66,-66
13,135,24,3,116,87,29
13,135,24,5,100,76,24
13,135,24,27,72,0,72
13,135,24,31,171,170,1
13,135,24,33,212,171,41
13,135,24,510,77,71,6
13,135,25,9,73,0,73
13,135,25,17,142,71,71
13,135,25,25,145,72,73
13,135,25,27,93,0,93
13,135,26,99,74,0,74
13,135,26,125,123,67,56
13,135,26,163,175,149,26
13,135,27,53,121,100,21
13,135,28,47,68,65,3
13,135,28,49,103,0,103
13,135,29,189,156,84,72
13,135,32,3,241,237,4
13,135,34,3,250,56,194
13,135,34,5,63,0,63
13,135,34,13,195,70,125
13,135,34,17,87,0,87
13,135,34,23,177,76,101
13,135,34,31,129,0,129
13,135,34,35,62,0,62
13,135,34,39,97,0,97
13,135,36,5,384,144,240
13,135,36,29,80,88,-8
13,135,36,47,596,238,358
13,135,36,55,84,0,84
13,135,36,59,322,56,266
13,135,36,61,320,150,170
13,135,36,81,705,268,437
13,135,36,85,72,0,72
13,135,36,103,300,70,230
13,135,36,119,177,61,116
13,135,37,21,0,63,-63
13,135,37,51,84,86,-2
13,135,37,63,98,90,8
13,135,37,67,77,69,8
13,135,37,71,0,72,-72
13,135,37,81,184,73,111
13,135,37,119,369,347,22
13,135,37,133,74,79,-5
13,135,37,183,229,248,-19
13,135,39,35,165,125,40
13,135,39,49,203,125,78
13,135,39,61,92,71,21
13,135,39,113,72,0,72
13,135,40,143,57,0,57
13,135,42,3,123,77,46
13,135,42,29,0,57,-57
13,135,42,45,74,71,3
13,135,42,91,110,0,110
13,135,42,101,182,126,56
13,135,44,7,105,0,105
13,135,45,7,0,81,-81
13,135,45,13,91,106,-15
13,135,45,15,89,70,19
13,135,45,19,145,126,19
13,135,45,45,184,206,-22
13,135,45,51,73,93,-20
13,135,45,63,92,65,27
13,135,45,73,0,73,-73
13,135,45,79,149,162,-13
13,135,45,83,77,131,-54
13,135,45,91,76,66,10
13,135,47,37,220,183,37
13,135,47,65,185,226,-41
13,135,47,93,143,104,39
13,135,47,125,88,66,22
13,135,47,149,74,120,-46
13,135,47,157,256,129,127
13,135,48,27,103,59,44
13,135,48,29,136,210,-74
13,135,48,85,164,147,17
13,135,48,113,259,262,-3
13,135,48,121,105,159,-54
13,135,48,157,102,78,24
13,135,48,201,445,418,27
13,135,48,439,153,200,-47
13,135,48,453,163,120,43
13,135,51,41,0,62,-62
13,135,51,59,211,122,89
13,135,51,87,66,65,1
13,135,51,107,0,84,-84
13,135,51,153,106,0,106
13,135,51,550,56,0,56
13,135,51,700,70,0,70
13,135,51,710,80,55,25
13,135,51,810,106,0,106
13,135,53,33,142,231,-89
13,135,53,53,71,94,-23
13,135,53,61,0,74,-74
13,135,55,79,129,0,129
13,137,13,11,378,255,123
13,137,13,119,68,0,68
13,137,13,121,52,0,52
13,137,13,135,192,106,86
13,137,13,139,439,368,71
13,137,13,157,62,67,-5
13,137,13,241,68,74,-6
13,137,13,257,282,304,-22
13,137,13,311,372,355,17
13,139,6,37,59,0,59
13,139,6,73,53,0,53
13,139,12,31,0,63,-63
13,139,12,86,101,0,101
13,139,12,95,53,0,53
13,139,12,99,76,0,76
13,139,13,11,232,422,-190
13,139,13,13,555,646,-91
13,139,13,51,76,0,76
13,139,13,57,120,156,-36
13,139,13,59,183,202,-19
13,139,13,63,112,0,112
13,139,13,67,344,308,36
13,139,13,85,263,241,22
13,139,13,89,450,372,78
13,139,13,117,1142,929,213
13,139,13,119,0,71,-71
13,139,13,121,596,487,109
13,139,13,135,4461,2650,1811
13,139,13,137,368,439,-71
13,139,13,151,84,0,84
13,139,13,157,949,1427,-478
13,139,13,187,476,426,50
13,139,13,217,59,0,59
13,139,13,241,0,67,-67
13,139,13,257,66,73,-7
13,139,13,297,159,117,42
13,139,13,311,473,563,-90
13,139,48,201,99,0,99
13,141,13,9,109,154,-45
13,143,1,29,80,99,-19
13,143,13,45,996,945,51
13,143,13,67,105,46,59
13,143,13,97,273,121,152
13,143,13,223,381,171,210
13,143,13,233,113,127,-14
13,145,1,81,163,133,30
13,145,1,113,137,112,25
13,145,13,77,54,0,54
13,145,13,199,88,77,11
13,145,13,215,1770,1214,556
13,145,13,285,319,215,104
13,147,13,59,62,74,-12
13,147,13,105,223,189,34
13,147,13,119,488,408,80
13,147,13,135,148,0,148
13,147,13,157,79,0,79
13,147,13,257,80,99,-19
13,147,45,7,78,147,-69
13,149,13,45,192,178,14
13,149,13,77,192,175,17
13,149,13,285,198,175,23
13,151,1,73,66,0,66
13,151,4,13,0,51,-51
13,151,6,37,134,67,67
13,151,6,73,85,0,85
13,151,12,11,254,112,142
13,151,12,31,87,111,-24
13,151,12,57,111,87,24
13,151,12,86,210,78,132
13,151,12,95,154,109,45
13,151,12,99,69,0,69
13,151,13,9,56,0,56
13,151,13,21,329,177,152
13,151,13,31,65,0,65
13,151,13,35,509,930,-421
13,151,13,45,72,63,9
13,151,13,51,166,112,54
13,151,13,57,76,192,-116
13,151,13,59,63,63,0
13,151,13,63,7221,4274,2947
13,151,13,67,721,815,-94
13,151,13,77,312,518,-206
13,151,13,89,2657,1506,1151
13,151,13,95,108,0,108
13,151,13,97,241,223,18
13,151,13,113,503,611,-108
13,151,13,117,0,171,-171
13,151,13,121,2259,2086,173
13,151,13,135,880,873,7
13,151,13,139,0,84,-84
13,151,13,153,243,166,77
13,151,13,159,81,192,-111
13,151,13,171,124,273,-149
13,151,13,185,105,0,105
13,151,13,199,0,56,-56
13,151,13,207,121,222,-101
13,151,13,215,150,62,88
13,151,13,217,551,602,-51
13,151,13,223,109,143,-34
13,151,13,231,68,252,-184
13,151,13,245,91,0,91
13,151,13,247,584,472,112
13,151,13,255,879,1366,-487
13,151,13,285,0,62,-62
13,151,13,293,77,83,-6
13,151,13,297,93,129,-36
13,151,15,3,77,0,77
13,151,17,31,157,64,93
13,151,24,33,69,0,69
13,151,26,163,68,0,68
13,151,32,3,62,0,62
13,151,34,13,79,0,79
13,151,36,5,130,0,130
13,151,36,47,196,0,196
13,151,36,59,62,0,62
13,151,36,81,139,0,139
13,151,36,103,54,0,54
13,151,37,119,81,0,81
13,151,48,201,84,71,13
13,151,48,439,78,0,78
13,153,1,89,0,70,-70
13,153,2,20,75,0,75
13,153,8,41,67,137,-70
13,153,12,5,93,0,93
13,153,12,11,120,0,120
13,153,12,31,82,85,-3
13,153,12,57,106,127,-21
13,153,12,86,89,0,89
13,153,12,91,96,117,-21
13,153,12,95,73,60,13
13,153,13,9,72,97,-25
13,153,13,21,1898,1554,344
13,153,13,23,155,114,41
13,153,13,31,58,0,58
13,153,13,51,130,124,6
13,153,13,57,57,70,-13
13,153,13,63,105,102,3
13,153,13,67,153,198,-45
13,153,13,79,156,247,-91
13,153,13,81,151,111,40
13,153,13,89,140,144,-4
13,153,13,91,120,95,25
13,153,13,93,172,0,172
13,153,13,95,134,60,74
13,153,13,121,156,244,-88
13,153,13,135,158,198,-40
13,153,13,151,166,243,-77
13,153,13,169,107,122,-15
13,153,13,175,161,73,88
13,153,13,179,67,0,67
13,153,13,185,105,83,22
13,153,13,193,232,147,85
13,153,13,207,143,155,-12
13,153,13,215,94,104,-10
13,153,13,225,1329,1232,97
13,153,13,235,189,187,2
13,153,13,245,0,64,-64
13,153,13,261,104,0,104
13,153,13,269,86,66,20
13,153,13,289,86,0,86
13,153,15,3,81,0,81
13,153,28,47,72,0,72
13,153,32,3,0,67,-67
13,153,48,29,96,160,-64
13,153,51,59,0,73,-73
13,155,13,17,264,177,87
13,155,13,69,0,65,-65
13,155,13,277,102,83,19
13,157,13,11,443,589,-146
13,157,13,13,932,747,185
13,157,13,57,0,55,-55
13,157,13,59,824,506,318
13,157,13,67,68,0,68
13,157,13,89,117,54,63
13,157,13,117,134,102,32
13,157,13,119,124,235,-111
13,157,13,121,142,119,23
13,157,13,135,2366,759,1607
13,157,13,137,67,62,5
13,157,13,139,1427,949,478
13,157,13,147,0,79,-79
13,157,13,195,229,251,-22
13,157,13,219,139,100,39
13,157,13,221,63,0,63
13,157,13,257,0,76,-76
13,157,13,297,134,114,20
13,159,13,35,73,91,-18
13,159,13,151,192,81,111
13,159,13,217,418,272,146
13,159,13,247,69,0,69
13,159,13,297,78,70,8
13,161,13,1,105,165,-60
13,161,13,69,89,58,31
13,161,13,271,113,62,51
13,163,13,33,0,70,-70
13,163,13,73,89,89,0
13,163,13,245,135,217,-82
13,165,13,31,95,170,-75
13,165,13,33,74,74,0
13,167,13,107,74,0,74
13,167,13,175,164,192,-28
13,169,13,9,167,114,53
13,169,13,21,859,809,50
13,169,13,153,122,107,15
13,169,13,207,81,59,22
13,169,13,289,80,85,-5
13,169,13,319,69,0,69
13,171,13,35,82,0,82
13,171,13,63,76,0,76
13,171,13,151,273,124,149
13,171,13,207,108,125,-17
13,171,13,231,139,98,41
13,171,13,255,398,264,134
13,171,13,293,114,123,-9
13,173,13,19,0,141,-141
13,173,13,185,437,399,38
13,175,13,9,0,56,-56
13,175,13,21,81,116,-35
13,175,13,23,0,69,-69
13,175,13,51,0,58,-58
13,175,13,91,121,83,38
13,175,13,107,75,68,7
13,175,13,153,73,161,-88
13,175,13,167,192,164,28
13,175,13,283,87,86,1
13,175,13,303,73,80,-7
13,177,13,95,1570,1030,540
13,177,13,261,88,103,-15
13,177,13,273,121,82,39
13,177,13,321,183,97,86
13,179,4,3,0,111,-111
13,179,6,37,62,0,62
13,179,6,71,136,0,136
13,179,6,73,57,0,57
13,179,8,41,264,325,-61
13,179,12,11,97,52,45
13,179,12,31,124,160,-36
13,179,12,57,69,113,-44
13,179,12,86,95,0,95
13,179,12,95,63,112,-49
13,179,13,29,407,365,42
13,179,13,31,55,135,-80
13,179,13,51,943,852,91
13,179,13,53,0,71,-71
13,179,13,67,0,74,-74
13,179,13,73,0,110,-110
13,179,13,89,0,73,-73
13,179,13,103,98,91,7
13,179,13,121,0,104,-104
13,179,13,127,110,0,110
13,179,13,153,0,67,-67
13,179,13,183,735,1113,-378
13,179,13,191,0,69,-69
13,179,13,215,170,177,-7
13,179,13,245,97,111,-14
13,179,13,267,87,119,-32
13,179,13,305,138,110,28
13,179,15,3,290,325,-35
13,179,20,61,224,132,92
13,179,21,47,113,0,113
13,179,29,169,0,127,-127
13,179,36,45,122,134,-12
13,179,37,51,182,237,-55
13,179,37,85,0,153,-153
13,179,40,31,111,106,5
13,179,45,79,98,142,-44
13,179,47,125,222,198,24
13,179,48,27,354,393,-39
13,179,48,29,105,146,-41
13,179,48,99,99,116,-17
13,179,48,141,353,344,9
13,179,48,201,77,0,77
13,179,51,59,79,95,-16
13,179,51,149,0,84,-84
13,179,53,53,232,266,-34
13,181,13,73,157,102,55
13,181,13,245,81,0,81
13,183,13,29,90,0,90
13,183,13,51,91,148,-57
13,183,13,179,1113,735,378
13,183,13,267,137,90,47
13,183,13,305,92,97,-5
13,185,4,13,0,55,-55
13,185,4,19,87,118,-31
13,185,8,41,82,98,-16
13,185,12,1,55,73,-18
13,185,12,11,113,56,57
13,185,12,23,62,0,62
13,185,12,31,144,256,-112
13,185,12,47,116,86,30
13,185,12,57,112,130,-18
13,185,12,73,76,105,-29
13,185,12,79,95,134,-39
13,185,12,86,167,0,167
13,185,12,91,0,103,-103
13,185,12,95,105,97,8
13,185,12,99,68,0,68
13,185,12,103,61,69,-8
13,185,12,105,87,0,87
13,185,13,19,311,332,-21
13,185,13,21,0,62,-62
13,185,13,27,623,527,96
13,185,13,51,57,109,-52
13,185,13,59,0,54,-54
13,185,13,63,91,89,2
13,185,13,67,88,116,-28
13,185,13,69,0,74,-74
13,185,13,71,186,96,90
13,185,13,75,369,358,11
13,185,13,89,75,139,-64
13,185,13,95,85,0,85
13,185,13,101,144,171,-27
13,185,13,121,104,146,-42
13,185,13,127,0,70,-70
13,185,13,135,75,118,-43
13,185,13,151,0,105,-105
13,185,13,153,83,105,-22
13,185,13,173,399,437,-38
13,185,13,275,102,103,-1
13,185,13,277,175,122,53
13,185,13,299,76,0,76
13,185,32,3,0,71,-71
13,185,35,1,74,0,74
13,185,48,29,73,62,11
13,187,13,57,0,58,-58
13,187,13,67,58,0,58
13,187,13,85,380,271,109
13,187,13,117,484,302,182
13,187,13,121,126,76,50
13,187,13,135,96,60,36
13,187,13,139,426,476,-50
13,187,13,311,157,200,-43
13,189,13,73,380,400,-20
13,189,13,245,212,298,-86
13,189,13,301,177,169,8
13,191,13,51,83,60,23
13,191,13,127,373,286,87
13,191,13,179,69,0,69
13,193,13,153,147,232,-85
13,193,13,225,0,63,-63
13,193,13,261,0,66,-66
13,195,13,11,71,75,-4
13,195,13,13,71,0,71
13,195,13,59,823,532,291
13,195,13,105,72,85,-13
13,195,13,119,86,0,86
13,195,13,135,57,0,57
13,195,13,157,251,229,22
13,195,13,219,115,133,-18
13,195,13,221,224,226,-2
13,197,13,215,158,150,8
13,199,13,77,473,369,104
13,199,13,113,97,0,97
13,199,13,121,71,82,-11
13,199,13,145,77,88,-11
13,199,13,151,56,0,56
13,199,13,215,92,79,13
13,199,13,263,81,79,2
13,199,13,285,260,382,-122
13,201,13,87,115,102,13
13,201,13,253,120,0,120
13,205,13,71,86,89,-3
13,205,13,95,281,273,8
13,205,13,131,89,118,-29
13,205,13,275,121,157,-36
13,207,13,21,871,688,183
13,207,13,35,124,84,40
13,207,13,151,222,121,101
13,207,13,153,155,143,12
13,207,13,169,59,81,-22
13,207,13,171,125,108,17
13,207,13,255,73,0,73
13,207,13,293,0,56,-56
13,209,13,279,345,303,42
13,211,13,59,79,92,-13
13,211,13,133,98,114,-16
13,211,13,135,112,0,112
13,211,13,217,221,166,55
13,211,13,219,79,79,0
13,211,13,237,95,101,-6
13,211,13,247,103,0,103
13,211,13,297,238,159,79
13,213,13,15,0,82,-82
13,213,13,47,109,96,13
13,213,13,123,102,0,102
13,213,13,129,230,259,-29
13,213,13,313,1322,1282,40
13,213,47,11,55,65,-10
13,213,47,65,72,81,-9
13,215,1,73,0,116,-116
13,215,1,81,900,1132,-232
13,215,1,89,0,82,-82
13,215,1,101,101,111,-10
13,215,1,113,2042,2256,-214
13,215,2,20,93,80,13
13,215,2,90,130,76,54
13,215,4,13,0,70,-70
13,215,6,37,72,59,13
13,215,6,71,150,95,55
13,215,6,73,58,0,58
13,215,8,41,415,311,104
13,215,12,5,80,60,20
13,215,12,11,87,59,28
13,215,12,31,106,120,-14
13,215,12,57,114,85,29
13,215,12,86,91,0,91
13,215,12,91,0,78,-78
13,215,12,95,63,0,63
13,215,13,21,82,54,28
13,215,13,51,198,124,74
13,215,13,53,642,502,140
13,215,13,63,187,215,-28
13,215,13,67,199,287,-88
13,215,13,73,0,72,-72
13,215,13,77,119,151,-32
13,215,13,89,222,246,-24
13,215,13,95,157,76,81
13,215,13,97,0,70,-70
13,215,13,117,0,59,-59
13,215,13,121,296,464,-168
13,215,13,135,193,277,-84
13,215,13,145,1214,1770,-556
13,215,13,151,62,150,-88
13,215,13,153,104,94,10
13,215,13,179,177,170,7
13,215,13,197,150,158,-8
13,215,13,199,79,92,-13
13,215,13,245,66,0,66
13,215,13,259,119,0,119
13,215,13,261,78,0,78
13,215,13,263,117,100,17
13,215,13,285,244,153,91
13,215,15,3,269,210,59
13,215,17,31,81,0,81
13,215,20,61,90,110,-20
13,215,20,161,0,94,-94
13,215,22,115,116,73,43
13,215,32,3,0,66,-66
13,215,36,45,207,185,22
13,215,36,47,56,0,56
13,215,36,71,53,0,53
13,215,37,51,333,256,77
13,215,37,85,0,79,-79
13,215,37,119,0,51,-51
13,215,37,125,0,105,-105
13,215,37,183,0,68,-68
13,215,45,79,0,115,-115
13,215,47,37,0,50,-50
13,215,47,125,335,226,109
13,215,48,27,374,323,51
13,215,48,29,126,162,-36
13,215,48,99,95,121,-26
13,215,48,141,325,274,51
13,215,48,201,77,85,-8
13,215,48,439,0,63,-63
13,215,53,53,245,212,33
13,215,53,67,0,72,-72
13,217,12,11,78,0,78
13,217,12,86,74,0,74
13,217,13,13,0,107,-107
13,217,13,35,100,161,-61
13,217,13,57,0,80,-80
13,217,13,59,0,98,-98
13,217,13,63,357,271,86
13,217,13,67,230,219,11
13,217,13,89,1824,1216,608
13,217,13,97,68,56,12
13,217,13,117,0,84,-84
13,217,13,121,563,451,112
13,217,13,135,992,671,321
13,217,13,139,0,59,-59
13,217,13,151,602,551,51
13,217,13,159,272,418,-146
13,217,13,211,166,221,-55
13,217,13,237,78,0,78
13,217,13,247,2527,2034,493
13,217,13,255,0,80,-80
13,217,13,297,829,879,-50
13,217,36,47,116,0,116
13,217,36,81,71,0,71
13,219,13,13,279,261,18
13,219,13,59,1430,880,550
13,219,13,67,71,63,8
13,219,13,89,76,60,16
13,219,13,121,76,94,-18
13,219,13,135,290,123,167
13,219,13,157,100,139,-39
13,219,13,195,133,115,18
13,219,13,211,79,79,0
13,219,13,221,75,66,9
13,219,13,297,202,133,69
13,221,13,59,516,328,188
13,221,13,157,0,63,-63
13,221,13,195,226,224,2
13,221,13,219,66,75,-9
13,223,6,37,73,0,73
13,223,12,11,118,0,118
13,223,12,31,75,64,11
13,223,12,86,98,0,98
13,223,13,15,545,750,-205
13,223,13,45,753,902,-149
13,223,13,57,949,628,321
13,223,13,63,197,134,63
13,223,13,67,8020,4248,3772
13,223,13,77,101,61,40
13,223,13,89,337,246,91
13,223,13,97,1796,1597,199
13,223,13,113,0,62,-62
13,223,13,115,116,200,-84
13,223,13,117,78,127,-49
13,223,13,121,801,700,101
13,223,13,135,421,240,181
13,223,13,143,171,381,-210
13,223,13,151,143,109,34
13,223,13,233,315,676,-361
13,223,17,31,79,0,79
13,223,36,103,73,0,73
13,225,13,21,354,306,48
13,225,13,79,173,185,-12
13,225,13,153,1232,1329,-97
13,225,13,193,63,0,63
13,227,13,15,76,79,-3
13,227,13,57,947,801,146
13,227,13,67,243,117,126
13,227,13,85,66,67,-1
13,227,13,89,64,0,64
13,227,13,117,196,96,100
13,227,13,121,183,69,114
13,227,13,123,202,253,-51
13,227,13,129,94,105,-11
13,227,13,135,166,0,166
13,229,13,25,161,163,-2
13,229,13,127,72,0,72
13,229,13,299,589,489,100
13,231,13,77,97,63,34
13,231,13,113,103,0,103
13,231,13,151,252,68,184
13,231,13,171,98,139,-41
13,231,13,255,571,397,174
13,231,13,293,166,186,-20
13,233,1,19,0,78,-78
13,233,13,15,339,281,58
13,233,13,45,130,99,31
13,233,13,67,161,86,75
13,233,13,97,76,0,76
13,233,13,115,635,758,-123
13,233,13,143,127,113,14
13,233,13,223,676,315,361
13,235,13,23,0,94,-94
13,235,13,153,187,189,-2
13,235,13,315,65,0,65
13,237,13,9,273,286,-13
13,237,13,21,73,80,-7
13,237,13,121,82,0,82
13,237,13,133,135,153,-18
13,237,13,135,77,0,77
13,237,13,211,101,95,6
13,237,13,217,0,78,-78
13,237,13,297,90,0,90
13,239,1,5,0,101,-101
13,241,13,121,82,0,82
13,241,13,135,61,0,61
13,241,13,137,74,68,6
13,241,13,139,67,0,67
13,241,37,113,108,121,-13
13,245,1,73,0,67,-67
13,245,4,3,75,69,6
13,245,4,13,0,63,-63
13,245,6,37,56,0,56
13,245,6,53,195,0,195
13,245,6,73,65,92,-27
13,245,8,41,161,110,51
13,245,12,11,151,0,151
13,245,12,31,95,146,-51
13,245,12,33,102,0,102
13,245,12,57,88,109,-21
13,245,12,86,126,0,126
13,245,12,95,103,59,44
13,245,13,21,68,56,12
13,245,13,31,137,83,54
13,245,13,33,788,612,176
13,245,13,51,210,157,53
13,245,13,59,88,50,38
13,245,13,63,101,135,-34
13,245,13,67,176,252,-76
13,245,13,73,3706,5801,-2095
13,245,13,89,250,295,-45
13,245,13,121,262,257,5
13,245,13,127,58,0,58
13,245,13,135,224,215,9
13,245,13,151,0,91,-91
13,245,13,153,64,0,64
13,245,13,163,217,135,82
13,245,13,179,111,97,14
13,245,13,181,0,81,-81
13,245,13,189,298,212,86
13,245,13,215,0,66,-66
13,245,13,301,67,0,67
13,245,13,303,59,0,59
13,245,15,3,122,194,-72
13,245,24,3,128,162,-34
13,245,36,45,0,86,-86
13,245,37,51,181,228,-47
13,245,37,119,97,167,-70
13,245,45,3,1389,1742,-353
13,245,45,15,0,63,-63
13,245,45,19,66,96,-30
13,245,45,37,163,190,-27
13,245,45,45,0,103,-103
13,245,45,63,124,88,36
13,245,45,79,271,265,6
13,245,47,125,85,91,-6
13,245,48,27,173,193,-20
13,245,48,29,158,179,-21
13,245,48,141,89,140,-51
13,245,48,201,105,97,8
13,245,48,451,63,0,63
13,245,51,59,60,103,-43
13,245,53,53,0,142,-142
13,247,12,11,81,0,81
13,247,12,86,84,0,84
13,247,13,13,0,77,-77
13,247,13,63,395,325,70
13,247,13,67,204,283,-79
13,247,13,89,2859,1839,1020
13,247,13,97,62,90,-28
13,247,13,121,533,717,-184
13,247,13,135,1048,859,189
13,247,13,151,472,584,-112
13,247,13,159,0,69,-69
13,247,13,211,0,103,-103
13,247,13,217,2034,2527,-493
13,247,13,297,267,492,-225
13,247,36,47,73,0,73
13,247,36,81,78,0,78
13,249,13,261,100,126,-26
13,251,13,31,224,320,-96
13,251,13,51,97,0,97
13,251,13,103,81,84,-3
13,253,13,87,119,138,-19
13,253,13,201,0,120,-120
13,255,13,35,195,236,-41
13,255,13,63,687,515,172
13,255,13,67,96,0,96
13,255,13,77,200,225,-25
13,255,13,89,170,152,18
13,255,13,113,335,210,125
13,255,13,121,289,201,88
13,255,13,135,178,65,113
13,255,13,151,1366,879,487
13,255,13,171,264,398,-134
13,255,13,207,0,73,-73
13,255,13,217,80,0,80
13,255,13,231,397,571,-174
13,255,13,293,191,187,4
13,257,13,119,268,300,-32
13,257,13,135,90,0,90
13,257,13,137,304,282,22
13,257,13,139,73,66,7
13,257,13,147,99,80,19
13,257,13,157,76,0,76
13,257,13,311,79,0,79
13,257,45,73,0,63,-63
13,259,13,215,0,119,-119
13,261,13,81,0,66,-66
13,261,13,95,104,81,23
13,261,13,153,0,104,-104
13,261,13,177,103,88,15
13,261,13,193,66,0,66
13,261,13,215,0,78,-78
13,261,13,249,126,100,26
13,263,13,199,79,81,-2
13,263,13,215,100,117,-17
13,267,13,31,113,136,-23
13,267,13,51,60,67,-7
13,267,13,109,128,126,2
13,267,13,179,119,87,32
13,267,13,183,90,137,-47
13,267,13,279,153,166,-13
13,269,13,153,66,86,-20
13,271,13,91,149,134,15
13,271,13,161,62,113,-51
13,273,13,95,197,204,-7
13,273,13,177,82,121,-39
13,275,12,73,231,279,-48
13,275,13,27,122,151,-29
13,275,13,71,194,260,-66
13,275,13,95,0,63,-63
13,275,13,121,0,56,-56
13,275,13,131,375,394,-19
13,275,13,185,103,102,1
13,275,13,205,157,121,36
13,277,13,17,118,87,31
13,277,13,19,176,219,-43
13,277,13,71,168,220,-52
13,277,13,75,122,161,-39
13,277,13,95,61,84,-23
13,277,13,155,83,102,-19
13,277,13,185,122,175,-53
13,277,13,287,128,142,-14
13,277,13,321,187,147,40
13,279,13,31,70,72,-2
13,279,13,107,80,115,-35
13,279,13,209,303,345,-42
13,279,13,267,166,153,13
13,281,13,291,188,201,-13
13,281,37,43,74,89,-15
13,283,13,175,86,87,-1
13,285,1,17,396,499,-103
13,285,1,81,130,158,-28
13,285,1,111,70,0,70
13,285,13,45,72,104,-32
13,285,13,63,100,0,100
13,285,13,67,59,64,-5
13,285,13,77,629,419,210
13,285,13,89,68,63,5
13,285,13,121,116,219,-103
13,285,13,135,0,84,-84
13,285,13,145,215,319,-104
13,285,13,149,175,198,-23
13,285,13,151,62,0,62
13,285,13,199,382,260,122
13,285,13,215,153,244,-91
13,287,13,277,142,128,14
13,289,13,21,260,270,-10
13,289,13,153,0,86,-86
13,289,13,169,85,80,5
13,291,13,67,83,0,83
13,291,13,111,195,128,67
13,291,13,121,63,0,63
13,291,13,135,82,0,82
13,291,13,281,201,188,13
13,291,37,39,92,80,12
13,293,13,151,83,77,6
13,293,13,171,123,114,9
13,293,13,207,56,0,56
13,293,13,231,186,166,20
13,293,13,255,187,191,-4
13,295,13,47,1419,1557,-138
13,295,13,55,273,315,-42
13,295,13,83,153,120,33
13,295,13,313,268,204,64
13,295,47,11,97,98,-1
13,295,47,65,1506,1190,316
13,297,13,13,599,595,4
13,297,13,59,282,349,-67
13,297,13,63,53,0,53
13,297,13,67,92,99,-7
13,297,13,89,489,298,191
13,297,13,117,55,0,55
13,297,13,121,189,187,2
13,297,13,135,3876,1753,2123
13,297,13,139,117,159,-42
13,297,13,151,129,93,36
13,297,13,157,114,134,-20
13,297,13,159,70,78,-8
13,297,13,211,159,238,-79
13,297,13,217,879,829,50
13,297,13,219,133,202,-69
13,297,13,237,0,90,-90
13,297,13,247,492,267,225
13,299,12,31,98,79,19
13,299,13,5,67,0,67
13,299,13,25,212,222,-10
13,299,13,69,101,0,101
13,299,13,127,83,100,-17
13,299,13,185,0,76,-76
13,299,13,229,489,589,-100
13,301,13,189,169,177,-8
13,301,13,245,0,67,-67
13,303,13,9,68,70,-2
13,303,13,175,80,73,7
13,303,13,245,0,59,-59
13,305,13,1,106,79,27
13,305,13,25,83,0,83
13,305,13,51,63,0,63
13,305,13,127,169,167,2
13,305,13,179,110,138,-28
13,305,13,183,97,92,5
13,311,13,117,97,69,28
13,311,13,135,107,54,53
13,311,13,137,355,372,-17
13,311,13,139,563,473,90
13,311,13,187,200,157,43
13,311,13,257,0,79,-79
13,313,12,86,74,0,74
13,313,13,15,107,111,-4
13,313,13,47,416,518,-102
13,313,13,67,97,92,5
13,313,13,89,0,56,-56
13,313,13,115,73,0,73
13,313,13,121,0,58,-58
13,313,13,129,466,425,41
13,313,13,135,58,0,58
13,313,13,213,1282,1322,-40
13,313,13,295,204,268,-64
13,313,47,11,117,146,-29
13,313,47,65,317,424,-107
13,315,13,81,63,0,63
13,315,13,235,0,65,-65
13,319,13,9,174,187,-13
13,319,13,21,0,71,-71
13,319,13,169,0,69,-69
13,321,13,71,135,89,46
13,321,13,95,242,311,-69
13,321,13,177,97,183,-86
13,321,13,277,147,187,-40
15,1,2,20,80,67,13
15,1,2,170,55,0,55
15,1,4,13,186,208,-22
15,1,4,19,62,104,-42
15,1,6,1,88,47,41
15,1,6,13,88,0,88
15,1,6,37,283,235,48
15,1,6,59,230,145,85
15,1,6,65,130,103,27
15,1,6,67,89,114,-25
15,1,6,71,100,78,22
15,1,6,73,224,157,67
15,1,6,75,85,0,85
15,1,6,81,96,0,96
15,1,6,83,52,0,52
15,1,6,85,103,47,56
15,1,6,97,108,63,45
15,1,6,111,60,0,60
15,1,8,41,0,58,-58
15,1,8,69,60,0,60
15,1,15,3,1834,1585,249
15,1,15,7,196,121,75
15,1,15,9,450,340,110
15,1,32,3,250,481,-231
15,1,32,31,70,64,6
15,1,41,17,0,58,-58
15,1,41,39,55,50,5
15,1,41,51,142,151,-9
15,1,41,67,64,63,1
15,1,48,201,0,59,-59
15,1,49,35,61,95,-34
15,1,53,11,66,101,-35
15,1,53,33,253,242,11
15,1,53,53,89,148,-59
15,1,53,61,95,81,14
15,1,53,67,52,0,52
15,3,1,31,0,95,-95
15,3,1,45,140,83,57
15,3,1,89,0,94,-94
15,3,1,101,94,85,9
15,3,1,113,0,84,-84
15,3,2,20,453,338,115
15,3,2,90,190,114,76
15,3,2,170,73,74,-1
15,3,4,3,130,168,-38
15,3,4,13,672,985,-313
15,3,4,19,222,268,-46
15,3,4,21,67,100,-33
15,3,4,25,0,85,-85
15,3,4,27,0,82,-82
15,3,6,1,347,485,-138
15,3,6,13,254,295,-41
15,3,6,19,135,129,6
15,3,6,29,117,143,-26
15,3,6,31,0,77,-77
15,3,6,37,1854,1879,-25
15,3,6,41,55,0,55
15,3,6,53,371,263,108
15,3,6,59,717,858,-141
15,3,6,61,76,173,-97
15,3,6,65,464,654,-190
15,3,6,67,354,412,-58
15,3,6,71,619,621,-2
15,3,6,73,2389,2996,-607
15,3,6,75,301,289,12
15,3,6,77,112,155,-43
15,3,6,81,188,250,-62
15,3,6,83,130,143,-13
15,3,6,85,420,383,37
15,3,6,87,0,69,-69
15,3,6,95,160,149,11
15,3,6,97,82,87,-5
15,3,6,99,80,89,-9
15,3,6,111,216,263,-47
15,3,8,1,72,126,-54
15,3,8,5,166,264,-98
15,3,8,13,0,75,-75
15,3,8,31,158,227,-69
15,3,8,35,70,119,-49
15,3,8,41,1078,1171,-93
15,3,8,59,74,126,-52
15,3,8,69,83,86,-3
15,3,9,3,46,0,46
15,3,9,9,0,60,-60
15,3,9,11,419,255,164
15,3,10,1,54,0,54
15,3,11,1,196,171,25
15,3,12,5,70,104,-34
15,3,12,9,109,151,-42
15,3,12,11,174,160,14
15,3,12,19,107,99,8
15,3,12,31,402,382,20
15,3,12,33,242,180,62
15,3,12,57,223,342,-119
15,3,12,71,0,76,-76
15,3,12,81,0,60,-60
15,3,12,86,163,195,-32
15,3,12,91,149,171,-22
15,3,12,95,186,276,-90
15,3,12,97,51,83,-32
15,3,12,99,120,120,0
15,3,12,101,66,0,66
15,3,12,103,116,163,-47
15,3,12,105,88,0,88
15,3,12,109,0,90,-90
15,3,12,113,89,117,-28
15,3,12,117,0,68,-68
15,3,12,127,53,108,-55
15,3,13,39,103,115,-12
15,3,13,51,118,137,-19
15,3,13,53,76,0,76
15,3,13,67,0,100,-100
15,3,13,73,211,298,-87
15,3,13,89,98,79,19
15,3,13,121,102,121,-19
15,3,13,135,85,117,-32
15,3,13,151,0,77,-77
15,3,13,153,0,81,-81
15,3,13,179,325,290,35
15,3,13,215,210,269,-59
15,3,13,245,194,122,72
15,3,15,1,1585,1834,-249
15,3,15,7,570,543,27
15,3,15,9,1191,1224,-33
15,3,16,1,95,138,-43
15,3,17,31,437,313,124
15,3,17,43,86,68,18
15,3,17,97,105,120,-15
15,3,17,163,140,124,16
15,3,18,97,81,118,-37
15,3,19,153,0,69,-69
15,3,20,61,278,250,28
15,3,20,91,0,59,-59
15,3,20,103,219,208,11
15,3,20,161,134,106,28
15,3,20,173,0,87,-87
15,3,21,47,214,130,84
15,3,21,93,104,209,-105
15,3,21,111,0,68,-68
15,3,22,115,172,154,18
15,3,24,3,506,729,-223
15,3,24,5,100,89,11
15,3,24,17,0,93,-93
15,3,24,25,78,0,78
15,3,24,27,103,182,-79
15,3,24,31,270,285,-15
15,3,24,33,143,189,-46
15,3,25,9,52,71,-19
15,3,25,17,125,160,-35
15,3,25,21,61,48,13
15,3,25,25,50,62,-12
15,3,25,27,58,0,58
15,3,26,81,60,0,60
15,3,26,99,65,72,-7
15,3,26,125,62,58,4
15,3,26,163,67,78,-11
15,3,27,53,98,76,22
15,3,27,123,0,57,-57
15,3,28,47,90,91,-1
15,3,29,95,0,83,-83
15,3,29,169,295,273,22
15,3,29,189,119,96,23
15,3,31,55,0,80,-80
15,3,31,153,105,101,4
15,3,32,3,1131,3432,-2301
15,3,32,31,65,242,-177
15,3,34,3,87,0,87
15,3,34,5,108,129,-21
15,3,34,23,0,55,-55
15,3,35,1,98,81,17
15,3,36,29,78,0,78
15,3,36,45,464,417,47
15,3,36,47,203,151,52
15,3,36,59,54,75,-21
15,3,36,61,174,179,-5
15,3,36,67,0,56,-56
15,3,36,71,70,70,0
15,3,36,81,189,176,13
15,3,36,91,109,0,109
15,3,36,103,90,115,-25
15,3,37,49,70,98,-28
15,3,37,51,641,660,-19
15,3,37,81,0,74,-74
15,3,37,85,146,196,-50
15,3,37,93,88,79,9
15,3,37,119,72,159,-87
15,3,37,125,0,111,-111
15,3,37,133,451,427,24
15,3,37,183,75,132,-57
15,3,39,35,82,81,1
15,3,39,49,86,100,-14
15,3,39,57,0,78,-78
15,3,39,113,102,59,43
15,3,40,31,322,255,67
15,3,40,109,115,133,-18
15,3,41,5,88,188,-100
15,3,41,17,0,69,-69
15,3,41,29,62,0,62
15,3,41,39,105,134,-29
15,3,41,47,69,129,-60
15,3,41,51,216,458,-242
15,3,41,67,169,375,-206
15,3,42,3,91,76,15
15,3,42,41,0,97,-97
15,3,42,101,83,73,10
15,3,44,5,144,108,36
15,3,45,13,124,92,32
15,3,45,15,170,178,-8
15,3,45,19,99,98,1
15,3,45,45,0,67,-67
15,3,45,79,253,290,-37
15,3,45,85,0,103,-103
15,3,47,37,0,58,-58
15,3,47,93,0,63,-63
15,3,47,125,526,437,89
15,3,47,157,101,113,-12
15,3,48,27,878,878,0
15,3,48,29,695,1184,-489
15,3,48,85,108,171,-63
15,3,48,91,0,62,-62
15,3,48,99,174,258,-84
15,3,48,113,209,258,-49
15,3,48,121,75,136,-61
15,3,48,141,944,976,-32
15,3,48,157,0,68,-68
15,3,48,187,0,165,-165
15,3,48,201,316,490,-174
15,3,48,339,53,120,-67
15,3,48,355,0,111,-111
15,3,48,439,253,346,-93
15,3,48,451,150,83,67
15,3,48,453,159,317,-158
15,3,48,491,77,203,-126
15,3,49,11,105,183,-78
15,3,49,35,304,501,-197
15,3,49,49,279,405,-126
15,3,49,53,0,80,-80
15,3,49,57,0,73,-73
15,3,51,13,156,162,-6
15,3,51,41,75,88,-13
15,3,51,59,566,880,-314
15,3,51,107,80,114,-34
15,3,51,149,96,115,-19
15,3,51,153,226,344,-118
15,3,51,179,92,188,-96
15,3,51,199,117,147,-30
15,3,51,510,121,154,-33
15,3,51,550,185,276,-91
15,3,51,650,99,168,-69
15,3,51,700,200,229,-29
15,3,51,710,233,174,59
15,3,51,740,0,48,-48
15,3,51,800,0,102,-102
15,3,51,810,526,506,20
15,3,53,9,0,52,-52
15,3,53,11,164,392,-228
15,3,53,29,120,270,-150
15,3,53,33,957,1335,-378
15,3,53,35,474,802,-328
15,3,53,53,1171,1384,-213
15,3,53,57,0,65,-65
15,3,53,61,244,420,-176
15,3,53,63,121,221,-100
15,3,53,67,305,440,-135
15,3,53,73,61,89,-28
15,3,55,25,0,64,-64
15,7,4,13,84,99,-15
15,7,6,37,132,92,40
15,7,6,59,112,71,41
15,7,6,65,71,0,71
15,7,6,73,168,123,45
15,7,15,1,121,196,-75
15,7,15,3,543,570,-27
15,7,15,9,126,119,7
15,7,32,3,76,142,-66
15,7,53,33,80,80,0
15,9,4,13,159,191,-32
15,9,6,1,127,85,42
15,9,6,13,110,53,57
15,9,6,37,381,239,142
15,9,6,59,228,169,59
15,9,6,65,108,63,45
15,9,6,67,97,57,40
15,9,6,71,72,0,72
15,9,6,73,265,202,63
15,9,6,75,72,0,72
15,9,6,83,56,0,56
15,9,6,85,154,0,154
15,9,6,87,74,0,74
15,9,15,1,340,450,-110
15,9,15,3,1224,1191,33
15,9,15,7,119,126,-7
15,9,17,31,87,0,87
15,9,32,3,216,410,-194
15,9,41,5,117,0,117
15,9,41,17,0,61,-61
15,9,41,51,113,81,32
15,9,41,67,74,114,-40
15,9,48,201,66,0,66
15,9,49,35,48,73,-25
15,9,53,11,0,63,-63
15,9,53,33,176,251,-75
15,9,53,53,0,82,-82
15,9,53,61,65,0,65
15,9,53,63,0,66,-66
16,1,2,20,173,0,173
16,1,2,90,77,0,77
16,1,4,13,868,707,161
16,1,4,19,174,126,48
16,1,4,21,73,72,1
16,1,4,25,59,0,59
16,1,6,1,494,78,416
16,1,6,7,114,0,114
16,1,6,13,401,57,344
16,1,6,17,119,0,119
16,1,6,19,188,0,188
16,1,6,23,83,0,83
16,1,6,29,154,0,154
16,1,6,37,1203,235,968
16,1,6,41,68,0,68
16,1,6,53,87,0,87
16,1,6,55,69,0,69
16,1,6,59,1161,196,965
16,1,6,61,347,59,288
16,1,6,65,754,184,570
16,1,6,67,499,131,368
16,1,6,71,475,89,386
16,1,6,73,1008,225,783
16,1,6,75,75,0,75
16,1,6,77,209,0,209
16,1,6,79,128,0,128
16,1,6,81,130,58,72
16,1,6,83,85,0,85
16,1,6,85,657,190,467
16,1,6,87,86,0,86
16,1,6,89,166,0,166
16,1,6,95,119,0,119
16,1,6,97,285,0,285
16,1,6,99,167,0,167
16,1,6,107,73,0,73
16,1,6,111,271,73,198
16,1,8,1,105,63,42
16,1,8,5,138,53,85
16,1,8,13,52,0,52
16,1,8,31,165,91,74
16,1,8,35,84,88,-4
16,1,8,41,199,90,109
16,1,8,59,160,0,160
16,1,8,69,91,72,19
16,1,15,3,138,95,43
16,1,16,3,0,98,-98
16,1,16,5,409,272,137
16,1,16,11,99,80,19
16,1,16,13,225,185,40
16,1,16,15,354,478,-124
16,1,16,17,59,62,-3
16,1,16,19,479,382,97
16,1,16,27,7143,9262,-2119
16,1,16,31,94,92,2
16,1,16,39,676,625,51
16,1,16,45,445,642,-197
16,1,16,47,91,0,91
16,1,16,49,75,75,0
16,1,16,53,122,54,68
16,1,16,55,326,325,1
16,1,16,57,283,120,163
16,1,16,65,267,87,180
16,1,16,67,77,85,-8
16,1,16,69,128,108,20
16,1,16,73,120,168,-48
16,1,16,75,314,313,1
16,1,16,83,785,509,276
16,1,16,85,331,431,-100
16,1,16,87,111,113,-2
16,1,17,31,145,60,85
16,1,24,3,66,0,66
16,1,27,53,80,70,10
16,1,29,189,55,0,55
16,1,30,29,80,0,80
16,1,30,31,103,63,40
16,1,30,49,65,0,65
16,1,30,63,120,74,46
16,1,30,111,93,50,43
16,1,32,3,428,383,45
16,1,32,7,131,86,45
16,1,32,31,256,124,132
16,1,35,1,103,48,55
16,1,36,47,47,0,47
16,1,41,1,0,53,-53
16,1,41,3,78,0,78
16,1,41,5,217,153,64
16,1,41,17,243,156,87
16,1,41,29,91,61,30
16,1,41,39,187,102,85
16,1,41,41,0,83,-83
16,1,41,45,177,179,-2
16,1,41,47,130,104,26
16,1,41,51,432,292,140
16,1,41,59,57,59,-2
16,1,41,61,78,0,78
16,1,41,67,405,205,200
16,1,48,29,119,68,51
16,1,48,113,111,77,34
16,1,48,201,167,101,66
16,1,48,439,92,63,29
16,1,48,453,123,114,9
16,1,49,5,148,71,77
16,1,49,11,190,132,58
16,1,49,35,574,499,75
16,1,49,49,444,331,113
16,1,49,53,108,0,108
16,1,49,57,79,111,-32
16,1,53,5,173,99,74
16,1,53,11,380,175,205
16,1,53,29,86,0,86
16,1,53,33,1079,509,570
16,1,53,35,115,78,37
16,1,53,53,317,182,135
16,1,53,61,333,109,224
16,1,53,63,269,270,-1
16,1,53,67,113,0,113
16,1,53,73,91,69,22
16,1,53,75,66,0,66
16,1,53,77,78,46,32
16,3,16,1,98,0,98
16,3,16,85,62,77,-15
16,5,4,13,98,87,11
16,5,6,73,70,0,70
16,5,16,1,272,409,-137
16,5,16,11,637,541,96
16,5,16,19,479,507,-28
16,5,16,27,151,160,-9
16,5,16,29,67,111,-44
16,5,16,41,73,0,73
16,5,16,65,134,65,69
16,5,16,77,183,265,-82
16,5,16,83,145,140,5
16,5,49,5,108,123,-15
16,5,49,11,136,77,59
16,5,49,35,331,253,78
16,5,49,49,136,110,26
16,5,49,57,71,66,5
16,9,16,55,181,205,-24
16,9,53,63,75,68,7
16,11,16,1,80,99,-19
16,11,16,5,541,637,-96
16,11,16,19,1051,880,171
16,11,16,27,0,64,-64
16,11,16,51,134,112,22
16,11,16,65,130,0,130
16,11,16,77,89,100,-11
16,11,49,35,102,67,35
16,13,6,37,83,0,83
16,13,16,1,185,225,-40
16,13,16,83,76,101,-25
16,13,53,33,138,55,83
16,15,16,1,478,354,124
16,15,16,27,146,111,35
16,17,6,65,68,0,68
16,17,6,73,105,0,105
16,17,16,1,62,59,3
16,17,16,21,161,129,32
16,17,16,55,971,948,23
16,17,16,57,50,0,50
16,17,45,15,0,71,-71
16,17,53,33,103,66,37
16,17,53,51,169,142,27
16,17,53,53,94,0,94
16,17,53,61,64,0,64
16,17,53,63,375,333,42
16,19,4,13,171,211,-40
16,19,6,37,88,0,88
16,19,6,67,71,0,71
16,19,6,73,56,0,56
16,19,16,1,382,479,-97
16,19,16,5,507,479,28
16,19,16,11,880,1051,-171
16,19,16,27,163,131,32
16,19,16,43,192,175,17
16,19,16,51,1171,1264,-93
16,19,16,57,0,47,-47
16,19,16,65,836,394,442
16,19,16,81,77,78,-1
16,19,16,83,109,129,-20
16,19,32,3,157,156,1
16,19,49,5,148,84,64
16,19,49,11,135,167,-32
16,19,49,35,288,346,-58
16,19,49,49,326,291,35
16,19,49,53,90,97,-7
16,19,49,57,83,114,-31
16,19,53,33,96,63,33
16,19,56,39,79,0,79
16,21,16,17,129,161,-32
16,21,16,55,119,133,-14
16,21,53,63,0,58,-58
16,27,4,13,196,252,-56
16,27,6,1,99,0,99
16,27,6,7,84,0,84
16,27,6,13,124,0,124
16,27,6,19,69,0,69
16,27,6,29,70,0,70
16,27,6,37,356,64,292
16,27,6,59,151,0,151
16,27,6,61,94,0,94
16,27,6,65,318,62,256
16,27,6,67,255,0,255
16,27,6,71,201,0,201
16,27,6,73,313,92,221
16,27,6,77,80,0,80
16,27,6,85,158,0,158
16,27,6,89,76,0,76
16,27,6,97,127,0,127
16,27,6,99,167,0,167
16,27,6,107,76,0,76
16,27,16,1,9262,7143,2119
16,27,16,5,160,151,9
16,27,16,11,64,0,64
16,27,16,15,111,146,-35
16,27,16,19,131,163,-32
16,27,16,39,181,220,-39
16,27,16,45,354,407,-53
16,27,16,55,120,132,-12
16,27,16,57,65,86,-21
16,27,16,65,80,0,80
16,27,16,69,70,0,70
16,27,16,73,709,677,32
16,27,16,75,423,586,-163
16,27,16,83,231,190,41
16,27,16,85,82,151,-69
16,27,16,87,100,136,-36
16,27,32,3,195,137,58
16,27,32,7,76,0,76
16,27,32,31,72,0,72
16,27,41,5,110,0,110
16,27,41,17,73,52,21
16,27,41,39,65,79,-14
16,27,41,45,265,288,-23
16,27,41,47,79,0,79
16,27,41,51,144,70,74
16,27,41,67,151,63,88
16,27,49,11,90,0,90
16,27,49,35,234,131,103
16,27,49,49,132,107,25
16,27,53,5,0,78,-78
16,27,53,11,137,0,137
16,27,53,33,174,100,74
16,27,53,53,180,69,111
16,27,53,61,160,75,85
16,27,53,63,71,68,3
16,29,16,5,111,67,44
16,31,16,1,92,94,-2
16,31,16,67,689,774,-85
16,31,16,83,213,239,-26
16,35,16,69,149,164,-15
16,39,4,13,59,64,-5
16,39,16,1,625,676,-51
16,39,16,27,220,181,39
16,39,16,83,77,74,3
16,41,16,5,0,73,-73
16,41,49,5,392,352,40
16,43,16,19,175,192,-17
16,43,16,51,96,149,-53
16,43,16,65,339,329,10
16,45,16,1,642,445,197
16,45,16,27,407,354,53
16,45,16,75,0,89,-89
16,47,16,1,0,91,-91
16,47,16,53,269,252,17
16,47,16,83,293,340,-47
16,49,16,1,75,75,0
16,49,16,61,121,121,0
16,49,16,69,88,155,-67
16,51,16,11,112,134,-22
16,51,16,19,1264,1171,93
16,51,16,43,149,96,53
16,51,16,65,479,279,200
16,51,49,35,77,81,-4
16,51,49,49,0,73,-73
16,53,16,1,54,122,-68
16,53,16,47,252,269,-17
16,53,16,67,0,65,-65
16,53,16,83,876,835,41
16,55,2,20,76,0,76
16,55,2,170,88,0,88
16,55,4,13,267,263,4
16,55,4,19,0,61,-61
16,55,6,1,72,0,72
16,55,6,13,86,0,86
16,55,6,17,63,0,63
16,55,6,19,117,0,117
16,55,6,29,101,0,101
16,55,6,37,329,109,220
16,55,6,59,295,59,236
16,55,6,61,75,0,75
16,55,6,65,336,87,249
16,55,6,67,185,0,185
16,55,6,71,249,0,249
16,55,6,73,419,92,327
16,55,6,79,75,0,75
16,55,6,85,107,0,107
16,55,6,89,58,0,58
16,55,6,95,62,0,62
16,55,6,97,78,0,78
16,55,6,111,96,0,96
16,55,16,1,325,326,-1
16,55,16,9,205,181,24
16,55,16,17,948,971,-23
16,55,16,21,133,119,14
16,55,16,27,132,120,12
16,55,16,57,230,200,30
16,55,16,69,130,95,35
16,55,16,79,322,434,-112
16,55,30,29,86,76,10
16,55,30,31,56,0,56
16,55,30,63,119,79,40
16,55,30,111,62,0,62
16,55,32,3,138,76,62
16,55,32,31,49,0,49
16,55,38,105,0,58,-58
16,55,41,5,66,0,66
16,55,41,17,64,0,64
16,55,41,51,65,53,12
16,55,41,67,108,71,37
16,55,49,35,93,0,93
16,55,53,5,77,55,22
16,55,53,11,93,0,93
16,55,53,25,70,0,70
16,55,53,33,593,166,427
16,55,53,35,82,0,82
16,55,53,51,69,0,69
16,55,53,53,192,141,51
16,55,53,61,315,88,227
16,55,53,63,2331,2473,-142
16,55,53,65,0,74,-74
16,55,53,67,102,0,102
16,55,53,75,75,0,75
16,57,16,1,120,283,-163
16,57,16,17,0,50,-50
16,57,16,19,47,0,47
16,57,16,27,86,65,21
16,57,16,55,200,230,-30
16,57,16,69,219,305,-86
16,57,53,3,78,78,0
16,57,53,33,107,110,-3
16,57,53,63,84,232,-148
16,57,53,75,439,495,-56
16,61,16,49,121,121,0
16,61,16,69,62,101,-39
16,63,16,83,0,94,-94
16,65,4,13,111,316,-205
16,65,6,37,60,0,60
16,65,16,1,87,267,-180
16,65,16,5,65,134,-69
16,65,16,11,0,130,-130
16,65,16,19,394,836,-442
16,65,16,27,0,80,-80
16,65,16,43,329,339,-10
16,65,16,51,279,479,-200
16,65,32,3,62,96,-34
16,65,49,5,0,90,-90
16,65,49,11,77,216,-139
16,65,49,35,191,443,-252
16,65,49,49,285,591,-306
16,65,49,57,0,97,-97
16,67,16,1,85,77,8
16,67,16,31,774,689,85
16,67,16,53,65,0,65
16,67,16,83,175,211,-36
16,69,16,1,108,128,-20
16,69,16,27,0,70,-70
16,69,16,35,164,149,15
16,69,16,49,155,88,67
16,69,16,55,95,130,-35
16,69,16,57,305,219,86
16,69,16,61,101,62,39
16,69,53,3,820,872,-52
16,69,53,33,0,51,-51
16,69,53,63,92,140,-48
16,69,53,75,89,73,16
16,71,49,3,98,0,98
16,73,16,1,168,120,48
16,73,16,27,677,709,-32
16,75,16,1,313,314,-1
16,75,16,27,586,423,163
16,75,16,45,89,0,89
16,75,16,87,166,104,62
16,75,41,45,481,465,16
16,77,16,5,265,183,82
16,77,16,11,100,89,11
16,79,16,55,434,322,112
16,79,53,63,100,57,43
16,81,16,19,78,77,1
16,81,56,39,345,229,116
16,83,4,13,111,99,12
16,83,6,37,65,0,65
16,83,6,59,65,0,65
16,83,6,67,68,0,68
16,83,6,71,67,0,67
16,83,16,1,509,785,-276
16,83,16,5,140,145,-5
16,83,16,13,101,76,25
16,83,16,19,129,109,20
16,83,16,27,190,231,-41
16,83,16,31,239,213,26
16,83,16,39,74,77,-3
16,83,16,47,340,293,47
16,83,16,53,835,876,-41
16,83,16,63,94,0,94
16,83,16,67,211,175,36
16,83,32,3,111,98,13
16,83,32,7,88,137,-49
16,83,49,5,0,60,-60
16,83,49,35,127,133,-6
16,83,49,49,0,72,-72
16,83,53,33,65,81,-16
16,85,16,1,431,331,100
16,85,16,3,77,62,15
16,85,16,27,151,82,69
16,87,16,1,113,111,2
16,87,16,27,136,100,36
16,87,16,75,104,166,-62
16,87,41,45,0,102,-102
17,1,17,9,97,64,33
17,1,17,31,0,62,-62
17,1,17,67,189,93,96
17,1,17,109,60,64,-4
17,1,17,119,0,50,-50
17,1,17,149,142,79,63
17,1,17,167,61,108,-47
17,1,29,111,117,139,-22
17,1,29,127,198,286,-88
17,1,29,183,0,95,-95
17,1,29,189,0,57,-57
17,3,29,31,116,175,-59
17,5,17,27,86,104,-18
17,5,17,51,107,76,31
17,5,17,119,286,269,17
17,5,17,135,54,105,-51
17,7,17,31,429,254,175
17,7,17,37,148,116,32
17,7,17,43,95,71,24
17,7,17,89,364,220,144
17,7,17,97,60,0,60
17,7,17,111,615,344,271
17,7,17,141,69,69,0
17,7,17,201,1823,2018,-195
17,7,55,105,63,84,-21
17,7,55,127,81,0,81
17,9,17,1,64,97,-33
17,11,17,31,0,62,-62
17,11,17,73,106,123,-17
17,11,17,99,620,678,-58
17,11,17,103,62,72,-10
17,11,17,143,48,0,48
17,11,17,155,96,95,1
17,11,17,195,70,86,-16
17,13,17,83,66,74,-8
17,13,17,119,0,55,-55
17,15,17,85,51,52,-1
17,15,17,177,113,108,5
17,15,17,195,153,150,3
17,15,19,45,81,96,-15
17,17,17,137,160,155,5
17,17,17,167,121,161,-40
17,17,17,169,69,74,-5
17,19,4,13,72,177,-105
17,19,4,19,0,56,-56
17,19,6,1,0,131,-131
17,19,6,37,117,184,-67
17,19,6,59,52,59,-7
17,19,6,73,54,114,-60
17,19,6,75,0,69,-69
17,19,6,81,0,65,-65
17,19,6,85,46,321,-275
17,19,12,1,0,59,-59
17,19,12,103,0,75,-75
17,19,13,121,0,63,-63
17,19,17,29,198,126,72
17,19,17,31,1226,1562,-336
17,19,17,39,109,154,-45
17,19,17,41,296,345,-49
17,19,17,43,152,217,-65
17,19,17,53,268,292,-24
17,19,17,75,132,133,-1
17,19,17,77,79,0,79
17,19,17,89,101,78,23
17,19,17,91,90,80,10
17,19,17,97,95,134,-39
17,19,17,105,56,0,56
17,19,17,111,0,51,-51
17,19,17,113,412,414,-2
17,19,17,115,225,184,41
17,19,17,119,61,0,61
17,19,17,143,132,156,-24
17,19,17,147,360,442,-82
17,19,17,163,0,65,-65
17,19,17,167,193,173,20
17,19,17,179,75,42,33
17,19,17,183,715,606,109
17,19,17,197,135,126,9
17,19,17,201,0,68,-68
17,19,18,97,96,165,-69
17,19,18,157,89,62,27
17,19,25,17,52,124,-72
17,19,27,53,0,67,-67
17,19,29,189,0,113,-113
17,19,29,510,0,72,-72
17,19,36,61,0,62,-62
17,19,39,49,0,87,-87
17,19,41,51,0,45,-45
17,19,41,67,0,63,-63
17,19,42,101,0,46,-46
17,19,47,37,0,61,-61
17,19,48,201,0,97,-97
17,19,48,439,0,67,-67
17,19,48,453,0,96,-96
17,19,53,33,63,281,-218
17,19,55,25,87,96,-9
17,21,17,115,136,226,-90
17,21,17,117,0,61,-61
17,21,17,135,111,107,4
17,21,17,167,386,427,-41
17,21,17,173,171,208,-37
17,23,17,29,71,120,-49
17,23,17,33,87,0,87
17,23,17,35,93,0,93
17,23,17,45,100,109,-9
17,23,18,167,68,140,-72
17,25,17,49,101,94,7
17,25,17,159,104,0,104
17,25,17,191,108,108,0
17,27,17,5,104,86,18
17,27,17,81,0,56,-56
17,27,17,119,326,264,62
17,27,17,121,415,372,43
17,27,17,163,501,451,50
17,27,17,189,129,117,12
17,27,29,189,54,0,54
17,27,29,510,0,59,-59
17,29,17,19,126,198,-72
17,29,17,23,120,71,49
17,29,17,31,147,168,-21
17,29,17,35,209,215,-6
17,29,17,41,242,206,36
17,29,17,45,67,110,-43
17,29,17,49,116,88,28
17,29,17,115,62,65,-3
17,29,17,139,167,142,25
17,29,17,173,191,150,41
17,31,1,73,170,187,-17
17,31,1,89,98,149,-51
17,31,1,97,58,83,-25
17,31,1,101,0,66,-66
17,31,1,125,0,55,-55
17,31,2,20,80,76,4
17,31,4,13,2173,4978,-2805
17,31,4,19,408,506,-98
17,31,4,21,95,227,-132
17,31,4,25,48,117,-69
17,31,5,7,173,186,-13
17,31,5,119,158,169,-11
17,31,5,143,100,78,22
17,31,6,1,755,1227,-472
17,31,6,13,329,509,-180
17,31,6,19,100,139,-39
17,31,6,29,64,104,-40
17,31,6,37,3357,5435,-2078
17,31,6,41,122,162,-40
17,31,6,53,92,56,36
17,31,6,59,943,1298,-355
17,31,6,61,69,85,-16
17,31,6,65,373,632,-259
17,31,6,67,250,348,-98
17,31,6,71,295,353,-58
17,31,6,73,1294,2172,-878
17,31,6,75,1142,1767,-625
17,31,6,77,67,86,-19
17,31,6,81,350,660,-310
17,31,6,83,113,174,-61
17,31,6,85,844,1492,-648
17,31,6,87,0,94,-94
17,31,6,95,52,91,-39
17,31,6,97,87,100,-13
17,31,6,99,67,78,-11
17,31,6,111,208,222,-14
17,31,6,113,0,55,-55
17,31,8,1,113,248,-135
17,31,8,5,260,498,-238
17,31,8,13,178,492,-314
17,31,8,14,0,154,-154
17,31,8,31,818,2131,-1313
17,31,8,35,129,347,-218
17,31,8,37,0,108,-108
17,31,8,41,264,460,-196
17,31,8,59,180,548,-368
17,31,8,69,146,238,-92
17,31,8,117,0,60,-60
17,31,8,123,0,76,-76
17,31,9,1,410,360,50
17,31,9,3,287,254,33
17,31,9,9,257,216,41
17,31,9,11,67,0,67
17,31,10,3,155,179,-24
17,31,11,1,1324,1066,258
17,31,12,1,124,139,-15
17,31,12,5,63,45,18
17,31,12,9,125,224,-99
17,31,12,11,905,1148,-243
17,31,12,15,71,133,-62
17,31,12,17,0,47,-47
17,31,12,19,0,99,-99
17,31,12,21,315,683,-368
17,31,12,31,307,402,-95
17,31,12,33,54,88,-34
17,31,12,35,0,74,-74
17,31,12,53,0,104,-104
17,31,12,57,656,1151,-495
17,31,12,61,48,98,-50
17,31,12,69,82,230,-148
17,31,12,71,373,866,-493
17,31,12,73,132,115,17
17,31,12,81,135,362,-227
17,31,12,83,64,118,-54
17,31,12,85,0,92,-92
17,31,12,86,997,1155,-158
17,31,12,87,56,76,-20
17,31,12,91,0,66,-66
17,31,12,95,769,918,-149
17,31,12,97,181,274,-93
17,31,12,99,691,1044,-353
17,31,12,101,163,312,-149
17,31,12,103,443,879,-436
17,31,12,105,159,341,-182
17,31,12,109,82,173,-91
17,31,12,111,70,120,-50
17,31,12,113,0,83,-83
17,31,12,115,225,580,-355
17,31,12,117,180,300,-120
17,31,12,119,0,118,-118
17,31,12,127,176,255,-79
17,31,13,51,85,119,-34
17,31,13,57,0,82,-82
17,31,13,59,0,61,-61
17,31,13,63,135,210,-75
17,31,13,67,407,700,-293
17,31,13,89,518,672,-154
17,31,13,97,0,102,-102
17,31,13,113,0,94,-94
17,31,13,117,0,163,-163
17,31,13,121,1069,1385,-316
17,31,13,135,278,636,-358
17,31,13,151,64,157,-93
17,31,13,215,0,81,-81
17,31,13,223,0,79,-79
17,31,15,3,313,437,-124
17,31,15,9,0,87,-87
17,31,16,1,60,145,-85
17,31,17,1,62,0,62
17,31,17,7,254,429,-175
17,31,17,11,62,0,62
17,31,17,19,1562,1226,336
17,31,17,29,168,147,21
17,31,17,37,1102,1239,-137
17,31,17,43,25450,33032,-7582
17,31,17,63,349,527,-178
17,31,17,73,50,66,-16
17,31,17,75,66,100,-34
17,31,17,77,320,249,71
17,31,17,85,69,128,-59
17,31,17,89,8344,12487,-4143
17,31,17,91,924,1264,-340
17,31,17,93,986,1643,-657
17,31,17,95,88,119,-31
17,31,17,97,13744,19218,-5474
17,31,17,99,291,512,-221
17,31,17,103,75,112,-37
17,31,17,105,97,111,-14
17,31,17,109,187,119,68
17,31,17,111,3777,6746,-2969
17,31,17,113,821,805,16
17,31,17,115,186,257,-71
17,31,17,119,228,243,-15
17,31,17,141,77,157,-80
17,31,17,143,544,587,-43
17,31,17,161,337,301,36
17,31,17,163,193,229,-36
17,31,17,167,846,734,112
17,31,17,177,156,191,-35
17,31,17,179,137,138,-1
17,31,17,183,286,330,-44
17,31,17,195,77,89,-12
17,31,17,197,14053,22236,-8183
17,31,17,199,69,65,4
17,31,17,201,1248,1917,-669
17,31,18,3,322,475,-153
17,31,18,11,80,132,-52
17,31,18,35,66,64,2
17,31,18,39,170,278,-108
17,31,18,57,426,729,-303
17,31,18,63,73,144,-71
17,31,18,67,93,203,-110
17,31,18,73,0,92,-92
17,31,18,81,68,67,1
17,31,18,85,54,98,-44
17,31,18,89,7109,13201,-6092
17,31,18,91,316,570,-254
17,31,18,97,1287,1922,-635
17,31,18,105,336,246,90
17,31,18,111,0,93,-93
17,31,18,127,731,1422,-691
17,31,18,141,622,775,-153
17,31,18,149,0,92,-92
17,31,18,157,506,657,-151
17,31,18,163,101,86,15
17,31,18,167,0,118,-118
17,31,19,13,68,120,-52
17,31,19,45,94,92,2
17,31,19,49,71,97,-26
17,31,19,57,85,104,-19
17,31,19,61,284,278,6
17,31,19,103,519,503,16
17,31,19,113,320,356,-36
17,31,19,153,406,483,-77
17,31,19,163,247,367,-120
17,31,19,169,94,67,27
17,31,19,179,0,88,-88
17,31,20,45,73,50,23
17,31,20,91,354,458,-104
17,31,20,161,58,0,58
17,31,20,173,133,116,17
17,31,20,209,0,76,-76
17,31,21,15,49,62,-13
17,31,21,67,165,214,-49
17,31,21,111,503,482,21
17,31,21,117,0,71,-71
17,31,22,33,138,100,38
17,31,22,51,116,107,9
17,31,22,71,288,255,33
17,31,23,5,89,102,-13
17,31,24,3,113,114,-1
17,31,24,5,189,185,4
17,31,24,21,0,50,-50
17,31,24,27,136,105,31
17,31,24,31,472,535,-63
17,31,24,33,169,233,-64
17,31,24,510,335,272,63
17,31,25,1,48,64,-16
17,31,25,5,50,0,50
17,31,25,9,133,184,-51
17,31,25,13,66,0,66
17,31,25,15,61,50,11
17,31,25,17,975,1084,-109
17,31,25,21,320,348,-28
17,31,25,23,63,76,-13
17,31,25,25,911,804,107
17,31,25,27,150,144,6
17,31,26,5,75,177,-102
17,31,26,21,272,605,-333
17,31,26,25,100,54,46
17,31,26,27,0,99,-99
17,31,26,45,45,0,45
17,31,26,49,114,102,12
17,31,26,55,63,111,-48
17,31,26,65,311,248,63
17,31,26,75,48,56,-8
17,31,26,77,408,351,57
17,31,26,81,698,1036,-338
17,31,26,93,70,92,-22
17,31,26,99,299,388,-89
17,31,26,111,0,56,-56
17,31,26,121,83,129,-46
17,31,26,125,1240,1455,-215
17,31,26,139,185,321,-136
17,31,26,145,62,57,5
17,31,26,147,41,0,41
17,31,26,149,52,81,-29
17,31,26,159,122,140,-18
17,31,26,161,749,800,-51
17,31,26,163,919,973,-54
17,31,27,3,134,134,0
17,31,27,19,0,84,-84
17,31,27,37,160,280,-120
17,31,27,53,1676,2057,-381
17,31,27,109,125,142,-17
17,31,27,123,491,662,-171
17,31,27,137,0,78,-78
17,31,27,139,0,63,-63
17,31,27,145,50,0,50
17,31,27,163,93,128,-35
17,31,28,33,0,133,-133
17,31,28,49,89,94,-5
17,31,28,89,0,56,-56
17,31,29,19,292,214,78
17,31,29,47,98,95,3
17,31,29,51,71,65,6
17,31,29,77,80,67,13
17,31,29,95,429,410,19
17,31,29,165,0,64,-64
17,31,29,183,179,215,-36
17,31,29,189,855,897,-42
17,31,29,510,505,497,8
17,31,30,63,0,51,-51
17,31,31,55,338,367,-29
17,31,31,109,148,111,37
17,31,31,153,61,0,61
17,31,32,3,1300,2744,-1444
17,31,32,31,121,166,-45
17,31,33,9,65,0,65
17,31,33,11,88,107,-19
17,31,33,15,51,58,-7
17,31,34,3,278,266,12
17,31,34,5,69,52,17
17,31,34,7,72,88,-16
17,31,34,13,191,123,68
17,31,34,17,519,627,-108
17,31,34,21,141,124,17
17,31,34,23,313,355,-42
17,31,34,25,105,79,26
17,31,34,27,235,171,64
17,31,34,29,93,66,27
17,31,34,31,100,60,40
17,31,34,35,143,151,-8
17,31,34,39,112,114,-2
17,31,35,1,168,237,-69
17,31,35,49,48,127,-79
17,31,36,1,95,59,36
17,31,36,5,211,179,32
17,31,36,27,46,56,-10
17,31,36,29,224,212,12
17,31,36,47,1662,1428,234
17,31,36,55,249,201,48
17,31,36,59,272,159,113
17,31,36,61,2453,2821,-368
17,31,36,67,111,94,17
17,31,36,81,723,648,75
17,31,36,85,74,0,74
17,31,36,91,0,64,-64
17,31,36,103,222,187,35
17,31,36,109,91,65,26
17,31,36,119,317,303,14
17,31,37,21,80,177,-97
17,31,37,25,0,98,-98
17,31,37,51,112,155,-43
17,31,37,63,187,295,-108
17,31,37,67,91,84,7
17,31,37,81,108,138,-30
17,31,37,97,0,64,-64
17,31,37,119,593,1011,-418
17,31,37,129,51,56,-5
17,31,37,133,157,131,26
17,31,37,135,84,109,-25
17,31,37,183,374,649,-275
17,31,38,17,117,73,44
17,31,39,17,143,132,11
17,31,39,25,49,82,-33
17,31,39,35,814,947,-133
17,31,39,41,102,154,-52
17,31,39,49,1074,1179,-105
17,31,39,57,84,93,-9
17,31,39,61,805,708,97
17,31,39,85,0,65,-65
17,31,39,93,75,101,-26
17,31,39,95,226,167,59
17,31,39,99,57,0,57
17,31,39,103,54,0,54
17,31,39,113,214,277,-63
17,31,39,133,52,0,52
17,31,39,151,74,84,-10
17,31,39,153,174,228,-54
17,31,39,165,126,150,-24
17,31,39,173,61,97,-36
17,31,40,27,0,61,-61
17,31,40,109,174,196,-22
17,31,40,143,168,204,-36
17,31,41,5,72,79,-7
17,31,41,17,0,55,-55
17,31,41,29,0,58,-58
17,31,41,39,86,127,-41
17,31,41,51,449,769,-320
17,31,41,67,120,334,-214
17,31,42,3,603,561,42
17,31,42,17,151,84,67
17,31,42,27,85,47,38
17,31,42,29,106,162,-56
17,31,42,41,49,53,-4
17,31,42,43,64,0,64
17,31,42,45,138,101,37
17,31,42,49,61,61,0
17,31,42,71,51,97,-46
17,31,42,77,68,62,6
17,31,42,91,171,242,-71
17,31,42,95,57,56,1
17,31,42,101,727,762,-35
17,31,44,7,212,190,22
17,31,45,13,0,78,-78
17,31,45,15,0,64,-64
17,31,45,19,147,291,-144
17,31,45,45,146,171,-25
17,31,45,51,0,58,-58
17,31,45,63,0,84,-84
17,31,45,79,91,107,-16
17,31,45,83,0,80,-80
17,31,45,91,59,145,-86
17,31,46,99,0,78,-78
17,31,47,35,0,73,-73
17,31,47,37,632,1133,-501
17,31,47,65,100,138,-38
17,31,47,93,130,217,-87
17,31,47,125,101,226,-125
17,31,47,149,72,215,-143
17,31,47,157,568,751,-183
17,31,47,165,78,95,-17
17,31,47,187,93,347,-254
17,31,47,189,0,125,-125
17,31,48,27,142,201,-59
17,31,48,29,615,813,-198
17,31,48,39,80,89,-9
17,31,48,41,59,0,59
17,31,48,61,0,73,-73
17,31,48,85,493,1031,-538
17,31,48,113,1202,2088,-886
17,31,48,121,292,593,-301
17,31,48,141,188,203,-15
17,31,48,157,238,412,-174
17,31,48,167,0,66,-66
17,31,48,201,1812,2330,-518
17,31,48,209,50,102,-52
17,31,48,215,130,140,-10
17,31,48,309,0,65,-65
17,31,48,339,91,224,-133
17,31,48,355,51,60,-9
17,31,48,439,756,1132,-376
17,31,48,453,1084,1512,-428
17,31,48,479,63,0,63
17,31,48,491,147,438,-291
17,31,49,35,355,472,-117
17,31,49,49,108,88,20
17,31,50,7,77,58,19
17,31,51,3,59,71,-12
17,31,51,13,396,276,120
17,31,51,41,0,52,-52
17,31,51,59,613,576,37
17,31,51,87,128,146,-18
17,31,51,107,140,201,-61
17,31,51,153,78,110,-32
17,31,51,510,140,176,-36
17,31,51,540,57,54,3
17,31,51,700,0,51,-51
17,31,51,710,114,138,-24
17,31,51,760,161,109,52
17,31,51,810,153,176,-23
17,31,53,11,72,119,-47
17,31,53,33,1389,2546,-1157
17,31,53,35,60,93,-33
17,31,53,53,221,305,-84
17,31,53,61,136,248,-112
17,31,53,63,60,65,-5
17,31,53,67,70,98,-28
17,31,53,73,61,88,-27
17,31,55,9,264,339,-75
17,31,55,25,1302,1675,-373
17,31,55,27,57,0,57
17,31,55,29,0,100,-100
17,31,55,35,0,61,-61
17,31,55,39,74,195,-121
17,31,55,55,0,58,-58
17,31,55,59,493,1009,-516
17,31,55,63,77,93,-16
17,31,55,71,0,59,-59
17,31,55,73,61,74,-13
17,31,55,79,1962,2279,-317
17,31,55,85,0,51,-51
17,31,55,87,174,148,26
17,31,55,89,113,161,-48
17,31,55,97,55,56,-1
17,31,55,101,322,506,-184
17,31,55,105,153,259,-106
17,31,55,111,56,91,-35
17,31,55,117,90,99,-9
17,31,55,125,0,87,-87
17,31,55,127,254,571,-317
17,31,55,131,58,85,-27
17,31,55,133,466,643,-177
17,31,55,139,141,184,-43
17,33,17,23,0,87,-87
17,33,17,79,62,68,-6
17,33,17,101,93,96,-3
17,35,17,23,0,93,-93
17,35,17,29,215,209,6
17,35,17,49,95,158,-63
17,37,4,13,0,113,-113
17,37,17,7,116,148,-32
17,37,17,31,1239,1102,137
17,37,17,43,659,539,120
17,37,17,89,1922,1222,700
17,37,17,93,605,452,153
17,37,17,97,87,127,-40
17,37,17,99,460,420,40
17,37,17,103,109,162,-53
17,37,17,111,279,209,70
17,37,17,141,290,443,-153
17,37,17,197,233,207,26
17,37,17,201,243,387,-144
17,37,55,25,0,57,-57
17,39,17,19,154,109,45
17,39,17,113,227,263,-36
17,39,17,115,131,95,36
17,39,17,147,78,91,-13
17,41,17,19,345,296,49
17,41,17,29,206,242,-36
17,41,17,139,155,219,-64
17,41,17,147,0,91,-91
17,43,4,13,531,1294,-763
17,43,4,19,0,160,-160
17,43,4,21,0,74,-74
17,43,6,1,150,129,21
17,43,6,13,70,67,3
17,43,6,37,439,632,-193
17,43,6,59,155,333,-178
17,43,6,65,103,75,28
17,43,6,67,76,114,-38
17,43,6,71,62,101,-39
17,43,6,73,245,349,-104
17,43,6,75,60,133,-73
17,43,6,81,65,65,0
17,43,6,85,182,224,-42
17,43,8,1,0,53,-53
17,43,8,5,92,179,-87
17,43,8,13,0,114,-114
17,43,8,31,111,259,-148
17,43,8,35,0,140,-140
17,43,8,41,63,151,-88
17,43,8,59,0,150,-150
17,43,8,69,0,86,-86
17,43,9,1,90,0,90
17,43,9,3,72,0,72
17,43,11,1,67,73,-6
17,43,12,9,0,60,-60
17,43,12,11,185,146,39
17,43,12,15,0,50,-50
17,43,12,21,91,324,-233
17,43,12,31,0,104,-104
17,43,12,57,149,284,-135
17,43,12,69,0,65,-65
17,43,12,71,87,342,-255
17,43,12,81,0,136,-136
17,43,12,86,140,132,8
17,43,12,95,97,191,-94
17,43,12,97,0,67,-67
17,43,12,99,138,209,-71
17,43,12,101,0,111,-111
17,43,12,103,105,270,-165
17,43,12,105,0,65,-65
17,43,12,115,49,202,-153
17,43,12,117,0,67,-67
17,43,12,119,0,66,-66
17,43,12,127,0,50,-50
17,43,13,67,80,133,-53
17,43,13,89,0,77,-77
17,43,13,121,144,214,-70
17,43,13,135,85,117,-32
17,43,15,3,68,86,-18
17,43,17,7,71,95,-24
17,43,17,19,217,152,65
17,43,17,31,33032,25450,7582
17,43,17,37,539,659,-120
17,43,17,63,148,204,-56
17,43,17,77,49,0,49
17,43,17,89,5344,9295,-3951
17,43,17,91,98,122,-24
17,43,17,93,1496,2657,-1161
17,43,17,97,1214,1570,-356
17,43,17,99,178,221,-43
17,43,17,103,0,75,-75
17,43,17,111,691,1159,-468
17,43,17,113,233,170,63
17,43,17,141,76,70,6
17,43,17,143,144,123,21
17,43,17,161,0,78,-78
17,43,17,167,127,71,56
17,43,17,179,0,60,-60
17,43,17,197,7231,10194,-2963
17,43,17,201,268,360,-92
17,43,18,3,0,93,-93
17,43,18,57,74,227,-153
17,43,18,89,318,409,-91
17,43,18,97,157,186,-29
17,43,18,127,99,124,-25
17,43,18,141,58,100,-42
17,43,19,103,71,83,-12
17,43,19,153,75,97,-22
17,43,19,163,0,66,-66
17,43,20,91,113,118,-5
17,43,21,111,68,93,-25
17,43,24,31,80,80,0
17,43,25,17,115,95,20
17,43,25,25,61,52,9
17,43,26,21,72,144,-72
17,43,26,77,58,0,58
17,43,26,81,127,170,-43
17,43,26,99,69,71,-2
17,43,26,125,226,228,-2
17,43,26,139,0,105,-105
17,43,26,161,72,90,-18
17,43,26,163,117,160,-43
17,43,27,53,235,280,-45
17,43,27,123,89,63,26
17,43,29,19,75,63,12
17,43,29,95,65,54,11
17,43,29,183,78,0,78
17,43,29,189,165,168,-3
17,43,29,510,61,70,-9
17,43,31,55,102,57,45
17,43,32,3,149,418,-269
17,43,34,3,93,0,93
17,43,34,17,56,59,-3
17,43,34,23,106,106,0
17,43,36,47,120,71,49
17,43,36,61,149,101,48
17,43,36,81,124,65,59
17,43,37,119,124,219,-95
17,43,37,183,68,235,-167
17,43,39,35,100,134,-34
17,43,39,49,111,141,-30
17,43,39,61,100,101,-1
17,43,39,113,0,63,-63
17,43,39,153,0,74,-74
17,43,41,51,62,73,-11
17,43,41,67,0,61,-61
17,43,42,3,97,95,2
17,43,42,101,0,68,-68
17,43,45,19,0,89,-89
17,43,47,37,105,195,-90
17,43,47,93,0,66,-66
17,43,47,157,72,76,-4
17,43,47,187,0,148,-148
17,43,48,29,127,165,-38
17,43,48,85,156,426,-270
17,43,48,113,201,303,-102
17,43,48,121,67,166,-99
17,43,48,157,71,128,-57
17,43,48,201,300,313,-13
17,43,48,339,0,89,-89
17,43,48,439,119,215,-96
17,43,48,453,121,261,-140
17,43,48,491,0,144,-144
17,43,49,35,56,77,-21
17,43,51,59,128,124,4
17,43,51,107,0,79,-79
17,43,53,33,266,391,-125
17,43,53,53,54,0,54
17,43,53,61,69,0,69
17,43,55,25,199,321,-122
17,43,55,59,75,151,-76
17,43,55,79,271,329,-58
17,43,55,101,0,61,-61
17,43,55,105,0,50,-50
17,43,55,127,45,166,-121
17,43,55,133,110,152,-42
17,45,17,23,109,100,9
17,45,17,29,110,67,43
17,45,17,183,83,65,18
17,45,18,167,71,96,-25
17,47,17,185,60,0,60
17,47,17,191,59,55,4
17,47,17,193,88,85,3
17,49,17,25,94,101,-7
17,49,17,29,88,116,-28
17,49,17,35,158,95,63
17,49,17,51,245,188,57
17,49,17,79,92,121,-29
17,49,17,173,180,176,4
17,51,17,5,76,107,-31
17,51,17,49,188,245,-57
17,51,17,121,85,111,-26
17,51,17,173,0,60,-60
17,53,17,19,292,268,24
17,53,17,75,145,143,2
17,53,17,105,96,62,34
17,53,17,113,0,57,-57
17,55,17,65,76,0,76
17,55,17,77,140,129,11
17,55,17,81,212,144,68
17,55,17,145,126,94,32
17,55,17,165,61,85,-24
17,55,17,199,672,702,-30
17,57,17,95,94,145,-51
17,57,17,109,131,171,-40
17,57,17,125,74,78,-4
17,57,17,143,324,349,-25
17,57,17,179,142,148,-6
17,59,17,165,0,107,-107
17,59,17,193,0,69,-69
17,61,17,83,109,173,-64
17,61,17,117,0,145,-145
17,61,17,119,68,100,-32
17,61,17,137,116,123,-7
17,61,17,167,0,51,-51
17,63,17,31,527,349,178
17,63,17,43,204,148,56
17,63,17,89,76,0,76
17,63,17,91,128,100,28
17,63,17,93,304,232,72
17,63,17,99,269,378,-109
17,63,17,105,123,153,-30
17,63,17,197,2372,1614,758
17,65,17,55,0,76,-76
17,65,17,81,69,0,69
17,65,17,193,0,83,-83
17,67,17,1,93,189,-96
17,67,17,109,121,98,23
17,67,19,111,186,213,-27
17,69,17,165,0,58,-58
17,71,17,187,70,70,0
17,71,19,57,81,80,1
17,73,17,11,123,106,17
17,73,17,31,66,50,16
17,73,17,95,165,101,64
17,73,17,131,106,81,25
17,73,17,143,0,108,-108
17,73,17,161,1076,981,95
17,73,17,175,82,0,82
17,73,17,195,65,0,65
17,73,19,163,246,249,-3
17,75,17,19,133,132,1
17,75,17,31,100,66,34
17,75,17,53,143,145,-2
17,75,17,91,521,549,-28
17,75,17,183,109,95,14
17,77,17,19,0,79,-79
17,77,17,31,249,320,-71
17,77,17,43,0,49,-49
17,77,17,55,129,140,-11
17,77,17,145,168,171,-3
17,77,17,157,148,106,42
17,77,17,163,73,127,-54
17,77,17,167,57,69,-12
17,77,17,181,153,113,40
17,77,17,199,646,758,-112
17,77,29,189,0,91,-91
17,77,29,510,0,73,-73
17,77,47,37,0,45,-45
17,79,17,33,68,62,6
17,79,17,49,121,92,29
17,79,17,159,0,61,-61
17,81,17,27,56,0,56
17,81,17,55,144,212,-68
17,81,17,65,0,69,-69
17,81,17,121,275,260,15
17,81,17,163,0,64,-64
17,81,17,189,100,65,35
17,81,17,191,66,90,-24
17,81,17,199,86,85,1
17,83,17,13,74,66,8
17,83,17,61,173,109,64
17,83,17,117,156,238,-82
17,83,17,119,489,541,-52
17,83,29,189,58,65,-7
17,85,17,15,52,51,1
17,85,17,31,128,69,59
17,85,17,177,122,97,25
17,85,19,61,240,281,-41
17,85,55,43,106,107,-1
17,87,17,181,70,0,70
17,87,17,199,206,229,-23
17,89,4,13,256,655,-399
17,89,4,19,55,98,-43
17,89,4,21,0,94,-94
17,89,6,37,173,228,-55
17,89,6,59,68,83,-15
17,89,6,73,157,158,-1
17,89,8,5,0,85,-85
17,89,8,31,0,114,-114
17,89,8,41,0,138,-138
17,89,8,59,0,71,-71
17,89,8,69,0,58,-58
17,89,12,11,0,84,-84
17,89,12,15,0,63,-63
17,89,12,21,0,110,-110
17,89,12,31,0,78,-78
17,89,12,57,0,133,-133
17,89,12,71,68,255,-187
17,89,12,81,0,73,-73
17,89,12,95,53,84,-31
17,89,12,99,0,90,-90
17,89,12,103,60,121,-61
17,89,12,115,0,95,-95
17,89,13,121,0,71,-71
17,89,17,7,220,364,-144
17,89,17,19,78,101,-23
17,89,17,31,12487,8344,4143
17,89,17,37,1222,1922,-700
17,89,17,43,9295,5344,3951
17,89,17,63,0,76,-76
17,89,17,91,0,53,-53
17,89,17,93,2562,3486,-924
17,89,17,97,767,697,70
17,89,17,99,218,318,-100
17,89,17,103,67,81,-14
17,89,17,111,2715,3802,-1087
17,89,17,113,78,78,0
17,89,17,141,65,137,-72
17,89,17,143,75,0,75
17,89,17,161,0,61,-61
17,89,17,167,64,0,64
17,89,17,197,1393,1359,34
17,89,17,201,389,633,-244
17,89,18,57,0,109,-109
17,89,18,89,75,98,-23
17,89,18,97,60,78,-18
17,89,18,127,0,59,-59
17,89,26,125,65,78,-13
17,89,27,53,55,59,-4
17,89,29,189,0,86,-86
17,89,32,3,89,183,-94
17,89,37,119,0,93,-93
17,89,37,183,0,58,-58
17,89,39,49,0,78,-78
17,89,41,51,0,53,-53
17,89,47,37,0,74,-74
17,89,47,187,0,93,-93
17,89,48,29,0,153,-153
17,89,48,85,0,110,-110
17,89,48,113,61,108,-47
17,89,48,121,0,61,-61
17,89,48,201,134,144,-10
17,89,48,439,0,139,-139
17,89,48,453,0,82,-82
17,89,48,491,0,68,-68
17,89,53,33,79,125,-46
17,89,55,25,0,136,-136
17,89,55,59,0,53,-53
17,89,55,79,97,132,-35
17,89,55,127,0,140,-140
17,89,55,133,0,66,-66
17,91,4,13,52,125,-73
17,91,17,19,80,90,-10
17,91,17,31,1264,924,340
17,91,17,43,122,98,24
17,91,17,63,100,128,-28
17,91,17,75,549,521,28
17,91,17,89,53,0,53
17,91,17,105,80,96,-16
17,91,17,113,0,63,-63
17,91,17,167,0,65,-65
17,91,17,197,1143,718,425
17,91,18,89,107,196,-89
17,91,32,3,0,64,-64
17,93,4,13,80,186,-106
17,93,17,31,1643,986,657
17,93,17,37,452,605,-153
17,93,17,43,2657,1496,1161
17,93,17,63,232,304,-72
17,93,17,89,3486,2562,924
17,93,17,97,86,93,-7
17,93,17,99,331,565,-234
17,93,17,111,57,57,0
17,93,17,113,0,78,-78
17,93,17,197,3305,1910,1395
17,93,18,89,0,78,-78
17,95,17,31,119,88,31
17,95,17,57,145,94,51
17,95,17,73,101,165,-64
17,95,17,109,82,0,82
17,95,17,131,57,70,-13
17,95,17,143,292,315,-23
17,95,17,161,71,126,-55
17,95,17,179,80,63,17
17,95,17,187,296,259,37
17,95,19,163,0,62,-62
17,95,26,77,0,74,-74
17,97,4,13,363,935,-572
17,97,4,19,76,143,-67
17,97,4,21,0,86,-86
17,97,6,1,94,151,-57
17,97,6,13,67,97,-30
17,97,6,37,376,489,-113
17,97,6,59,89,238,-149
17,97,6,65,95,191,-96
17,97,6,71,0,63,-63
17,97,6,73,734,884,-150
17,97,6,75,63,71,-8
17,97,6,81,0,89,-89
17,97,6,85,152,185,-33
17,97,6,111,67,74,-7
17,97,8,5,0,98,-98
17,97,8,13,0,90,-90
17,97,8,31,85,187,-102
17,97,8,35,0,99,-99
17,97,8,41,56,61,-5
17,97,8,59,0,113,-113
17,97,8,69,0,66,-66
17,97,11,1,65,69,-4
17,97,12,11,146,149,-3
17,97,12,21,62,271,-209
17,97,12,31,133,189,-56
17,97,12,57,115,201,-86
17,97,12,69,0,75,-75
17,97,12,71,99,281,-182
17,97,12,81,0,94,-94
17,97,12,86,74,125,-51
17,97,12,95,75,136,-61
17,97,12,99,132,272,-140
17,97,12,101,0,96,-96
17,97,12,103,72,176,-104
17,97,12,105,0,58,-58
17,97,12,109,0,104,-104
17,97,12,115,0,192,-192
17,97,13,67,0,86,-86
17,97,13,89,0,62,-62
17,97,13,121,72,145,-73
17,97,13,135,0,107,-107
17,97,15,3,120,105,15
17,97,17,7,0,60,-60
17,97,17,19,134,95,39
17,97,17,31,19218,13744,5474
17,97,17,37,127,87,40
17,97,17,43,1570,1214,356
17,97,17,89,697,767,-70
17,97,17,93,93,86,7
17,97,17,111,3007,3917,-910
17,97,17,113,146,76,70
17,97,17,143,179,69,110
17,97,17,167,0,48,-48
17,97,17,197,477,370,107
17,97,17,201,158,232,-74
17,97,18,57,0,125,-125
17,97,18,89,82,182,-100
17,97,18,97,76,173,-97
17,97,18,127,0,59,-59
17,97,19,103,61,50,11
17,97,21,111,69,0,69
17,97,24,31,87,84,3
17,97,25,17,86,166,-80
17,97,25,25,0,56,-56
17,97,26,81,0,79,-79
17,97,26,125,108,145,-37
17,97,26,163,63,103,-40
17,97,27,53,138,182,-44
17,97,29,19,48,71,-23
17,97,29,95,0,57,-57
17,97,29,189,105,107,-2
17,97,32,3,139,352,-213
17,97,34,23,69,60,9
17,97,36,47,82,57,25
17,97,36,61,90,147,-57
17,97,37,119,58,144,-86
17,97,37,133,82,84,-2
17,97,37,183,0,104,-104
17,97,39,35,107,0,107
17,97,39,49,116,115,1
17,97,39,61,0,56,-56
17,97,42,101,55,0,55
17,97,45,13,0,88,-88
17,97,47,35,0,56,-56
17,97,47,37,0,97,-97
17,97,47,149,0,74,-74
17,97,47,157,66,117,-51
17,97,47,187,0,108,-108
17,97,48,29,131,133,-2
17,97,48,85,68,194,-126
17,97,48,113,130,200,-70
17,97,48,121,0,186,-186
17,97,48,201,208,239,-31
17,97,48,339,0,96,-96
17,97,48,439,99,167,-68
17,97,48,453,132,184,-52
17,97,48,491,0,96,-96
17,97,49,35,56,80,-24
17,97,51,59,75,94,-19
17,97,51,99,0,190,-190
17,97,51,550,0,87,-87
17,97,51,650,0,49,-49
17,97,51,710,148,166,-18
17,97,51,810,183,236,-53
17,97,53,33,121,268,-147
17,97,53,35,83,90,-7
17,97,53,61,0,68,-68
17,97,55,9,0,74,-74
17,97,55,25,142,258,-116
17,97,55,59,1637,3199,-1562
17,97,55,79,365,564,-199
17,97,55,101,277,610,-333
17,97,55,127,175,289,-114
17,97,55,133,136,192,-56
17,99,4,13,0,90,-90
17,99,17,11,678,620,58
17,99,17,31,512,291,221
17,99,17,37,420,460,-40
17,99,17,43,221,178,43
17,99,17,63,378,269,109
17,99,17,89,318,218,100
17,99,17,93,565,331,234
17,99,17,103,106,174,-68
17,99,17,105,338,332,6
17,99,17,113,76,186,-110
17,99,17,123,77,120,-43
17,99,17,141,60,0,60
17,99,17,143,56,115,-59
17,99,17,155,160,203,-43
17,99,17,179,53,0,53
17,99,17,197,462,364,98
17,99,17,201,0,85,-85
17,99,17,203,0,57,-57
17,101,17,33,96,93,3
17,101,17,159,83,65,18
17,101,18,83,159,236,-77
17,103,17,11,72,62,10
17,103,17,31,112,75,37
17,103,17,37,162,109,53
17,103,17,43,75,0,75
17,103,17,89,81,67,14
17,103,17,99,174,106,68
17,103,17,141,387,463,-76
17,103,17,195,421,408,13
17,103,17,201,72,79,-7
17,105,17,19,0,56,-56
17,105,17,31,111,97,14
17,105,17,53,62,96,-34
17,105,17,63,153,123,30
17,105,17,91,96,80,16
17,105,17,99,332,338,-6
17,105,17,113,330,458,-128
17,105,17,197,166,141,25
17,107,17,113,150,227,-77
17,107,17,115,111,66,45
17,107,17,125,102,82,20
17,107,17,167,288,224,64
17,107,17,179,107,118,-11
17,109,17,1,64,60,4
17,109,17,31,119,187,-68
17,109,17,57,171,131,40
17,109,17,67,98,121,-23
17,109,17,95,0,82,-82
17,109,17,143,0,48,-48
17,109,17,169,69,0,69
17,111,4,13,158,586,-428
17,111,4,21,0,67,-67
17,111,6,37,81,88,-7
17,111,6,73,0,104,-104
17,111,8,1,0,60,-60
17,111,8,31,0,56,-56
17,111,8,41,0,79,-79
17,111,8,69,0,55,-55
17,111,12,11,0,55,-55
17,111,12,15,0,65,-65
17,111,12,21,0,70,-70
17,111,12,57,0,78,-78
17,111,12,71,0,194,-194
17,111,12,103,0,96,-96
17,111,12,115,0,73,-73
17,111,17,7,344,615,-271
17,111,17,19,51,0,51
17,111,17,31,6746,3777,2969
17,111,17,37,209,279,-70
17,111,17,43,1159,691,468
17,111,17,89,3802,2715,1087
17,111,17,93,57,57,0
17,111,17,97,3917,3007,910
17,111,17,197,214,169,45
17,111,17,201,320,480,-160
17,111,18,89,0,77,-77
17,111,18,97,0,54,-54
17,111,32,3,61,139,-78
17,111,48,85,0,86,-86
17,111,48,121,0,64,-64
17,111,48,201,0,54,-54
17,111,48,453,0,83,-83
17,111,55,25,55,108,-53
17,111,55,59,193,372,-179
17,111,55,79,128,147,-19
17,111,55,101,65,84,-19
17,111,55,105,71,128,-57
17,111,55,127,347,784,-437
17,111,55,133,0,101,-101
17,113,4,13,126,673,-547
17,113,4,21,0,57,-57
17,113,6,37,54,55,-1
17,113,8,41,0,59,-59
17,113,12,71,0,66,-66
17,113,13,117,0,86,-86
17,113,17,19,414,412,2
17,113,17,31,805,821,-16
17,113,17,39,263,227,36
17,113,17,43,170,233,-63
17,113,17,53,57,0,57
17,113,17,89,78,78,0
17,113,17,91,63,0,63
17,113,17,93,78,0,78
17,113,17,97,76,146,-70
17,113,17,99,186,76,110
17,113,17,105,458,330,128
17,113,17,107,227,150,77
17,113,17,115,236,153,83
17,113,17,119,0,52,-52
17,113,17,143,384,365,19
17,113,17,167,175,175,0
17,113,17,179,410,421,-11
17,113,17,183,0,48,-48
17,113,17,197,159,137,22
17,113,17,201,55,0,55
17,113,17,203,369,434,-65
17,113,18,97,0,65,-65
17,113,29,19,0,54,-54
17,113,29,183,0,59,-59
17,113,29,189,0,89,-89
17,113,32,3,0,78,-78
17,113,47,37,0,57,-57
17,113,48,85,75,424,-349
17,113,48,113,0,115,-115
17,113,48,439,0,78,-78
17,113,48,453,0,57,-57
17,113,53,53,73,0,73
17,113,55,25,0,80,-80
17,115,4,13,0,90,-90
17,115,17,19,184,225,-41
17,115,17,21,226,136,90
17,115,17,29,65,62,3
17,115,17,31,257,186,71
17,115,17,39,95,131,-36
17,115,17,107,66,111,-45
17,115,17,113,153,236,-83
17,115,17,119,54,0,54
17,115,17,139,194,197,-3
17,115,17,143,110,87,23
17,115,17,147,215,249,-34
17,115,17,163,0,69,-69
17,115,17,167,283,432,-149
17,115,17,173,133,117,16
17,115,17,179,0,52,-52
17,115,18,97,0,78,-78
17,115,29,189,0,58,-58
17,117,17,21,61,0,61
17,117,17,61,145,0,145
17,117,17,83,238,156,82
17,117,17,119,781,735,46
17,117,17,135,265,251,14
17,117,17,163,68,55,13
17,117,17,167,455,344,111
17,119,4,13,0,117,-117
17,119,17,1,50,0,50
17,119,17,5,269,286,-17
17,119,17,13,55,0,55
17,119,17,19,0,61,-61
17,119,17,27,264,326,-62
17,119,17,31,243,228,15
17,119,17,61,100,68,32
17,119,17,83,541,489,52
17,119,17,113,52,0,52
17,119,17,115,0,54,-54
17,119,17,117,735,781,-46
17,119,17,121,57,0,57
17,119,17,133,114,106,8
17,119,17,135,141,111,30
17,119,17,137,59,0,59
17,119,17,143,56,0,56
17,119,17,163,3292,2995,297
17,119,17,167,205,170,35
17,119,17,197,52,0,52
17,119,29,19,49,0,49
17,119,29,71,61,48,13
17,119,29,99,177,243,-66
17,119,29,113,0,65,-65
17,119,29,183,431,600,-169
17,119,29,189,1367,1380,-13
17,119,29,510,820,727,93
17,119,48,201,0,70,-70
17,119,48,439,0,51,-51
17,121,17,27,372,415,-43
17,121,17,51,111,85,26
17,121,17,81,260,275,-15
17,121,17,119,0,57,-57
17,121,17,163,0,95,-95
17,121,17,189,135,88,47
17,123,17,99,120,77,43
17,123,17,143,189,165,24
17,123,17,179,53,73,-20
17,123,17,203,169,140,29
17,125,17,57,78,74,4
17,125,17,107,82,102,-20
17,125,17,143,68,56,12
17,125,17,167,60,0,60
17,125,17,179,226,274,-48
17,127,17,153,68,0,68
17,127,21,145,220,309,-89
17,129,17,167,530,468,62
17,131,17,73,81,106,-25
17,131,17,95,70,57,13
17,131,17,161,342,296,46
17,131,17,187,101,85,16
17,131,19,139,0,66,-66
17,131,19,163,63,93,-30
17,133,17,119,106,114,-8
17,133,17,157,199,188,11
17,133,17,163,738,502,236
17,133,29,99,108,127,-19
17,133,29,183,0,74,-74
17,133,29,189,381,304,77
17,133,29,510,135,119,16
17,135,17,5,105,54,51
17,135,17,21,107,111,-4
17,135,17,117,251,265,-14
17,135,17,119,111,141,-30
17,135,17,167,174,175,-1
17,137,17,17,155,160,-5
17,137,17,61,123,116,7
17,137,17,119,0,59,-59
17,137,17,167,260,434,-174
17,137,17,171,120,168,-48
17,139,17,29,142,167,-25
17,139,17,41,219,155,64
17,139,17,115,197,194,3
17,139,17,173,133,99,34
17,141,17,7,69,69,0
17,141,17,31,157,77,80
17,141,17,37,443,290,153
17,141,17,43,70,76,-6
17,141,17,89,137,65,72
17,141,17,99,0,60,-60
17,141,17,103,463,387,76
17,141,17,177,167,160,7
17,141,17,195,114,132,-18
17,141,17,201,771,759,12
17,143,4,13,64,147,-83
17,143,4,19,0,158,-158
17,143,6,37,58,56,2
17,143,6,73,0,73,-73
17,143,12,71,0,73,-73
17,143,12,103,0,66,-66
17,143,13,121,0,58,-58
17,143,17,11,0,48,-48
17,143,17,19,156,132,24
17,143,17,31,587,544,43
17,143,17,43,123,144,-21
17,143,17,57,349,324,25
17,143,17,73,108,0,108
17,143,17,89,0,75,-75
17,143,17,95,315,292,23
17,143,17,97,69,179,-110
17,143,17,99,115,56,59
17,143,17,109,48,0,48
17,143,17,113,365,384,-19
17,143,17,115,87,110,-23
17,143,17,119,0,56,-56
17,143,17,123,165,189,-24
17,143,17,125,56,68,-12
17,143,17,161,83,66,17
17,143,17,167,161,175,-14
17,143,17,175,117,78,39
17,143,17,179,2660,2904,-244
17,143,17,197,79,110,-31
17,143,17,203,385,465,-80
17,143,18,97,69,145,-76
17,143,19,163,0,78,-78
17,143,26,125,0,184,-184
17,143,27,53,0,87,-87
17,143,29,189,0,99,-99
17,143,32,3,0,99,-99
17,143,37,183,0,74,-74
17,143,47,37,0,68,-68
17,143,48,29,0,67,-67
17,143,48,113,0,100,-100
17,143,48,201,72,89,-17
17,143,48,439,0,77,-77
17,143,48,453,0,79,-79
17,145,17,55,94,126,-32
17,145,17,77,171,168,3
17,145,17,157,166,162,4
17,145,17,163,0,61,-61
17,145,17,189,53,78,-25
17,145,17,199,66,120,-54
17,147,17,19,442,360,82
17,147,17,39,91,78,13
17,147,17,41,91,0,91
17,147,17,115,249,215,34
17,149,17,1,79,142,-63
17,149,29,163,0,65,-65
17,151,17,165,0,53,-53
17,153,17,127,0,68,-68
17,155,17,11,95,96,-1
17,155,17,99,203,160,43
17,157,17,77,106,148,-42
17,157,17,133,188,199,-11
17,157,17,145,162,166,-4
17,157,17,163,274,262,12
17,157,29,157,57,84,-27
17,159,17,25,0,104,-104
17,159,17,79,61,0,61
17,159,17,101,65,83,-18
17,159,17,191,57,0,57
17,161,4,13,60,84,-24
17,161,17,31,301,337,-36
17,161,17,43,78,0,78
17,161,17,73,981,1076,-95
17,161,17,89,61,0,61
17,161,17,95,126,71,55
17,161,17,131,296,342,-46
17,161,17,143,66,83,-17
17,161,17,187,51,0,51
17,161,17,195,137,199,-62
17,161,19,45,74,141,-67
17,161,19,103,74,85,-11
17,161,19,113,83,130,-47
17,161,19,139,124,117,7
17,161,19,153,62,142,-80
17,161,19,163,2215,2604,-389
17,161,26,77,0,91,-91
17,163,4,13,125,137,-12
17,163,4,19,0,71,-71
17,163,6,37,96,90,6
17,163,6,73,86,0,86
17,163,6,95,104,0,104
17,163,8,41,99,120,-21
17,163,12,57,112,109,3
17,163,12,91,0,122,-122
17,163,15,3,124,140,-16
17,163,17,19,65,0,65
17,163,17,27,451,501,-50
17,163,17,31,229,193,36
17,163,17,77,127,73,54
17,163,17,81,64,0,64
17,163,17,115,69,0,69
17,163,17,117,55,68,-13
17,163,17,119,2995,3292,-297
17,163,17,121,95,0,95
17,163,17,133,502,738,-236
17,163,17,145,61,0,61
17,163,17,157,262,274,-12
17,163,17,167,164,123,41
17,163,17,189,165,141,24
17,163,17,199,79,0,79
17,163,20,173,67,0,67
17,163,28,47,88,0,88
17,163,29,19,58,0,58
17,163,29,71,0,57,-57
17,163,29,99,254,301,-47
17,163,29,183,173,321,-148
17,163,29,189,1426,1672,-246
17,163,29,510,1166,1187,-21
17,163,32,3,0,93,-93
17,163,34,5,90,0,90
17,163,39,57,0,79,-79
17,163,48,29,187,239,-52
17,163,48,113,0,80,-80
17,163,48,201,85,73,12
17,163,48,439,0,71,-71
17,163,51,59,127,116,11
17,163,53,53,107,0,107
17,165,17,55,85,61,24
17,165,17,59,107,0,107
17,165,17,69,58,0,58
17,165,17,151,53,0,53
17,165,17,199,180,246,-66
17,167,4,13,81,107,-26
17,167,6,37,0,43,-43
17,167,12,71,0,100,-100
17,167,12,103,0,55,-55
17,167,17,1,108,61,47
17,167,17,17,161,121,40
17,167,17,19,173,193,-20
17,167,17,21,427,386,41
17,167,17,31,734,846,-112
17,167,17,43,71,127,-56
17,167,17,61,51,0,51
17,167,17,77,69,57,12
17,167,17,89,0,64,-64
17,167,17,91,65,0,65
17,167,17,97,48,0,48
17,167,17,107,224,288,-64
17,167,17,113,175,175,0
17,167,17,115,432,283,149
17,167,17,117,344,455,-111
17,167,17,119,170,205,-35
17,167,17,125,0,60,-60
17,167,17,129,468,530,-62
17,167,17,135,175,174,1
17,167,17,137,434,260,174
17,167,17,143,175,161,14
17,167,17,163,123,164,-41
17,167,17,179,63,96,-33
17,167,17,197,100,107,-7
17,167,18,97,0,109,-109
17,167,29,183,0,69,-69
17,167,29,189,107,200,-93
17,167,29,510,100,151,-51
17,167,32,3,54,65,-11
17,167,47,37,0,51,-51
17,167,48,201,0,69,-69
17,169,17,17,74,69,5
17,169,17,109,0,69,-69
17,171,17,137,168,120,48
17,173,17,21,208,171,37
17,173,17,29,150,191,-41
17,173,17,49,176,180,-4
17,173,17,51,60,0,60
17,173,17,115,117,133,-16
17,173,17,139,99,133,-34
17,175,17,73,0,82,-82
17,175,17,143,78,117,-39
17,177,17,15,108,113,-5
17,177,17,31,191,156,35
17,177,17,85,97,122,-25
17,177,17,141,160,167,-7
17,177,17,201,469,541,-72
17,177,55,25,0,62,-62
17,177,55,45,105,181,-76
17,179,4,13,47,141,-94
17,179,17,19,42,75,-33
17,179,17,31,138,137,1
17,179,17,43,60,0,60
17,179,17,57,148,142,6
17,179,17,95,63,80,-17
17,179,17,99,0,53,-53
17,179,17,107,118,107,11
17,179,17,113,421,410,11
17,179,17,115,52,0,52
17,179,17,123,73,53,20
17,179,17,125,274,226,48
17,179,17,143,2904,2660,244
17,179,17,167,96,63,33
17,179,17,203,638,785,-147
17,179,19,163,0,51,-51
17,179,29,189,0,59,-59
17,181,17,77,113,153,-40
17,181,17,87,0,70,-70
17,181,17,199,87,105,-18
17,181,29,31,0,54,-54
17,183,17,19,606,715,-109
17,183,17,31,330,286,44
17,183,17,45,65,83,-18
17,183,17,75,95,109,-14
17,183,17,113,48,0,48
17,183,18,45,66,171,-105
17,183,18,97,76,106,-30
17,183,18,165,65,116,-51
17,183,18,167,0,61,-61
17,183,18,171,0,97,-97
17,185,17,47,0,60,-60
17,185,18,51,75,133,-58
17,185,18,163,0,77,-77
17,187,17,71,70,70,0
17,187,17,95,259,296,-37
17,187,17,131,85,101,-16
17,187,17,161,0,51,-51
17,189,17,27,117,129,-12
17,189,17,81,65,100,-35
17,189,17,121,88,135,-47
17,189,17,145,78,53,25
17,189,17,163,141,165,-24
17,191,17,25,108,108,0
17,191,17,47,55,59,-4
17,191,17,81,90,66,24
17,191,17,159,0,57,-57
17,193,17,47,85,88,-3
17,193,17,59,69,0,69
17,193,17,65,83,0,83
17,193,18,163,56,72,-16
17,195,17,11,86,70,16
17,195,17,15,150,153,-3
17,195,17,31,89,77,12
17,195,17,73,0,65,-65
17,195,17,103,408,421,-13
17,195,17,141,132,114,18
17,195,17,161,199,137,62
17,195,17,201,47,0,47
17,195,19,45,289,255,34
17,195,19,163,86,78,8
17,197,4,13,259,1057,-798
17,197,4,19,0,125,-125
17,197,4,21,0,97,-97
17,197,6,1,0,58,-58
17,197,6,37,183,210,-27
17,197,6,59,91,151,-60
17,197,6,65,94,68,26
17,197,6,71,0,73,-73
17,197,6,73,141,178,-37
17,197,8,5,0,50,-50
17,197,8,31,0,111,-111
17,197,8,41,0,61,-61
17,197,8,59,0,70,-70
17,197,12,11,74,78,-4
17,197,12,21,0,180,-180
17,197,12,31,0,77,-77
17,197,12,57,60,184,-124
17,197,12,71,88,265,-177
17,197,12,81,0,71,-71
17,197,12,95,69,150,-81
17,197,12,99,0,109,-109
17,197,12,101,0,102,-102
17,197,12,103,0,123,-123
17,197,12,105,0,132,-132
17,197,12,115,0,120,-120
17,197,12,127,0,69,-69
17,197,13,121,53,155,-102
17,197,13,135,0,122,-122
17,197,17,19,126,135,-9
17,197,17,31,22236,14053,8183
17,197,17,37,207,233,-26
17,197,17,43,10194,7231,2963
17,197,17,63,1614,2372,-758
17,197,17,89,1359,1393,-34
17,197,17,91,718,1143,-425
17,197,17,93,1910,3305,-1395
17,197,17,97,370,477,-107
17,197,17,99,364,462,-98
17,197,17,105,141,166,-25
17,197,17,111,169,214,-45
17,197,17,113,137,159,-22
17,197,17,119,0,52,-52
17,197,17,143,110,79,31
17,197,17,167,107,100,7
17,197,17,201,111,159,-48
17,197,18,3,0,71,-71
17,197,18,57,0,135,-135
17,197,18,89,728,1797,-1069
17,197,18,97,100,118,-18
17,197,18,127,90,291,-201
17,197,18,141,75,0,75
17,197,18,157,0,64,-64
17,197,19,103,52,0,52
17,197,19,153,0,60,-60
17,197,19,163,0,60,-60
17,197,26,125,0,90,-90
17,197,26,163,66,88,-22
17,197,27,53,0,125,-125
17,197,29,189,87,107,-20
17,197,32,3,114,306,-192
17,197,36,47,66,0,66
17,197,37,119,61,123,-62
17,197,37,183,0,83,-83
17,197,39,49,57,0,57
17,197,47,37,0,89,-89
17,197,47,125,0,71,-71
17,197,47,149,0,96,-96
17,197,47,157,0,74,-74
17,197,47,187,0,85,-85
17,197,48,29,57,120,-63
17,197,48,85,0,176,-176
17,197,48,113,76,159,-83
17,197,48,121,60,113,-53
17,197,48,157,0,69,-69
17,197,48,201,193,281,-88
17,197,48,339,0,84,-84
17,197,48,439,107,152,-45
17,197,48,453,0,98,-98
17,197,48,491,0,76,-76
17,197,49,35,0,73,-73
17,197,53,33,92,121,-29
17,197,55,25,75,92,-17
17,197,55,79,81,121,-40
17,197,55,127,0,74,-74
17,199,17,31,65,69,-4
17,199,17,55,702,672,30
17,199,17,77,758,646,112
17,199,17,81,85,86,-1
17,199,17,87,229,206,23
17,199,17,145,120,66,54
17,199,17,163,0,79,-79
17,199,17,165,246,180,66
17,199,17,181,105,87,18
17,199,29,189,0,74,-74
17,201,4,13,172,359,-187
17,201,4,19,0,76,-76
17,201,6,37,0,69,-69
17,201,6,73,0,96,-96
17,201,8,41,0,62,-62
17,201,12,71,0,115,-115
17,201,12,103,0,84,-84
17,201,12,105,0,62,-62
17,201,17,7,2018,1823,195
17,201,17,19,68,0,68
17,201,17,31,1917,1248,669
17,201,17,37,387,243,144
17,201,17,43,360,268,92
17,201,17,89,633,389,244
17,201,17,97,232,158,74
17,201,17,99,85,0,85
17,201,17,103,79,72,7
17,201,17,111,480,320,160
17,201,17,113,0,55,-55
17,201,17,141,759,771,-12
17,201,17,177,541,469,72
17,201,17,195,0,47,-47
17,201,17,197,159,111,48
17,201,26,125,0,62,-62
17,201,27,53,55,0,55
17,201,32,3,60,140,-80
17,201,48,113,0,78,-78
17,201,48,201,59,133,-74
17,201,55,25,206,344,-138
17,201,55,45,49,60,-11
17,201,55,79,111,210,-99
17,201,55,105,1073,1087,-14
17,201,55,127,90,101,-11
17,201,55,133,0,79,-79
17,203,17,99,57,0,57
17,203,17,113,434,369,65
17,203,17,123,140,169,-29
17,203,17,143,465,385,80
17,203,17,179,785,638,147
18,1,18,3,357,460,-103
18,1,18,75,151,110,41
18,1,18,179,221,276,-55
18,1,39,161,81,75,6
18,3,4,13,163,181,-18
18,3,4,19,0,54,-54
18,3,6,37,135,85,50
18,3,6,59,64,0,64
18,3,6,73,112,79,33
18,3,8,31,88,0,88
18,3,8,41,94,0,94
18,3,12,9,0,67,-67
18,3,12,57,0,98,-98
18,3,12,71,63,135,-72
18,3,12,81,0,73,-73
18,3,12,99,0,63,-63
18,3,12,103,60,83,-23
18,3,13,89,75,0,75
18,3,17,31,475,322,153
18,3,17,43,93,0,93
18,3,17,197,71,0,71
18,3,18,1,460,357,103
18,3,18,17,50,0,50
18,3,18,33,926,1091,-165
18,3,18,35,145,121,24
18,3,18,39,176,213,-37
18,3,18,53,165,148,17
18,3,18,57,220,433,-213
18,3,18,63,63,127,-64
18,3,18,67,69,64,5
18,3,18,69,682,703,-21
18,3,18,81,60,79,-19
18,3,18,85,483,278,205
18,3,18,87,160,186,-26
18,3,18,89,149,87,62
18,3,18,95,117,80,37
18,3,18,97,753,914,-161
18,3,18,99,52,0,52
18,3,18,103,82,60,22
18,3,18,105,100,75,25
18,3,18,113,620,769,-149
18,3,18,127,65,91,-26
18,3,18,141,264,231,33
18,3,18,151,367,497,-130
18,3,18,157,139,92,47
18,3,18,169,148,101,47
18,3,18,179,547,628,-81
18,3,18,183,919,955,-36
18,3,26,23,86,57,29
18,3,26,77,0,63,-63
18,3,26,81,78,0,78
18,3,26,125,126,74,52
18,3,26,163,110,101,9
18,3,32,3,0,95,-95
18,3,39,3,76,97,-21
18,3,39,35,63,0,63
18,3,39,39,167,116,51
18,3,39,49,110,95,15
18,3,39,61,0,68,-68
18,3,39,95,72,106,-34
18,3,39,99,65,0,65
18,3,39,113,69,67,2
18,3,39,125,181,117,64
18,3,39,161,133,95,38
18,3,39,171,93,58,35
18,3,48,113,154,83,71
18,3,48,201,102,0,102
18,3,48,439,64,54,10
18,3,53,33,65,67,-2
18,5,18,13,227,261,-34
18,5,18,31,164,234,-70
18,5,18,57,0,152,-152
18,5,18,71,542,541,1
18,5,18,77,0,60,-60
18,5,18,79,412,461,-49
18,5,18,81,750,740,10
18,5,18,97,431,573,-142
18,5,18,105,136,146,-10
18,5,18,145,191,202,-11
18,5,18,157,60,0,60
18,5,21,111,0,57,-57
18,5,26,125,69,76,-7
18,5,48,439,55,0,55
18,7,18,157,335,315,20
18,9,18,35,240,180,60
18,9,18,53,125,181,-56
18,9,18,75,96,104,-8
18,9,18,179,0,108,-108
18,11,17,31,132,80,52
18,11,18,23,169,217,-48
18,11,18,57,1071,1180,-109
18,11,18,63,675,520,155
18,11,18,81,96,93,3
18,11,18,97,1936,1265,671
18,11,18,107,144,192,-48
18,11,18,157,242,203,39
18,13,18,5,261,227,34
18,13,18,81,337,344,-7
18,13,18,97,229,140,89
18,13,18,105,136,136,0
18,13,18,109,116,127,-11
18,15,18,17,109,113,-4
18,15,18,23,162,157,5
18,15,18,67,70,102,-32
18,15,18,157,626,491,135
18,15,18,181,345,255,90
18,17,12,86,67,0,67
18,17,18,3,0,50,-50
18,17,18,15,113,109,4
18,17,18,49,113,111,2
18,17,18,67,278,405,-127
18,17,18,97,73,89,-16
18,17,18,103,269,336,-67
18,17,18,157,94,171,-77
18,17,18,181,169,96,73
18,19,18,43,2816,2948,-132
18,19,18,57,0,67,-67
18,19,18,61,422,516,-94
18,19,18,77,128,110,18
18,19,18,97,120,119,1
18,19,18,143,354,448,-94
18,19,18,175,308,403,-95
18,19,21,29,181,117,64
18,19,21,93,69,0,69
18,19,21,111,2666,1746,920
18,19,21,185,115,84,31
18,19,21,211,62,0,62
18,21,18,55,116,89,27
18,21,18,63,64,0,64
18,21,18,97,97,94,3
18,21,18,119,112,118,-6
18,21,18,121,126,64,62
18,21,18,133,292,179,113
18,21,18,153,79,0,79
18,21,18,167,668,631,37
18,23,18,11,217,169,48
18,23,18,15,157,162,-5
18,23,18,57,114,88,26
18,23,18,67,99,111,-12
18,23,18,97,101,146,-45
18,23,18,157,576,545,31
18,25,18,37,68,71,-3
18,25,18,43,86,62,24
18,25,18,61,263,242,21
18,25,18,117,87,74,13
18,27,18,37,81,119,-38
18,27,18,55,85,122,-37
18,27,18,83,195,276,-81
18,27,18,97,0,71,-71
18,27,18,101,205,247,-42
18,27,18,125,69,0,69
18,27,18,163,54,123,-69
18,29,18,47,205,175,30
18,29,18,97,0,62,-62
18,29,18,115,225,255,-30
18,29,18,137,429,601,-172
18,29,18,155,99,89,10
18,29,21,15,187,222,-35
18,29,21,37,0,58,-58
18,29,21,117,104,148,-44
18,29,39,17,131,89,42
18,29,39,61,1217,854,363
18,31,18,5,234,164,70
18,31,18,47,143,112,31
18,31,18,79,129,101,28
18,31,18,81,56,73,-17
18,31,18,97,124,145,-21
18,31,18,137,248,249,-1
18,31,18,139,207,139,68
18,31,18,145,224,251,-27
18,33,18,3,1091,926,165
18,33,18,87,81,72,9
18,33,18,113,508,467,41
18,33,18,151,566,539,27
18,33,18,183,81,0,81
18,33,39,39,0,61,-61
18,33,39,171,78,67,11
18,35,4,13,0,56,-56
18,35,17,31,64,66,-2
18,35,18,3,121,145,-24
18,35,18,9,180,240,-60
18,35,18,53,125,175,-50
18,35,18,57,252,456,-204
18,35,18,59,108,109,-1
18,35,18,65,306,330,-24
18,35,18,67,0,59,-59
18,35,18,75,222,146,76
18,35,18,81,53,61,-8
18,35,18,95,906,760,146
18,35,18,97,397,780,-383
18,35,18,105,0,50,-50
18,35,18,135,346,341,5
18,35,18,141,0,46,-46
18,35,18,157,0,57,-57
18,35,18,177,79,65,14
18,37,18,25,71,68,3
18,37,18,27,119,81,38
18,37,18,97,63,70,-7
18,37,18,101,62,0,62
18,37,18,117,100,98,2
18,37,18,123,116,89,27
18,37,18,125,155,187,-32
18,37,18,147,195,214,-19
18,37,18,163,130,193,-63
18,37,18,173,0,92,-92
18,37,21,111,0,69,-69
18,39,4,13,0,72,-72
18,39,6,37,77,0,77
18,39,12,71,0,79,-79
18,39,17,31,278,170,108
18,39,18,3,213,176,37
18,39,18,57,70,88,-18
18,39,18,85,938,841,97
18,39,18,87,641,484,157
18,39,18,89,75,73,2
18,39,18,91,95,70,25
18,39,18,97,191,286,-95
18,39,18,99,293,284,9
18,39,18,113,338,276,62
18,39,18,127,81,0,81
18,39,18,141,3029,3325,-296
18,39,18,157,68,62,6
18,39,26,21,185,185,0
18,39,26,27,487,734,-247
18,39,26,77,74,63,11
18,39,26,149,329,409,-80
18,41,18,47,176,131,45
18,41,18,139,144,144,0
18,41,18,161,117,0,117
18,41,18,177,165,201,-36
18,43,18,19,2948,2816,132
18,43,18,25,62,86,-24
18,43,18,61,683,840,-157
18,43,18,97,72,67,5
18,43,18,143,89,79,10
18,43,18,175,222,220,2
18,43,21,29,56,0,56
18,43,21,111,1811,943,868
18,45,17,183,171,66,105
18,45,18,107,200,167,33
18,45,18,157,195,149,46
18,45,18,165,96,76,20
18,45,18,171,184,226,-42
18,47,18,29,175,205,-30
18,47,18,31,112,143,-31
18,47,18,41,131,176,-45
18,47,18,97,0,56,-56
18,47,18,137,372,334,38
18,47,39,17,104,90,14
18,47,39,61,200,150,50
18,49,18,17,111,113,-2
18,49,18,85,241,165,76
18,49,18,99,193,203,-10
18,49,18,103,126,95,31
18,49,18,131,98,66,32
18,51,17,185,133,75,58
18,51,18,83,108,136,-28
18,51,18,125,113,207,-94
18,51,18,129,94,80,14
18,51,18,163,575,689,-114
18,51,18,173,137,139,-2
18,53,18,3,148,165,-17
18,53,18,9,181,125,56
18,53,18,35,175,125,50
18,53,18,57,81,164,-83
18,53,18,67,195,188,7
18,53,18,69,109,125,-16
18,53,18,95,206,263,-57
18,53,18,97,161,277,-116
18,53,18,103,212,133,79
18,53,18,169,117,134,-17
18,55,18,21,89,116,-27
18,55,18,27,122,85,37
18,55,18,83,75,77,-2
18,55,18,93,77,120,-43
18,55,18,97,66,77,-11
18,55,18,105,479,529,-50
18,55,18,119,102,114,-12
18,55,18,153,208,190,18
18,55,18,167,100,97,3
18,57,4,13,204,266,-62
18,57,6,37,220,126,94
18,57,6,59,108,98,10
18,57,6,73,150,126,24
18,57,6,85,0,62,-62
18,57,8,31,69,78,-9
18,57,8,41,68,84,-16
18,57,12,11,81,67,14
18,57,12,21,0,100,-100
18,57,12,57,90,124,-34
18,57,12,71,111,205,-94
18,57,12,81,0,103,-103
18,57,12,86,64,0,64
18,57,12,95,71,82,-11
18,57,12,99,85,69,16
18,57,12,103,79,107,-28
18,57,12,115,0,102,-102
18,57,13,67,76,0,76
18,57,13,121,0,82,-82
18,57,17,31,729,426,303
18,57,17,43,227,74,153
18,57,17,89,109,0,109
18,57,17,97,125,0,125
18,57,17,197,135,0,135
18,57,18,3,433,220,213
18,57,18,5,152,0,152
18,57,18,11,1180,1071,109
18,57,18,19,67,0,67
18,57,18,23,88,114,-26
18,57,18,35,456,252,204
18,57,18,39,88,70,18
18,57,18,53,164,81,83
18,57,18,59,836,1094,-258
18,57,18,63,738,723,15
18,57,18,65,133,140,-7
18,57,18,67,352,292,60
18,57,18,81,628,341,287
18,57,18,85,92,0,92
18,57,18,89,216,69,147
18,57,18,95,1107,1246,-139
18,57,18,97,11441,7738,3703
18,57,18,105,319,188,131
18,57,18,109,98,85,13
18,57,18,127,138,0,138
18,57,18,133,0,68,-68
18,57,18,141,254,110,144
18,57,18,145,98,58,40
18,57,18,157,393,182,211
18,57,18,159,220,336,-116
18,57,18,163,139,0,139
18,57,18,167,181,0,181
18,57,18,177,111,0,111
18,57,19,49,0,75,-75
18,57,20,91,70,0,70
18,57,21,67,83,0,83
18,57,21,111,203,100,103
18,57,25,17,80,109,-29
18,57,26,81,65,0,65
18,57,26,125,150,129,21
18,57,26,163,67,0,67
18,57,27,53,0,83,-83
18,57,29,189,91,68,23
18,57,32,3,105,80,25
18,57,36,47,64,0,64
18,57,36,61,0,67,-67
18,57,36,81,77,0,77
18,57,37,119,0,87,-87
18,57,37,183,0,109,-109
18,57,39,17,71,0,71
18,57,39,35,74,72,2
18,57,39,49,174,135,39
18,57,39,61,109,95,14
18,57,39,113,74,0,74
18,57,39,165,0,81,-81
18,57,42,3,0,61,-61
18,57,47,37,104,107,-3
18,57,48,29,0,54,-54
18,57,48,85,71,0,71
18,57,48,113,75,0,75
18,57,48,121,89,94,-5
18,57,48,201,135,102,33
18,57,48,439,97,0,97
18,57,48,453,70,82,-12
18,57,48,491,0,80,-80
18,57,51,59,69,0,69
18,57,53,33,166,105,61
18,59,18,35,109,108,1
18,59,18,57,1094,836,258
18,59,18,63,164,100,64
18,59,18,65,381,475,-94
18,59,18,81,261,143,118
18,59,18,95,421,574,-153
18,59,18,97,3392,1980,1412
18,59,18,109,62,0,62
18,59,18,139,144,97,47
18,59,18,145,276,338,-62
18,59,18,177,68,0,68
18,61,18,19,516,422,94
18,61,18,25,242,263,-21
18,61,18,43,840,683,157
18,61,18,175,166,192,-26
18,61,21,111,357,290,67
18,63,4,13,67,138,-71
18,63,6,37,60,0,60
18,63,12,71,0,80,-80
18,63,12,103,0,97,-97
18,63,17,31,144,73,71
18,63,18,3,127,63,64
18,63,18,11,520,675,-155
18,63,18,21,0,64,-64
18,63,18,57,723,738,-15
18,63,18,59,100,164,-64
18,63,18,65,54,0,54
18,63,18,67,48,0,48
18,63,18,81,431,444,-13
18,63,18,89,124,0,124
18,63,18,95,97,68,29
18,63,18,97,7941,5482,2459
18,63,18,105,176,95,81
18,63,18,107,144,178,-34
18,63,18,109,851,961,-110
18,63,18,119,0,79,-79
18,63,18,133,599,685,-86
18,63,18,141,99,0,99
18,63,18,157,153,122,31
18,63,18,167,230,93,137
18,63,48,201,0,60,-60
18,65,18,35,330,306,24
18,65,18,57,140,133,7
18,65,18,59,475,381,94
18,65,18,63,0,54,-54
18,65,18,95,428,459,-31
18,65,18,97,347,252,95
18,65,18,135,66,63,3
18,65,18,139,173,121,52
18,65,18,145,59,0,59
18,65,18,177,252,227,25
18,67,17,31,203,93,110
18,67,18,3,64,69,-5
18,67,18,15,102,70,32
18,67,18,17,405,278,127
18,67,18,23,111,99,12
18,67,18,35,59,0,59
18,67,18,53,188,195,-7
18,67,18,57,292,352,-60
18,67,18,63,0,48,-48
18,67,18,95,117,118,-1
18,67,18,97,291,360,-69
18,67,18,103,512,539,-27
18,67,18,157,188,306,-118
18,67,18,159,403,348,55
18,67,18,169,59,0,59
18,69,18,3,703,682,21
18,69,18,53,125,109,16
18,69,18,85,51,58,-7
18,69,18,169,230,156,74
18,69,18,179,290,194,96
18,69,18,183,116,128,-12
18,71,18,5,541,542,-1
18,71,18,77,51,75,-24
18,71,18,79,440,539,-99
18,71,18,81,92,75,17
18,71,18,93,94,89,5
18,71,18,97,139,133,6
18,71,18,105,61,55,6
18,71,18,143,278,283,-5
18,71,18,175,78,97,-19
18,73,17,31,92,0,92
18,73,18,89,556,329,227
18,73,18,97,0,59,-59
18,73,18,111,322,216,106
18,73,18,127,325,339,-14
18,73,18,131,101,66,35
18,73,18,157,88,174,-86
18,73,18,181,134,143,-9
18,75,18,1,110,151,-41
18,75,18,9,104,96,8
18,75,18,35,146,222,-76
18,75,18,135,165,104,61
18,75,18,179,0,61,-61
18,77,18,5,60,0,60
18,77,18,19,110,128,-18
18,77,18,71,75,51,24
18,77,18,79,173,105,68
18,77,18,97,60,48,12
18,77,18,137,96,57,39
18,77,18,143,169,109,60
18,77,18,155,114,100,14
18,77,21,41,61,0,61
18,77,21,111,50,96,-46
18,77,21,223,105,100,5
18,79,18,5,461,412,49
18,79,18,31,101,129,-28
18,79,18,71,539,440,99
18,79,18,77,105,173,-68
18,79,18,81,0,67,-67
18,79,18,97,80,66,14
18,79,18,137,65,0,65
18,79,18,143,0,68,-68
18,81,4,13,79,0,79
18,81,17,31,67,68,-1
18,81,18,3,79,60,19
18,81,18,5,740,750,-10
18,81,18,11,93,96,-3
18,81,18,13,344,337,7
18,81,18,31,73,56,17
18,81,18,35,61,53,8
18,81,18,57,341,628,-287
18,81,18,59,143,261,-118
18,81,18,63,444,431,13
18,81,18,71,75,92,-17
18,81,18,79,67,0,67
18,81,18,89,79,0,79
18,81,18,93,56,0,56
18,81,18,95,78,85,-7
18,81,18,97,7900,6167,1733
18,81,18,105,219,180,39
18,81,18,109,868,817,51
18,81,18,133,66,94,-28
18,81,18,141,70,0,70
18,81,18,145,383,470,-87
18,81,18,157,90,77,13
18,81,18,167,86,0,86
18,81,36,81,94,0,94
18,83,17,101,236,159,77
18,83,18,27,276,195,81
18,83,18,51,136,108,28
18,83,18,55,77,75,2
18,83,18,97,0,108,-108
18,83,18,153,99,107,-8
18,83,18,163,66,140,-74
18,85,17,31,98,54,44
18,85,18,3,278,483,-205
18,85,18,39,841,938,-97
18,85,18,49,165,241,-76
18,85,18,57,0,92,-92
18,85,18,69,58,51,7
18,85,18,97,76,97,-21
18,85,18,99,349,261,88
18,85,18,103,102,0,102
18,85,18,113,257,310,-53
18,85,18,141,197,212,-15
18,85,18,169,210,329,-119
18,85,18,183,302,381,-79
18,87,18,3,186,160,26
18,87,18,33,72,81,-9
18,87,18,39,484,641,-157
18,87,18,113,438,529,-91
18,87,18,141,0,61,-61
18,87,18,151,145,170,-25
18,87,26,149,210,241,-31
18,89,4,13,211,484,-273
18,89,4,19,0,83,-83
18,89,6,37,146,121,25
18,89,6,73,97,102,-5
18,89,8,31,0,56,-56
18,89,12,11,0,76,-76
18,89,12,31,0,72,-72
18,89,12,57,0,76,-76
18,89,12,71,0,145,-145
18,89,12,95,63,75,-12
18,89,12,103,0,50,-50
18,89,12,105,64,0,64
18,89,13,67,0,60,-60
18,89,13,121,0,85,-85
18,89,13,135,0,57,-57
18,89,17,31,13201,7109,6092
18,89,17,43,409,318,91
18,89,17,89,98,75,23
18,89,17,91,196,107,89
18,89,17,93,78,0,78
18,89,17,97,182,82,100
18,89,17,111,77,0,77
18,89,17,197,1797,728,1069
18,89,18,3,87,149,-62
18,89,18,39,73,75,-2
18,89,18,57,69,216,-147
18,89,18,63,0,124,-124
18,89,18,73,329,556,-227
18,89,18,81,0,79,-79
18,89,18,91,339,650,-311
18,89,18,97,957,1721,-764
18,89,18,105,81,128,-47
18,89,18,111,185,339,-154
18,89,18,127,3623,5428,-1805
18,89,18,141,195,220,-25
18,89,18,149,60,103,-43
18,89,18,157,220,256,-36
18,89,18,167,90,54,36
18,89,18,181,0,60,-60
18,89,26,21,0,63,-63
18,89,26,81,0,67,-67
18,89,26,163,61,71,-10
18,89,27,53,74,111,-37
18,89,32,3,102,252,-150
18,89,47,37,0,56,-56
18,89,48,29,68,100,-32
18,89,48,113,0,146,-146
18,89,48,121,0,93,-93
18,89,48,201,134,184,-50
18,89,48,439,0,110,-110
18,89,48,453,0,66,-66
18,89,55,79,78,135,-57
18,91,17,31,570,316,254
18,91,18,39,70,95,-25
18,91,18,89,650,339,311
18,91,18,97,130,234,-104
18,91,18,99,62,109,-47
18,91,18,127,1424,1154,270
18,91,18,141,583,694,-111
18,91,18,149,217,202,15
18,91,26,21,274,272,2
18,93,18,55,120,77,43
18,93,18,71,89,94,-5
18,93,18,81,0,56,-56
18,93,18,97,70,79,-9
18,93,18,105,742,590,152
18,93,18,117,204,321,-117
18,95,18,3,80,117,-37
18,95,18,35,760,906,-146
18,95,18,53,263,206,57
18,95,18,57,1246,1107,139
18,95,18,59,574,421,153
18,95,18,63,68,97,-29
18,95,18,65,459,428,31
18,95,18,67,118,117,1
18,95,18,81,85,78,7
18,95,18,97,1237,1041,196
18,95,18,159,160,175,-15
18,97,1,73,84,72,12
18,97,4,13,330,676,-346
18,97,4,19,77,94,-17
18,97,6,1,60,103,-43
18,97,6,37,470,494,-24
18,97,6,59,109,164,-55
18,97,6,65,114,100,14
18,97,6,67,0,66,-66
18,97,6,71,121,131,-10
18,97,6,73,266,271,-5
18,97,6,75,51,64,-13
18,97,6,81,0,54,-54
18,97,6,85,83,95,-12
18,97,8,1,65,0,65
18,97,8,5,122,111,11
18,97,8,13,0,57,-57
18,97,8,31,100,270,-170
18,97,8,35,0,63,-63
18,97,8,41,148,146,2
18,97,8,59,0,77,-77
18,97,11,1,79,101,-22
18,97,12,9,61,110,-49
18,97,12,11,302,124,178
18,97,12,15,0,94,-94
18,97,12,21,0,115,-115
18,97,12,31,128,199,-71
18,97,12,57,206,326,-120
18,97,12,69,0,81,-81
18,97,12,71,132,247,-115
18,97,12,81,69,90,-21
18,97,12,86,257,157,100
18,97,12,91,62,78,-16
18,97,12,95,146,183,-37
18,97,12,97,0,72,-72
18,97,12,99,140,94,46
18,97,12,101,67,141,-74
18,97,12,103,156,304,-148
18,97,12,105,56,133,-77
18,97,12,115,55,137,-82
18,97,12,127,0,81,-81
18,97,13,63,69,79,-10
18,97,13,67,76,138,-62
18,97,13,89,209,141,68
18,97,13,121,144,185,-41
18,97,13,135,123,121,2
18,97,15,3,118,81,37
18,97,17,19,165,96,69
18,97,17,31,1922,1287,635
18,97,17,43,186,157,29
18,97,17,89,78,60,18
18,97,17,97,173,76,97
18,97,17,111,54,0,54
18,97,17,113,65,0,65
18,97,17,115,78,0,78
18,97,17,143,145,69,76
18,97,17,167,109,0,109
18,97,17,183,106,76,30
18,97,17,197,118,100,18
18,97,18,3,914,753,161
18,97,18,5,573,431,142
18,97,18,11,1265,1936,-671
18,97,18,13,140,229,-89
18,97,18,17,89,73,16
18,97,18,19,119,120,-1
18,97,18,21,94,97,-3
18,97,18,23,146,101,45
18,97,18,27,71,0,71
18,97,18,29,62,0,62
18,97,18,31,145,124,21
18,97,18,35,780,397,383
18,97,18,37,70,63,7
18,97,18,39,286,191,95
18,97,18,43,67,72,-5
18,97,18,47,56,0,56
18,97,18,53,277,161,116
18,97,18,55,77,66,11
18,97,18,57,7738,11441,-3703
18,97,18,59,1980,3392,-1412
18,97,18,63,5482,7941,-2459
18,97,18,65,252,347,-95
18,97,18,67,360,291,69
18,97,18,71,133,139,-6
18,97,18,73,59,0,59
18,97,18,77,48,60,-12
18,97,18,79,66,80,-14
18,97,18,81,6167,7900,-1733
18,97,18,83,108,0,108
18,97,18,85,97,76,21
18,97,18,89,1721,957,764
18,97,18,91,234,130,104
18,97,18,93,79,70,9
18,97,18,95,1041,1237,-196
18,97,18,103,67,71,-4
18,97,18,105,1136,730,406
18,97,18,107,182,171,11
18,97,18,109,1563,2404,-841
18,97,18,113,49,0,49
18,97,18,119,166,206,-40
18,97,18,121,0,67,-67
18,97,18,127,220,207,13
18,97,18,133,381,435,-54
18,97,18,135,45,0,45
18,97,18,137,44,79,-35
18,97,18,139,98,114,-16
18,97,18,141,736,481,255
18,97,18,145,683,929,-246
18,97,18,157,1008,614,394
18,97,18,159,66,98,-32
18,97,18,163,338,244,94
18,97,18,167,591,339,252
18,97,18,173,76,67,9
18,97,18,177,216,151,65
18,97,18,181,93,0,93
18,97,19,103,59,0,59
18,97,19,153,74,103,-29
18,97,20,91,0,75,-75
18,97,20,173,59,0,59
18,97,21,67,122,85,37
18,97,21,111,449,405,44
18,97,21,227,54,0,54
18,97,22,71,55,62,-7
18,97,24,5,86,0,86
18,97,24,27,96,0,96
18,97,24,31,75,90,-15
18,97,24,33,104,51,53
18,97,24,510,63,0,63
18,97,25,17,62,121,-59
18,97,25,25,59,76,-17
18,97,26,21,166,84,82
18,97,26,49,62,0,62
18,97,26,65,64,57,7
18,97,26,77,93,79,14
18,97,26,81,149,120,29
18,97,26,99,64,49,15
18,97,26,125,115,170,-55
18,97,26,161,73,63,10
18,97,26,163,159,161,-2
18,97,27,53,101,148,-47
18,97,29,95,71,0,71
18,97,29,189,121,124,-3
18,97,29,510,112,100,12
18,97,32,3,190,292,-102
18,97,34,13,55,0,55
18,97,34,17,75,0,75
18,97,34,23,84,0,84
18,97,35,1,0,55,-55
18,97,36,5,127,0,127
18,97,36,47,192,86,106
18,97,36,59,114,0,114
18,97,36,61,94,149,-55
18,97,36,81,218,0,218
18,97,36,103,54,0,54
18,97,37,51,0,78,-78
18,97,37,63,0,65,-65
18,97,37,81,0,66,-66
18,97,37,119,156,195,-39
18,97,37,183,76,114,-38
18,97,39,17,140,101,39
18,97,39,35,142,179,-37
18,97,39,49,330,381,-51
18,97,39,61,322,282,40
18,97,39,95,74,50,24
18,97,39,113,163,127,36
18,97,39,165,0,67,-67
18,97,40,109,0,68,-68
18,97,41,51,66,70,-4
18,97,42,3,101,95,6
18,97,42,101,111,109,2
18,97,45,19,0,62,-62
18,97,45,45,0,83,-83
18,97,45,79,0,54,-54
18,97,47,37,258,278,-20
18,97,47,93,51,0,51
18,97,47,125,65,106,-41
18,97,47,157,160,126,34
18,97,47,165,0,56,-56
18,97,48,27,0,76,-76
18,97,48,29,116,202,-86
18,97,48,85,60,120,-60
18,97,48,113,234,285,-51
18,97,48,121,119,73,46
18,97,48,141,64,66,-2
18,97,48,201,364,341,23
18,97,48,339,0,77,-77
18,97,48,439,143,218,-75
18,97,48,453,138,147,-9
18,97,49,35,84,87,-3
18,97,51,13,0,60,-60
18,97,51,59,121,81,40
18,97,51,510,0,44,-44
18,97,53,33,203,303,-100
18,97,53,53,67,68,-1
18,97,53,61,0,52,-52
18,97,55,25,82,84,-2
18,97,55,79,209,181,28
18,99,18,3,0,52,-52
18,99,18,39,284,293,-9
18,99,18,49,203,193,10
18,99,18,85,261,349,-88
18,99,18,91,109,62,47
18,99,18,141,628,698,-70
18,99,18,149,276,284,-8
18,101,18,27,247,205,42
18,101,18,37,0,62,-62
18,103,18,3,60,82,-22
18,103,18,17,336,269,67
18,103,18,49,95,126,-31
18,103,18,53,133,212,-79
18,103,18,67,539,512,27
18,103,18,85,0,102,-102
18,103,18,97,71,67,4
18,103,18,169,182,153,29
18,105,4,13,58,80,-22
18,105,6,37,54,61,-7
18,105,6,73,54,77,-23
18,105,6,81,0,44,-44
18,105,6,85,0,115,-115
18,105,8,31,0,50,-50
18,105,17,31,246,336,-90
18,105,18,3,75,100,-25
18,105,18,5,146,136,10
18,105,18,13,136,136,0
18,105,18,35,50,0,50
18,105,18,55,529,479,50
18,105,18,57,188,319,-131
18,105,18,63,95,176,-81
18,105,18,71,55,61,-6
18,105,18,81,180,219,-39
18,105,18,89,128,81,47
18,105,18,93,590,742,-152
18,105,18,97,730,1136,-406
18,105,18,109,287,256,31
18,105,18,119,425,517,-92
18,105,18,127,46,51,-5
18,105,18,133,56,0,56
18,105,18,141,88,80,8
18,105,18,157,134,88,46
18,105,18,163,104,58,46
18,105,18,167,137,96,41
18,105,21,111,75,83,-8
18,105,25,17,0,66,-66
18,105,27,53,0,49,-49
18,105,36,47,57,45,12
18,105,36,61,0,78,-78
18,105,39,49,55,85,-30
18,105,39,61,0,55,-55
18,105,48,453,0,68,-68
18,105,53,33,45,160,-115
18,107,18,11,192,144,48
18,107,18,45,167,200,-33
18,107,18,63,178,144,34
18,107,18,97,171,182,-11
18,107,18,121,71,87,-16
18,107,18,133,148,160,-12
18,107,18,157,276,383,-107
18,109,18,13,127,116,11
18,109,18,57,85,98,-13
18,109,18,59,0,62,-62
18,109,18,63,961,851,110
18,109,18,81,817,868,-51
18,109,18,97,2404,1563,841
18,109,18,105,256,287,-31
18,109,18,119,147,148,-1
18,109,18,133,139,164,-25
18,111,17,31,93,0,93
18,111,18,73,216,322,-106
18,111,18,89,339,185,154
18,111,18,127,65,0,65
18,111,18,157,0,81,-81
18,113,18,3,769,620,149
18,113,18,33,467,508,-41
18,113,18,39,276,338,-62
18,113,18,85,310,257,53
18,113,18,87,529,438,91
18,113,18,97,0,49,-49
18,113,18,151,99,158,-59
18,113,18,183,239,265,-26
18,115,18,29,255,225,30
18,115,18,155,82,98,-16
18,115,39,61,71,0,71
18,117,18,25,74,87,-13
18,117,18,37,98,100,-2
18,117,18,93,321,204,117
18,117,18,175,111,122,-11
18,119,18,21,118,112,6
18,119,18,55,114,102,12
18,119,18,63,79,0,79
18,119,18,97,206,166,40
18,119,18,105,517,425,92
18,119,18,109,148,147,1
18,119,18,133,183,143,40
18,121,18,21,64,126,-62
18,121,18,97,67,0,67
18,121,18,107,87,71,16
18,121,18,133,82,58,24
18,121,18,165,118,173,-55
18,121,18,167,209,214,-5
18,123,18,37,89,116,-27
18,123,18,147,182,149,33
18,123,21,59,0,69,-69
18,123,21,91,117,80,37
18,125,18,27,0,69,-69
18,125,18,37,187,155,32
18,125,18,51,207,113,94
18,125,18,163,72,66,6
18,127,4,13,56,172,-116
18,127,6,37,0,56,-56
18,127,12,71,0,90,-90
18,127,12,103,0,69,-69
18,127,17,31,1422,731,691
18,127,17,43,124,99,25
18,127,17,89,59,0,59
18,127,17,97,59,0,59
18,127,17,197,291,90,201
18,127,18,3,91,65,26
18,127,18,39,0,81,-81
18,127,18,57,0,138,-138
18,127,18,73,339,325,14
18,127,18,89,5428,3623,1805
18,127,18,91,1154,1424,-270
18,127,18,97,207,220,-13
18,127,18,105,51,46,5
18,127,18,111,0,65,-65
18,127,18,131,0,60,-60
18,127,18,141,188,174,14
18,127,18,149,144,170,-26
18,127,18,157,97,102,-5
18,127,26,21,72,75,-3
18,127,32,3,0,80,-80
18,129,18,51,80,94,-14
18,129,18,163,1016,1006,10
18,129,18,173,105,102,3
18,131,18,49,66,98,-32
18,131,18,73,66,101,-35
18,131,18,127,60,0,60
18,131,18,149,170,126,44
18,131,18,157,0,84,-84
18,131,18,181,0,84,-84
18,133,18,21,179,292,-113
18,133,18,57,68,0,68
18,133,18,63,685,599,86
18,133,18,81,94,66,28
18,133,18,97,435,381,54
18,133,18,105,0,56,-56
18,133,18,107,160,148,12
18,133,18,109,164,139,25
18,133,18,119,143,183,-40
18,133,18,121,58,82,-24
18,133,18,167,95,100,-5
18,135,18,35,341,346,-5
18,135,18,65,63,66,-3
18,135,18,75,104,165,-61
18,135,18,97,0,45,-45
18,135,18,177,168,242,-74
18,135,39,37,208,262,-54
18,137,18,29,601,429,172
18,137,18,31,249,248,1
18,137,18,47,334,372,-38
18,137,18,77,57,96,-39
18,137,18,79,0,65,-65
18,137,18,97,79,44,35
18,137,39,61,196,124,72
18,139,18,31,139,207,-68
18,139,18,41,144,144,0
18,139,18,59,97,144,-47
18,139,18,65,121,173,-52
18,139,18,97,114,98,16
18,139,18,145,230,143,87
18,141,4,13,120,219,-99
18,141,6,37,122,93,29
18,141,6,59,0,50,-50
18,141,6,73,61,62,-1
18,141,6,85,0,65,-65
18,141,12,71,0,85,-85
18,141,12,103,0,68,-68
18,141,13,121,52,0,52
18,141,17,31,775,622,153
18,141,17,43,100,58,42
18,141,17,197,0,75,-75
18,141,18,3,231,264,-33
18,141,18,35,46,0,46
18,141,18,39,3325,3029,296
18,141,18,57,110,254,-144
18,141,18,63,0,99,-99
18,141,18,81,0,70,-70
18,141,18,85,212,197,15
18,141,18,87,61,0,61
18,141,18,89,220,195,25
18,141,18,91,694,583,111
18,141,18,97,481,736,-255
18,141,18,99,698,628,70
18,141,18,105,80,88,-8
18,141,18,127,174,188,-14
18,141,18,149,132,171,-39
18,141,18,157,93,103,-10
18,141,21,111,0,57,-57
18,141,26,21,1011,1004,7
18,141,26,27,534,709,-175
18,141,26,77,104,140,-36
18,141,26,81,73,102,-29
18,141,26,125,77,60,17
18,141,26,149,64,105,-41
18,141,26,159,86,71,15
18,141,26,163,0,68,-68
18,141,32,3,53,70,-17
18,141,36,61,0,78,-78
18,141,39,49,69,78,-9
18,141,41,51,0,59,-59
18,141,48,201,77,0,77
18,141,48,453,0,43,-43
18,141,53,33,0,90,-90
18,141,55,79,0,56,-56
18,143,18,19,448,354,94
18,143,18,43,79,89,-10
18,143,18,71,283,278,5
18,143,18,77,109,169,-60
18,143,18,79,68,0,68
18,143,18,175,127,160,-33
18,143,21,111,51,72,-21
18,145,18,5,202,191,11
18,145,18,31,251,224,27
18,145,18,57,58,98,-40
18,145,18,59,338,276,62
18,145,18,65,0,59,-59
18,145,18,81,470,383,87
18,145,18,97,929,683,246
18,145,18,139,143,230,-87
18,147,18,37,214,195,19
18,147,18,123,149,182,-33
18,147,18,163,148,147,1
18,147,18,173,190,201,-11
18,147,21,59,134,123,11
18,149,17,31,92,0,92
18,149,18,89,103,60,43
18,149,18,91,202,217,-15
18,149,18,99,284,276,8
18,149,18,127,170,144,26
18,149,18,131,126,170,-44
18,149,18,141,171,132,39
18,151,18,3,497,367,130
18,151,18,33,539,566,-27
18,151,18,87,170,145,25
18,151,18,113,158,99,59
18,151,26,23,195,120,75
18,151,26,59,0,92,-92
18,151,39,171,74,60,14
18,153,18,21,0,79,-79
18,153,18,55,190,208,-18
18,153,18,83,107,99,8
18,153,18,167,359,358,1
18,155,18,29,89,99,-10
18,155,18,77,100,114,-14
18,155,18,115,98,82,16
18,155,39,61,66,0,66
18,157,4,13,0,87,-87
18,157,6,1,0,72,-72
18,157,6,37,72,101,-29
18,157,6,73,61,115,-54
18,157,6,75,0,45,-45
18,157,6,85,0,199,-199
18,157,12,71,0,56,-56
18,157,17,19,62,89,-27
18,157,17,31,657,506,151
18,157,17,197,64,0,64
18,157,18,3,92,139,-47
18,157,18,5,0,60,-60
18,157,18,7,315,335,-20
18,157,18,11,203,242,-39
18,157,18,15,491,626,-135
18,157,18,17,171,94,77
18,157,18,23,545,576,-31
18,157,18,35,57,0,57
18,157,18,39,62,68,-6
18,157,18,45,149,195,-46
18,157,18,57,182,393,-211
18,157,18,63,122,153,-31
18,157,18,67,306,188,118
18,157,18,73,174,88,86
18,157,18,81,77,90,-13
18,157,18,89,256,220,36
18,157,18,97,614,1008,-394
18,157,18,105,88,134,-46
18,157,18,107,383,276,107
18,157,18,111,81,0,81
18,157,18,127,102,97,5
18,157,18,131,84,0,84
18,157,18,141,103,93,10
18,157,18,167,59,0,59
18,157,18,171,120,122,-2
18,157,18,181,533,510,23
18,157,25,17,0,75,-75
18,157,25,25,0,43,-43
18,157,26,125,0,56,-56
18,157,26,161,0,59,-59
18,157,27,53,0,56,-56
18,157,39,35,0,47,-47
18,157,39,49,0,51,-51
18,157,39,61,0,56,-56
18,157,48,201,0,109,-109
18,157,48,453,0,50,-50
18,157,53,33,0,157,-157
18,159,18,57,336,220,116
18,159,18,67,348,403,-55
18,159,18,95,175,160,15
18,159,18,97,98,66,32
18,161,18,41,0,117,-117
18,161,18,177,111,132,-21
18,161,39,17,130,78,52
18,163,4,13,79,67,12
18,163,6,37,56,0,56
18,163,17,31,86,101,-15
18,163,17,185,77,0,77
18,163,17,193,72,56,16
18,163,18,27,123,54,69
18,163,18,37,193,130,63
18,163,18,51,689,575,114
18,163,18,57,0,139,-139
18,163,18,83,140,66,74
18,163,18,97,244,338,-94
18,163,18,105,58,104,-46
18,163,18,125,66,72,-6
18,163,18,129,1006,1016,-10
18,163,18,147,147,148,-1
18,163,18,167,0,44,-44
18,163,18,173,2285,2780,-495
18,163,21,59,210,161,49
18,163,21,101,586,481,105
18,163,21,107,99,0,99
18,163,21,111,108,136,-28
18,163,21,225,61,0,61
18,163,29,189,0,80,-80
18,163,47,37,0,97,-97
18,165,17,183,116,65,51
18,165,18,45,76,96,-20
18,165,18,121,173,118,55
18,165,18,167,320,313,7
18,167,17,23,140,68,72
18,167,17,31,118,0,118
18,167,17,45,96,71,25
18,167,17,183,61,0,61
18,167,18,21,631,668,-37
18,167,18,55,97,100,-3
18,167,18,57,0,181,-181
18,167,18,63,93,230,-137
18,167,18,81,0,86,-86
18,167,18,89,54,90,-36
18,167,18,97,339,591,-252
18,167,18,105,96,137,-41
18,167,18,121,214,209,5
18,167,18,133,100,95,5
18,167,18,153,358,359,-1
18,167,18,157,0,59,-59
18,167,18,163,44,0,44
18,167,18,165,313,320,-7
18,169,18,3,101,148,-47
18,169,18,53,134,117,17
18,169,18,67,0,59,-59
18,169,18,69,156,230,-74
18,169,18,85,329,210,119
18,169,18,103,153,182,-29
18,169,18,183,0,88,-88
18,171,17,183,97,0,97
18,171,18,45,226,184,42
18,171,18,157,122,120,2
18,173,18,37,92,0,92
18,173,18,51,139,137,2
18,173,18,97,67,76,-9
18,173,18,129,102,105,-3
18,173,18,147,201,190,11
18,173,18,163,2780,2285,495
18,173,21,59,76,68,8
18,173,21,101,146,72,74
18,175,18,19,403,308,95
18,175,18,43,220,222,-2
18,175,18,61,192,166,26
18,175,18,71,97,78,19
18,175,18,117,122,111,11
18,175,18,143,160,127,33
18,175,21,111,113,101,12
18,177,18,35,65,79,-14
18,177,18,41,201,165,36
18,177,18,57,0,111,-111
18,177,18,59,0,68,-68
18,177,18,65,227,252,-25
18,177,18,97,151,216,-65
18,177,18,135,242,168,74
18,177,18,161,132,111,21
18,177,39,17,52,67,-15
18,177,39,37,63,76,-13
18,177,39,113,78,131,-53
18,177,39,135,249,163,86
18,179,18,1,276,221,55
18,179,18,3,628,547,81
18,179,18,9,108,0,108
18,179,18,69,194,290,-96
18,179,18,75,61,0,61
18,181,18,15,255,345,-90
18,181,18,17,96,169,-73
18,181,18,73,143,134,9
18,181,18,89,60,0,60
18,181,18,97,0,93,-93
18,181,18,131,84,0,84
18,181,18,157,510,533,-23
18,183,18,3,955,919,36
18,183,18,33,0,81,-81
18,183,18,69,128,116,12
18,183,18,85,381,302,79
18,183,18,113,265,239,26
18,183,18,169,88,0,88
19,1,19,77,69,87,-18
19,1,19,153,78,69,9
19,1,19,175,86,0,86
19,5,19,43,124,136,-12
19,5,19,191,86,103,-17
19,7,19,153,0,51,-51
19,7,19,185,79,0,79
19,9,19,29,63,0,63
19,11,19,13,84,94,-10
19,11,19,95,66,75,-9
19,11,19,103,58,71,-13
19,11,19,113,868,742,126
19,11,19,171,87,0,87
19,13,4,13,62,105,-43
19,13,17,31,120,68,52
19,13,19,11,94,84,10
19,13,19,17,420,565,-145
19,13,19,19,289,333,-44
19,13,19,23,192,240,-48
19,13,19,33,70,57,13
19,13,19,37,82,67,15
19,13,19,49,0,130,-130
19,13,19,61,97,113,-16
19,13,19,65,98,89,9
19,13,19,67,78,0,78
19,13,19,75,229,244,-15
19,13,19,83,66,0,66
19,13,19,103,150,232,-82
19,13,19,113,372,420,-48
19,13,19,127,110,69,41
19,13,19,153,260,605,-345
19,13,19,163,110,175,-65
19,13,19,169,90,82,8
19,13,19,171,106,135,-29
19,13,19,187,52,0,52
19,13,27,53,64,120,-56
19,13,48,113,0,58,-58
19,13,55,25,0,70,-70
19,15,19,49,164,170,-6
19,15,19,153,425,350,75
19,15,19,169,552,532,20
19,17,19,13,565,420,145
19,17,19,23,145,120,25
19,17,19,37,95,67,28
19,17,19,65,112,79,33
19,17,19,113,0,56,-56
19,17,19,153,0,62,-62
19,19,19,13,333,289,44
19,19,19,65,241,205,36
19,19,19,113,165,169,-4
19,21,12,86,59,0,59
19,21,19,35,0,125,-125
19,21,19,41,71,72,-1
19,21,19,109,0,72,-72
19,21,19,151,0,64,-64
19,21,19,153,64,90,-26
19,21,19,161,0,128,-128
19,21,19,193,0,120,-120
19,23,19,13,240,192,48
19,23,19,17,120,145,-25
19,23,19,75,75,69,6
19,25,19,153,0,54,-54
19,25,19,161,63,0,63
19,25,19,187,105,166,-61
19,27,19,47,116,86,30
19,27,19,49,0,60,-60
19,27,19,153,87,153,-66
19,27,19,161,82,52,30
19,29,19,9,0,63,-63
19,29,19,153,62,82,-20
19,29,19,155,109,116,-7
19,31,19,103,252,205,47
19,31,19,105,71,69,2
19,31,19,113,174,231,-57
19,31,19,139,207,245,-38
19,31,19,163,169,125,44
19,33,19,13,57,70,-13
19,33,19,49,0,49,-49
19,33,19,67,197,201,-4
19,33,19,69,142,143,-1
19,33,19,81,163,179,-16
19,33,19,113,0,59,-59
19,33,19,131,79,62,17
19,33,19,153,104,169,-65
19,33,19,189,98,76,22
19,33,19,195,170,179,-9
19,33,27,53,0,49,-49
19,35,19,21,125,0,125
19,35,19,141,62,0,62
19,35,19,149,0,75,-75
19,35,19,193,58,81,-23
19,37,19,13,67,82,-15
19,37,19,17,67,95,-28
19,37,19,67,120,108,12
19,39,19,53,107,62,45
19,39,19,153,146,147,-1
19,39,19,181,95,76,19
19,41,19,21,72,71,1
19,41,19,59,212,156,56
19,41,19,141,92,79,13
19,41,19,147,74,72,2
19,43,19,5,136,124,12
19,43,19,55,106,157,-51
19,43,19,61,105,49,56
19,43,19,65,73,60,13
19,43,19,113,67,0,67
19,43,55,23,92,73,19
19,45,17,15,96,81,15
19,45,17,31,92,94,-2
19,45,17,161,141,74,67
19,45,17,195,255,289,-34
19,45,19,61,0,70,-70
19,45,19,97,204,205,-1
19,45,19,103,0,67,-67
19,45,19,113,63,114,-51
19,45,19,163,619,604,15
19,47,19,27,86,116,-30
19,47,19,85,0,59,-59
19,47,19,153,0,89,-89
19,49,4,13,79,153,-74
19,49,17,31,97,71,26
19,49,18,57,75,0,75
19,49,19,13,130,0,130
19,49,19,15,170,164,6
19,49,19,27,60,0,60
19,49,19,33,49,0,49
19,49,19,73,66,73,-7
19,49,19,77,172,218,-46
19,49,19,99,75,55,20
19,49,19,103,167,81,86
19,49,19,113,130,0,130
19,49,19,121,189,211,-22
19,49,19,125,69,0,69
19,49,19,127,63,0,63
19,49,19,153,6674,5060,1614
19,49,19,163,112,0,112
19,49,19,169,199,147,52
19,49,19,181,284,355,-71
19,49,19,187,51,0,51
19,49,27,53,67,76,-9
19,49,31,55,95,99,-4
19,51,19,179,122,160,-38
19,53,19,39,62,107,-45
19,53,19,153,52,64,-12
19,55,19,43,157,106,51
19,55,19,61,215,153,62
19,55,19,105,73,52,21
19,55,19,113,173,154,19
19,57,17,31,104,85,19
19,57,17,71,80,81,-1
19,57,19,87,231,175,56
19,57,19,103,62,71,-9
19,57,19,111,264,273,-9
19,57,19,113,0,79,-79
19,57,19,115,72,0,72
19,57,19,153,0,91,-91
19,57,19,163,0,70,-70
19,59,19,41,156,212,-56
19,59,19,63,125,62,63
19,59,19,143,65,0,65
19,61,4,13,0,79,-79
19,61,17,31,278,284,-6
19,61,17,85,281,240,41
19,61,19,13,113,97,16
19,61,19,43,49,105,-56
19,61,19,45,70,0,70
19,61,19,55,153,215,-62
19,61,19,97,237,255,-18
19,61,19,103,95,115,-20
19,61,19,105,119,125,-6
19,61,19,113,177,215,-38
19,61,19,153,82,118,-36
19,61,19,163,111,170,-59
19,61,55,25,0,164,-164
19,61,55,43,280,261,19
19,61,55,65,0,48,-48
19,63,19,59,62,125,-63
19,65,19,13,89,98,-9
19,65,19,17,79,112,-33
19,65,19,19,205,241,-36
19,65,19,43,60,73,-13
19,65,19,191,75,74,1
19,67,19,13,0,78,-78
19,67,19,33,201,197,4
19,67,19,37,108,120,-12
19,67,19,131,0,72,-72
19,69,19,33,143,142,1
19,69,19,83,74,79,-5
19,71,19,129,61,0,61
19,71,19,145,86,68,18
19,71,31,131,72,0,72
19,71,31,153,66,0,66
19,73,19,49,73,66,7
19,73,19,77,0,56,-56
19,73,19,153,0,53,-53
19,75,19,13,244,229,15
19,75,19,23,69,75,-6
19,75,19,83,0,59,-59
19,75,19,127,75,0,75
19,75,19,171,60,71,-11
19,77,19,1,87,69,18
19,77,19,49,218,172,46
19,77,19,73,56,0,56
19,77,19,153,220,238,-18
19,79,19,153,91,94,-3
19,79,19,169,146,183,-37
19,79,19,187,141,128,13
19,79,19,197,72,0,72
19,81,19,33,179,163,16
19,81,19,189,120,107,13
19,83,19,13,0,66,-66
19,83,19,69,79,74,5
19,83,19,75,59,0,59
19,83,19,127,59,60,-1
19,83,19,153,80,99,-19
19,83,19,169,98,88,10
19,85,19,47,59,0,59
19,85,19,155,191,164,27
19,85,19,165,0,54,-54
19,85,31,55,204,121,83
19,85,31,153,63,0,63
19,85,31,177,0,72,-72
19,87,19,57,175,231,-56
19,87,19,101,69,79,-10
19,87,19,103,58,108,-50
19,87,19,111,99,81,18
19,87,19,183,97,101,-4
19,89,19,131,0,65,-65
19,89,19,191,116,84,32
19,91,19,151,62,0,62
19,91,19,187,130,142,-12
19,91,19,197,0,64,-64
19,93,19,161,67,0,67
19,93,19,193,0,56,-56
19,95,19,11,75,66,9
19,95,19,103,288,226,62
19,95,19,107,61,0,61
19,95,19,113,230,161,69
19,95,19,157,0,62,-62
19,97,19,45,205,204,1
19,97,19,61,255,237,18
19,97,19,163,92,99,-7
19,99,19,49,55,75,-20
19,99,19,123,69,62,7
19,99,19,125,176,176,0
19,99,19,127,125,135,-10
19,99,19,153,963,834,129
19,99,19,157,216,207,9
19,99,19,169,93,87,6
19,99,19,181,74,0,74
19,101,19,87,79,69,10
19,101,19,103,0,61,-61
19,101,19,107,69,75,-6
19,101,19,177,100,100,0
19,101,19,179,134,92,42
19,103,4,13,71,155,-84
19,103,6,37,100,121,-21
19,103,6,73,0,78,-78
19,103,8,31,0,110,-110
19,103,17,31,503,519,-16
19,103,17,43,83,71,12
19,103,17,97,50,61,-11
19,103,17,161,85,74,11
19,103,17,197,0,52,-52
19,103,18,97,0,59,-59
19,103,19,11,71,58,13
19,103,19,13,232,150,82
19,103,19,31,205,252,-47
19,103,19,45,67,0,67
19,103,19,49,81,167,-86
19,103,19,57,71,62,9
19,103,19,61,115,95,20
19,103,19,87,108,58,50
19,103,19,95,226,288,-62
19,103,19,101,61,0,61
19,103,19,111,81,0,81
19,103,19,113,1581,2072,-491
19,103,19,115,73,65,8
19,103,19,139,297,251,46
19,103,19,153,373,605,-232
19,103,19,163,332,236,96
19,103,19,169,124,78,46
19,103,19,183,381,437,-56
19,103,20,91,0,60,-60
19,103,27,53,92,210,-118
19,103,27,123,0,62,-62
19,103,29,189,0,59,-59
19,103,31,55,74,76,-2
19,103,32,3,0,52,-52
19,103,36,61,0,48,-48
19,103,48,201,0,85,-85
19,103,48,453,0,49,-49
19,103,53,33,0,93,-93
19,103,55,25,74,143,-69
19,103,55,79,0,77,-77
19,105,19,31,69,71,-2
19,105,19,55,52,73,-21
19,105,19,61,125,119,6
19,105,19,113,446,446,0
19,107,19,95,0,61,-61
19,107,19,101,75,69,6
19,107,19,123,108,86,22
19,107,19,179,120,84,36
19,107,19,183,95,63,32
19,109,19,21,72,0,72
19,109,19,147,57,85,-28
19,109,19,153,70,78,-8
19,111,17,67,213,186,27
19,111,19,57,273,264,9
19,111,19,87,81,99,-18
19,111,19,103,0,81,-81
19,111,19,153,0,90,-90
19,111,29,45,110,67,43
19,113,4,13,167,264,-97
19,113,4,19,0,74,-74
19,113,6,37,0,45,-45
19,113,6,73,0,55,-55
19,113,8,31,0,67,-67
19,113,12,9,0,72,-72
19,113,12,11,107,0,107
19,113,17,31,356,320,36
19,113,17,161,130,83,47
19,113,19,11,742,868,-126
19,113,19,13,420,372,48
19,113,19,17,56,0,56
19,113,19,19,169,165,4
19,113,19,31,231,174,57
19,113,19,33,59,0,59
19,113,19,43,0,67,-67
19,113,19,45,114,63,51
19,113,19,49,0,130,-130
19,113,19,55,154,173,-19
19,113,19,57,79,0,79
19,113,19,61,215,177,38
19,113,19,95,161,230,-69
19,113,19,103,2072,1581,491
19,113,19,105,446,446,0
19,113,19,127,63,0,63
19,113,19,139,124,0,124
19,113,19,153,351,591,-240
19,113,19,163,215,239,-24
19,113,19,169,109,168,-59
19,113,19,171,0,71,-71
19,113,19,179,62,0,62
19,113,19,183,91,77,14
19,113,27,53,88,145,-57
19,113,29,95,0,65,-65
19,113,31,55,84,86,-2
19,113,32,3,0,55,-55
19,113,48,113,0,69,-69
19,113,48,201,48,0,48
19,113,55,25,63,81,-18
19,115,19,57,0,72,-72
19,115,19,103,65,73,-8
19,115,19,139,266,223,43
19,117,19,125,0,55,-55
19,117,19,153,63,98,-35
19,117,19,181,0,69,-69
19,119,19,167,91,94,-3
19,119,46,99,70,113,-43
19,121,19,49,211,189,22
19,121,19,153,428,315,113
19,121,19,181,209,197,12
19,123,19,99,62,69,-7
19,123,19,107,86,108,-22
19,123,19,125,171,213,-42
19,123,19,153,78,138,-60
19,123,19,157,0,61,-61
19,123,19,179,183,151,32
19,125,19,49,0,69,-69
19,125,19,99,176,176,0
19,125,19,117,55,0,55
19,125,19,123,213,171,42
19,125,19,153,415,477,-62
19,125,19,181,136,124,12
19,127,19,13,69,110,-41
19,127,19,49,0,63,-63
19,127,19,75,0,75,-75
19,127,19,83,60,59,1
19,127,19,99,135,125,10
19,127,19,113,0,63,-63
19,127,19,153,230,417,-187
19,127,19,157,57,84,-27
19,127,19,169,158,166,-8
19,127,19,171,252,196,56
19,129,19,71,0,61,-61
19,129,19,137,61,0,61
19,129,19,155,225,293,-68
19,129,31,55,204,105,99
19,129,31,153,165,128,37
19,131,19,33,62,79,-17
19,131,19,67,72,0,72
19,131,19,89,65,0,65
19,133,19,193,163,220,-57
19,135,19,179,73,67,6
19,137,19,129,0,61,-61
19,137,19,145,136,0,136
19,137,19,155,0,103,-103
19,137,31,55,0,54,-54
19,139,17,131,66,0,66
19,139,17,161,117,124,-7
19,139,19,31,245,207,38
19,139,19,103,251,297,-46
19,139,19,113,0,124,-124
19,139,19,115,223,266,-43
19,139,19,153,0,55,-55
19,139,19,163,346,350,-4
19,141,19,35,0,62,-62
19,141,19,41,79,92,-13
19,141,19,143,85,85,0
19,141,19,167,137,182,-45
19,143,19,59,0,65,-65
19,143,19,141,85,85,0
19,145,19,71,68,86,-18
19,145,19,137,0,136,-136
19,145,19,155,59,0,59
19,145,19,173,79,0,79
19,147,19,41,72,74,-2
19,147,19,109,85,57,28
19,149,19,35,75,0,75
19,149,19,167,93,122,-29
19,149,19,193,578,622,-44
19,149,31,43,65,0,65
19,149,46,127,0,75,-75
19,151,19,21,64,0,64
19,151,19,91,0,62,-62
19,153,4,13,321,473,-152
19,153,4,19,0,61,-61
19,153,4,21,0,76,-76
19,153,6,37,196,115,81
19,153,6,59,77,0,77
19,153,6,65,62,70,-8
19,153,6,73,113,108,5
19,153,8,1,69,0,69
19,153,8,5,99,115,-16
19,153,8,13,0,73,-73
19,153,8,31,157,129,28
19,153,8,41,108,121,-13
19,153,8,59,61,62,-1
19,153,8,69,0,77,-77
19,153,12,31,0,50,-50
19,153,12,57,80,71,9
19,153,12,71,0,57,-57
19,153,12,103,0,51,-51
19,153,13,89,71,0,71
19,153,15,3,69,0,69
19,153,17,31,483,406,77
19,153,17,43,97,75,22
19,153,17,161,142,62,80
19,153,17,197,60,0,60
19,153,18,97,103,74,29
19,153,19,1,69,78,-9
19,153,19,7,51,0,51
19,153,19,13,605,260,345
19,153,19,15,350,425,-75
19,153,19,17,62,0,62
19,153,19,21,90,64,26
19,153,19,25,54,0,54
19,153,19,27,153,87,66
19,153,19,29,82,62,20
19,153,19,33,169,104,65
19,153,19,39,147,146,1
19,153,19,47,89,0,89
19,153,19,49,5060,6674,-1614
19,153,19,53,64,52,12
19,153,19,57,91,0,91
19,153,19,61,118,82,36
19,153,19,73,53,0,53
19,153,19,77,238,220,18
19,153,19,79,94,91,3
19,153,19,83,99,80,19
19,153,19,99,834,963,-129
19,153,19,103,605,373,232
19,153,19,109,78,70,8
19,153,19,111,90,0,90
19,153,19,113,591,351,240
19,153,19,117,98,63,35
19,153,19,121,315,428,-113
19,153,19,123,138,78,60
19,153,19,125,477,415,62
19,153,19,127,417,230,187
19,153,19,139,55,0,55
19,153,19,155,111,78,33
19,153,19,157,141,140,1
19,153,19,159,51,0,51
19,153,19,163,441,256,185
19,153,19,169,1803,1259,544
19,153,19,171,74,0,74
19,153,19,175,137,64,73
19,153,19,179,239,119,120
19,153,19,181,1923,2456,-533
19,153,19,187,254,151,103
19,153,19,193,158,102,56
19,153,19,197,64,0,64
19,153,20,91,165,137,28
19,153,21,111,59,0,59
19,153,27,3,0,87,-87
19,153,27,37,98,100,-2
19,153,27,53,288,428,-140
19,153,27,123,98,155,-57
19,153,27,163,0,65,-65
19,153,29,19,55,0,55
19,153,29,47,89,67,22
19,153,29,95,136,154,-18
19,153,29,189,59,78,-19
19,153,31,55,297,305,-8
19,153,31,109,103,76,27
19,153,31,153,75,75,0
19,153,32,3,119,106,13
19,153,36,47,0,68,-68
19,153,37,119,0,56,-56
19,153,38,17,0,65,-65
19,153,39,49,85,86,-1
19,153,41,51,69,58,11
19,153,46,99,125,68,57
19,153,48,29,77,103,-26
19,153,48,85,73,100,-27
19,153,48,113,94,132,-38
19,153,48,121,56,0,56
19,153,48,201,186,124,62
19,153,48,439,68,69,-1
19,153,48,453,87,0,87
19,153,53,33,83,117,-34
19,153,55,25,104,116,-12
19,153,55,79,0,56,-56
19,155,4,13,0,71,-71
19,155,19,29,116,109,7
19,155,19,85,164,191,-27
19,155,19,129,293,225,68
19,155,19,137,103,0,103
19,155,19,145,0,59,-59
19,155,19,153,78,111,-33
19,155,19,165,170,160,10
19,155,31,55,1977,2035,-58
19,155,31,109,73,73,0
19,155,31,153,624,717,-93
19,157,19,95,62,0,62
19,157,19,99,207,216,-9
19,157,19,123,61,0,61
19,157,19,127,84,57,27
19,157,19,153,140,141,-1
19,159,19,153,0,51,-51
19,161,19,21,128,0,128
19,161,19,25,0,63,-63
19,161,19,27,52,82,-30
19,161,19,93,0,67,-67
19,163,4,13,68,173,-105
19,163,12,71,0,61,-61
19,163,17,31,367,247,120
19,163,17,43,66,0,66
19,163,17,73,249,246,3
19,163,17,95,62,0,62
19,163,17,131,93,63,30
19,163,17,143,78,0,78
19,163,17,161,2604,2215,389
19,163,17,179,51,0,51
19,163,17,195,78,86,-8
19,163,17,197,60,0,60
19,163,19,13,175,110,65
19,163,19,31,125,169,-44
19,163,19,45,604,619,-15
19,163,19,49,0,112,-112
19,163,19,57,70,0,70
19,163,19,61,170,111,59
19,163,19,97,99,92,7
19,163,19,103,236,332,-96
19,163,19,113,239,215,24
19,163,19,139,350,346,4
19,163,19,153,256,441,-185
19,163,19,169,53,65,-12
19,163,20,91,0,79,-79
19,163,27,53,0,54,-54
19,163,32,3,0,66,-66
19,163,55,25,0,56,-56
19,165,19,85,54,0,54
19,165,19,155,160,170,-10
19,165,31,55,74,83,-9
19,167,19,119,94,91,3
19,167,19,141,182,137,45
19,167,19,149,122,93,29
19,167,19,193,75,103,-28
19,167,46,83,61,96,-35
19,167,46,99,64,92,-28
19,169,4,13,0,83,-83
19,169,6,73,0,57,-57
19,169,6,85,0,44,-44
19,169,17,31,67,94,-27
19,169,19,13,82,90,-8
19,169,19,15,532,552,-20
19,169,19,49,147,199,-52
19,169,19,79,183,146,37
19,169,19,83,88,98,-10
19,169,19,99,87,93,-6
19,169,19,103,78,124,-46
19,169,19,113,168,109,59
19,169,19,127,166,158,8
19,169,19,153,1259,1803,-544
19,169,19,163,65,53,12
19,169,19,181,58,66,-8
19,169,19,187,116,56,60
19,169,19,193,50,0,50
19,169,27,53,60,112,-52
19,169,27,123,0,55,-55
19,169,31,55,0,71,-71
19,169,53,33,0,85,-85
19,169,55,25,0,79,-79
19,171,19,11,0,87,-87
19,171,19,13,135,106,29
19,171,19,75,71,60,11
19,171,19,113,71,0,71
19,171,19,127,196,252,-56
19,171,19,153,0,74,-74
19,173,19,145,0,79,-79
19,175,19,1,0,86,-86
19,175,19,153,64,137,-73
19,177,19,101,100,100,0
19,177,29,199,0,86,-86
19,179,17,31,88,0,88
19,179,19,51,160,122,38
19,179,19,101,92,134,-42
19,179,19,107,84,120,-36
19,179,19,113,0,62,-62
19,179,19,123,151,183,-32
19,179,19,135,67,73,-6
19,179,19,153,119,239,-120
19,179,19,193,0,104,-104
19,179,29,21,139,0,139
19,181,19,39,76,95,-19
19,181,19,49,355,284,71
19,181,19,99,0,74,-74
19,181,19,117,69,0,69
19,181,19,121,197,209,-12
19,181,19,125,124,136,-12
19,181,19,153,2456,1923,533
19,181,19,169,66,58,8
19,183,19,87,101,97,4
19,183,19,103,437,381,56
19,183,19,107,63,95,-32
19,183,19,113,77,91,-14
19,185,19,7,0,79,-79
19,187,19,13,0,52,-52
19,187,19,25,166,105,61
19,187,19,49,0,51,-51
19,187,19,79,128,141,-13
19,187,19,91,142,130,12
19,187,19,153,151,254,-103
19,187,19,169,56,116,-60
19,187,19,197,67,61,6
19,189,19,33,76,98,-22
19,189,19,81,107,120,-13
19,189,19,195,47,0,47
19,191,19,5,103,86,17
19,191,19,65,74,75,-1
19,191,19,89,84,116,-32
19,193,4,13,0,62,-62
19,193,19,21,120,0,120
19,193,19,35,81,58,23
19,193,19,93,56,0,56
19,193,19,133,220,163,57
19,193,19,149,622,578,44
19,193,19,153,102,158,-56
19,193,19,167,103,75,28
19,193,19,169,0,50,-50
19,193,19,179,104,0,104
19,193,27,53,0,62,-62
19,193,31,43,879,711,168
19,193,31,55,162,239,-77
19,193,31,153,0,49,-49
19,193,40,139,50,0,50
19,193,46,83,0,74,-74
19,193,46,99,117,118,-1
19,193,46,127,339,578,-239
19,195,19,33,179,170,9
19,195,19,189,0,47,-47
19,197,19,79,0,72,-72
19,197,19,91,64,0,64
19,197,19,153,0,64,-64
19,197,19,187,61,67,-6
20,1,20,133,127,137,-10
20,3,20,59,77,68,9
20,3,20,91,72,0,72
20,5,20,87,0,64,-64
20,5,20,91,65,69,-4
20,5,20,103,115,120,-5
20,5,20,177,0,69,-69
20,5,29,21,105,81,24
20,5,29,95,0,59,-59
20,5,29,165,0,59,-59
20,9,20,51,0,59,-59
20,9,20,53,0,59,-59
20,9,20,91,0,78,-78
20,9,20,145,63,60,3
20,9,20,155,0,70,-70
20,9,20,159,77,83,-6
20,9,20,169,0,82,-82
20,9,20,173,68,111,-43
20,11,20,37,83,112,-29
20,11,20,91,0,100,-100
20,11,20,107,109,0,109
20,11,29,217,71,100,-29
20,13,20,131,80,69,11
20,13,20,177,0,66,-66
20,15,20,35,138,111,27
20,15,20,73,84,0,84
20,15,20,79,131,142,-11
20,15,20,91,73,130,-57
20,15,20,103,105,0,105
20,15,20,115,68,0,68
20,15,20,155,0,66,-66
20,15,20,173,2844,2663,181
20,15,20,191,100,0,100
20,17,20,111,0,70,-70
20,21,20,37,221,229,-8
20,21,20,99,59,78,-19
20,21,29,97,376,409,-33
20,21,29,145,123,117,6
20,21,40,115,133,152,-19
20,25,20,57,73,0,73
20,27,20,161,103,85,18
20,29,20,157,0,64,-64
20,29,20,169,0,68,-68
20,31,20,111,86,95,-9
20,35,20,15,111,138,-27
20,35,20,173,427,619,-192
20,35,20,191,246,167,79
20,35,40,71,95,140,-45
20,37,20,11,112,83,29
20,37,20,21,229,221,8
20,37,20,91,121,190,-69
20,37,20,99,119,98,21
20,37,20,125,67,0,67
20,37,20,133,106,71,35
20,37,20,173,73,121,-48
20,37,29,11,68,0,68
20,37,29,95,0,66,-66
20,37,29,97,186,270,-84
20,41,20,61,216,169,47
20,41,20,91,0,53,-53
20,41,20,161,83,89,-6
20,41,20,169,204,236,-32
20,43,29,21,182,192,-10
20,45,4,13,50,87,-37
20,45,6,37,90,64,26
20,45,6,73,0,65,-65
20,45,8,31,0,49,-49
20,45,8,41,0,55,-55
20,45,17,31,50,73,-23
20,45,20,51,56,0,56
20,45,20,59,300,211,89
20,45,20,87,279,311,-32
20,45,20,91,1368,1898,-530
20,45,20,103,378,351,27
20,45,20,111,59,51,8
20,45,20,121,107,0,107
20,45,20,139,86,67,19
20,45,20,155,65,0,65
20,45,20,161,158,67,91
20,45,20,169,77,0,77
20,45,20,173,254,213,41
20,45,20,177,907,773,134
20,45,20,209,254,255,-1
20,45,29,37,0,49,-49
20,45,29,47,54,120,-66
20,45,29,95,378,591,-213
20,45,29,165,0,64,-64
20,45,48,113,0,79,-79
20,45,48,201,0,67,-67
20,45,48,453,0,53,-53
20,51,20,9,59,0,59
20,51,20,45,0,56,-56
20,51,20,91,0,110,-110
20,51,20,163,72,65,7
20,51,20,167,108,101,7
20,51,20,169,0,63,-63
20,51,20,173,80,140,-60
20,53,20,9,59,0,59
20,53,20,169,68,74,-6
20,55,20,57,214,148,66
20,55,20,67,81,0,81
20,55,20,93,109,119,-10
20,55,20,173,154,160,-6
20,55,20,175,149,0,149
20,57,20,25,0,73,-73
20,57,20,55,148,214,-66
20,57,20,69,105,79,26
20,57,20,91,0,77,-77
20,57,20,173,90,199,-109
20,57,20,175,79,0,79
20,57,48,201,0,52,-52
20,59,20,3,68,77,-9
20,59,20,45,211,300,-89
20,59,20,91,439,465,-26
20,59,20,121,118,159,-41
20,59,20,139,102,130,-28
20,59,20,177,86,109,-23
20,59,29,95,64,67,-3
20,61,2,90,130,83,47
20,61,4,13,82,89,-7
20,61,6,37,69,75,-6
20,61,6,71,120,98,22
20,61,8,41,240,310,-70
20,61,13,51,0,103,-103
20,61,13,179,132,224,-92
20,61,13,215,110,90,20
20,61,15,3,250,278,-28
20,61,20,41,169,216,-47
20,61,20,91,0,99,-99
20,61,20,161,884,1011,-127
20,61,20,169,65,71,-6
20,61,20,173,101,130,-29
20,61,20,177,0,89,-89
20,61,21,47,0,97,-97
20,61,29,95,0,62,-62
20,61,29,169,113,96,17
20,61,36,45,119,115,4
20,61,37,51,117,132,-15
20,61,37,85,0,88,-88
20,61,40,31,81,0,81
20,61,45,79,84,93,-9
20,61,47,125,113,245,-132
20,61,48,27,277,300,-23
20,61,48,29,147,176,-29
20,61,48,99,0,117,-117
20,61,48,141,351,247,104
20,61,48,201,71,0,71
20,61,51,149,0,102,-102
20,61,53,53,155,252,-97
20,61,53,67,0,89,-89
20,67,20,55,0,81,-81
20,69,20,57,79,105,-26
20,73,20,15,0,84,-84
20,77,20,173,65,73,-8
20,79,20,15,142,131,11
20,79,20,113,187,159,28
20,79,20,115,142,132,10
20,79,20,155,128,185,-57
20,79,20,173,884,891,-7
20,85,20,87,76,0,76
20,85,20,177,311,339,-28
20,87,20,5,64,0,64
20,87,20,45,311,279,32
20,87,20,85,0,76,-76
20,87,20,91,0,81,-81
20,87,20,103,193,138,55
20,87,20,177,513,388,125
20,91,4,13,389,595,-206
20,91,4,19,93,72,21
20,91,4,21,0,65,-65
20,91,5,7,135,140,-5
20,91,5,143,72,49,23
20,91,6,1,78,79,-1
20,91,6,37,409,309,100
20,91,6,59,204,191,13
20,91,6,65,104,62,42
20,91,6,67,0,78,-78
20,91,6,71,85,69,16
20,91,6,73,286,232,54
20,91,6,75,0,51,-51
20,91,6,81,0,62,-62
20,91,6,85,60,118,-58
20,91,8,1,90,87,3
20,91,8,5,177,184,-7
20,91,8,13,0,80,-80
20,91,8,31,158,247,-89
20,91,8,35,158,166,-8
20,91,8,41,164,220,-56
20,91,8,59,76,129,-53
20,91,8,69,61,138,-77
20,91,11,1,0,46,-46
20,91,12,9,0,67,-67
20,91,12,11,120,117,3
20,91,12,21,0,129,-129
20,91,12,31,56,80,-24
20,91,12,57,108,85,23
20,91,12,71,91,123,-32
20,91,12,81,0,70,-70
20,91,12,86,90,63,27
20,91,12,95,100,97,3
20,91,12,99,92,98,-6
20,91,12,103,70,129,-59
20,91,12,115,0,70,-70
20,91,12,117,70,0,70
20,91,13,67,0,87,-87
20,91,13,121,66,88,-22
20,91,15,3,59,0,59
20,91,17,31,458,354,104
20,91,17,43,118,113,5
20,91,18,57,0,70,-70
20,91,18,97,75,0,75
20,91,19,103,60,0,60
20,91,19,153,137,165,-28
20,91,19,163,79,0,79
20,91,20,3,0,72,-72
20,91,20,5,69,65,4
20,91,20,9,78,0,78
20,91,20,11,100,0,100
20,91,20,15,130,73,57
20,91,20,37,190,121,69
20,91,20,41,53,0,53
20,91,20,45,1898,1368,530
20,91,20,51,110,0,110
20,91,20,57,77,0,77
20,91,20,59,465,439,26
20,91,20,61,99,0,99
20,91,20,87,81,0,81
20,91,20,103,820,1021,-201
20,91,20,107,110,141,-31
20,91,20,111,181,78,103
20,91,20,113,46,0,46
20,91,20,121,1126,1485,-359
20,91,20,125,0,74,-74
20,91,20,139,66,65,1
20,91,20,149,90,0,90
20,91,20,155,108,0,108
20,91,20,161,494,187,307
20,91,20,169,156,101,55
20,91,20,173,890,529,361
20,91,20,177,762,382,380
20,91,20,209,4767,4384,383
20,91,24,31,67,55,12
20,91,25,17,56,74,-18
20,91,26,125,63,0,63
20,91,27,53,129,143,-14
20,91,29,15,0,68,-68
20,91,29,19,221,110,111
20,91,29,21,149,62,87
20,91,29,29,82,103,-21
20,91,29,37,761,1069,-308
20,91,29,43,61,0,61
20,91,29,47,1444,1454,-10
20,91,29,77,259,169,90
20,91,29,95,8991,8596,395
20,91,29,97,118,72,46
20,91,29,101,120,104,16
20,91,29,165,825,1015,-190
20,91,29,183,163,110,53
20,91,29,189,456,262,194
20,91,29,510,69,65,4
20,91,31,55,306,244,62
20,91,31,109,165,147,18
20,91,31,153,90,59,31
20,91,32,3,142,213,-71
20,91,34,17,65,0,65
20,91,34,23,68,0,68
20,91,36,47,93,58,35
20,91,36,61,77,85,-8
20,91,36,81,76,0,76
20,91,37,119,98,82,16
20,91,37,183,102,156,-54
20,91,39,35,0,70,-70
20,91,39,49,66,65,1
20,91,40,27,60,0,60
20,91,40,109,173,148,25
20,91,40,143,176,128,48
20,91,41,51,0,48,-48
20,91,41,67,0,79,-79
20,91,42,3,71,59,12
20,91,47,37,75,61,14
20,91,47,157,78,54,24
20,91,48,29,132,187,-55
20,91,48,85,188,310,-122
20,91,48,113,285,310,-25
20,91,48,121,146,152,-6
20,91,48,201,256,280,-24
20,91,48,439,226,274,-48
20,91,48,453,111,207,-96
20,91,48,491,82,98,-16
20,91,49,35,0,105,-105
20,91,51,59,75,105,-30
20,91,53,33,173,334,-161
20,93,20,55,119,109,10
20,95,20,155,62,0,62
20,95,20,173,233,203,30
20,99,20,21,78,59,19
20,99,20,37,98,119,-21
20,99,20,125,123,120,3
20,99,20,133,107,129,-22
20,99,29,97,0,110,-110
20,103,4,13,66,69,-3
20,103,6,71,110,0,110
20,103,8,41,133,192,-59
20,103,15,3,208,219,-11
20,103,20,5,120,115,5
20,103,20,15,0,105,-105
20,103,20,45,351,378,-27
20,103,20,87,138,193,-55
20,103,20,91,1021,820,201
20,103,20,161,0,74,-74
20,103,20,173,76,79,-3
20,103,20,177,109,101,8
20,103,20,209,1196,929,267
20,103,22,115,105,0,105
20,103,29,47,151,187,-36
20,103,29,95,268,293,-25
20,103,29,165,288,275,13
20,103,29,169,99,0,99
20,103,36,71,111,0,111
20,103,37,51,95,149,-54
20,103,40,31,92,0,92
20,103,47,125,97,124,-27
20,103,48,27,136,225,-89
20,103,48,141,137,186,-49
20,103,51,59,135,136,-1
20,103,53,53,122,156,-34
20,103,53,67,108,87,21
20,105,20,169,0,57,-57
20,107,20,11,0,109,-109
20,107,20,91,141,110,31
20,107,20,121,210,133,77
20,109,20,193,0,70,-70
20,111,20,17,70,0,70
20,111,20,31,95,86,9
20,111,20,45,51,59,-8
20,111,20,91,78,181,-103
20,111,20,173,128,135,-7
20,111,20,177,105,148,-43
20,111,29,95,0,78,-78
20,113,20,79,159,187,-28
20,113,20,91,0,46,-46
20,113,20,115,68,68,0
20,113,20,155,195,243,-48
20,113,20,159,64,60,4
20,113,20,169,213,182,31
20,113,20,173,152,197,-45
20,115,20,15,0,68,-68
20,115,20,79,132,142,-10
20,115,20,113,68,68,0
20,115,20,173,109,133,-24
20,117,20,131,0,53,-53
20,121,20,45,0,107,-107
20,121,20,59,159,118,41
20,121,20,91,1485,1126,359
20,121,20,107,133,210,-77
20,121,20,209,89,0,89
20,121,29,37,127,104,23
20,121,29,95,132,106,26
20,125,20,37,0,67,-67
20,125,20,91,74,0,74
20,125,20,99,120,123,-3
20,125,20,173,98,98,0
20,125,20,205,101,99,2
20,125,40,105,80,76,4
20,125,40,143,63,95,-32
20,125,40,147,129,205,-76
20,131,20,13,69,80,-11
20,131,20,117,53,0,53
20,131,20,177,71,49,22
20,133,20,1,137,127,10
20,133,20,37,71,106,-35
20,133,20,99,129,107,22
20,133,20,205,78,60,18
20,139,20,45,67,86,-19
20,139,20,59,130,102,28
20,139,20,91,65,66,-1
20,139,20,177,500,471,29
20,143,20,169,226,206,20
20,145,20,9,60,63,-3
20,149,20,91,0,90,-90
20,149,20,161,812,620,192
20,149,20,177,124,229,-105
20,149,20,197,80,133,-53
20,151,20,173,0,134,-134
20,155,20,9,70,0,70
20,155,20,15,66,0,66
20,155,20,45,0,65,-65
20,155,20,79,185,128,57
20,155,20,91,0,108,-108
20,155,20,95,0,62,-62
20,155,20,113,243,195,48
20,155,20,159,160,143,17
20,155,20,161,0,56,-56
20,155,20,169,73,101,-28
20,155,20,173,701,783,-82
20,155,29,95,0,63,-63
20,157,20,29,64,0,64
20,159,20,9,83,77,6
20,159,20,113,60,64,-4
20,159,20,155,143,160,-17
20,161,2,90,0,75,-75
20,161,4,13,0,74,-74
20,161,6,37,82,54,28
20,161,8,41,87,165,-78
20,161,13,215,94,0,94
20,161,15,3,106,134,-28
20,161,17,31,0,58,-58
20,161,20,27,85,103,-18
20,161,20,41,89,83,6
20,161,20,45,67,158,-91
20,161,20,61,1011,884,127
20,161,20,91,187,494,-307
20,161,20,103,74,0,74
20,161,20,149,620,812,-192
20,161,20,155,56,0,56
20,161,20,169,110,110,0
20,161,20,173,151,246,-95
20,161,20,177,200,266,-66
20,161,20,209,0,94,-94
20,161,29,95,61,209,-148
20,161,37,51,0,71,-71
20,161,47,125,75,82,-7
20,161,48,27,75,92,-17
20,161,48,29,0,82,-82
20,161,48,141,70,133,-63
20,161,48,201,0,61,-61
20,161,48,439,0,63,-63
20,161,53,53,99,0,99
20,163,20,51,65,72,-7
20,167,20,51,101,108,-7
20,169,20,9,82,0,82
20,169,20,29,68,0,68
20,169,20,41,236,204,32
20,169,20,45,0,77,-77
20,169,20,51,63,0,63
20,169,20,53,74,68,6
20,169,20,61,71,65,6
20,169,20,91,101,156,-55
20,169,20,105,57,0,57
20,169,20,113,182,213,-31
20,169,20,143,206,226,-20
20,169,20,155,101,73,28
20,169,20,161,110,110,0
20,169,20,173,233,301,-68
20,169,20,177,101,79,22
20,169,29,95,0,64,-64
20,173,4,13,245,403,-158
20,173,4,19,73,129,-56
20,173,5,7,0,114,-114
20,173,5,119,0,64,-64
20,173,6,37,271,178,93
20,173,6,59,94,87,7
20,173,6,65,0,77,-77
20,173,6,71,61,0,61
20,173,6,73,181,145,36
20,173,6,85,0,53,-53
20,173,8,1,96,102,-6
20,173,8,5,142,178,-36
20,173,8,31,74,121,-47
20,173,8,35,0,92,-92
20,173,8,41,208,253,-45
20,173,8,59,81,89,-8
20,173,8,69,0,88,-88
20,173,12,31,0,63,-63
20,173,12,57,90,99,-9
20,173,12,95,0,59,-59
20,173,15,3,87,0,87
20,173,17,31,116,133,-17
20,173,17,163,0,67,-67
20,173,18,97,0,59,-59
20,173,20,9,111,68,43
20,173,20,15,2663,2844,-181
20,173,20,35,619,427,192
20,173,20,37,121,73,48
20,173,20,45,213,254,-41
20,173,20,51,140,80,60
20,173,20,55,160,154,6
20,173,20,57,199,90,109
20,173,20,61,130,101,29
20,173,20,77,73,65,8
20,173,20,79,891,884,7
20,173,20,91,529,890,-361
20,173,20,95,203,233,-30
20,173,20,103,79,76,3
20,173,20,111,135,128,7
20,173,20,113,197,152,45
20,173,20,115,133,109,24
20,173,20,125,98,98,0
20,173,20,151,134,0,134
20,173,20,155,783,701,82
20,173,20,161,246,151,95
20,173,20,169,301,233,68
20,173,20,175,85,0,85
20,173,20,177,278,247,31
20,173,20,191,834,722,112
20,173,20,209,111,112,-1
20,173,27,53,0,76,-76
20,173,29,47,113,148,-35
20,173,29,77,87,71,16
20,173,29,95,261,480,-219
20,173,29,97,66,70,-4
20,173,29,165,55,89,-34
20,173,29,183,0,67,-67
20,173,29,189,67,75,-8
20,173,31,55,57,101,-44
20,173,31,109,68,0,68
20,173,32,3,198,190,8
20,173,35,1,58,0,58
20,173,40,27,121,106,15
20,173,40,47,66,72,-6
20,173,40,71,89,72,17
20,173,40,109,300,415,-115
20,173,40,143,293,276,17
20,173,48,29,169,215,-46
20,173,48,85,98,144,-46
20,173,48,113,203,332,-129
20,173,48,121,109,91,18
20,173,48,201,182,240,-58
20,173,48,339,0,63,-63
20,173,48,439,262,398,-136
20,173,48,453,70,88,-18
20,173,49,35,0,52,-52
20,173,51,59,0,82,-82
20,173,53,33,96,151,-55
20,173,53,61,107,98,9
20,173,53,63,0,70,-70
20,175,20,55,0,149,-149
20,175,20,57,0,79,-79
20,175,20,173,0,85,-85
20,175,40,7,92,166,-74
20,175,40,139,211,191,20
20,175,48,141,0,162,-162
20,177,4,13,73,82,-9
20,177,20,5,69,0,69
20,177,20,13,66,0,66
20,177,20,45,773,907,-134
20,177,20,59,109,86,23
20,177,20,61,89,0,89
20,177,20,85,339,311,28
20,177,20,87,388,513,-125
20,177,20,91,382,762,-380
20,177,20,103,101,109,-8
20,177,20,111,148,105,43
20,177,20,131,49,71,-22
20,177,20,139,471,500,-29
20,177,20,149,229,124,105
20,177,20,161,266,200,66
20,177,20,169,79,101,-22
20,177,20,173,247,278,-31
20,177,20,197,180,116,64
20,177,20,209,153,208,-55
20,177,29,47,70,113,-43
20,177,29,95,244,369,-125
20,177,29,165,0,70,-70
20,177,31,55,0,48,-48
20,177,32,3,0,55,-55
20,177,40,143,0,58,-58
20,177,48,113,0,51,-51
20,177,48,439,62,73,-11
20,191,20,15,0,100,-100
20,191,20,35,167,246,-79
20,191,20,173,722,834,-112
20,193,20,109,70,0,70
20,197,20,149,133,80,53
20,197,20,177,116,180,-64
20,205,20,125,99,101,-2
20,205,20,133,60,78,-18
20,209,4,13,0,87,-87
20,209,6,37,82,58,24
20,209,17,31,76,0,76
20,209,20,45,255,254,1
20,209,20,91,4384,4767,-383
20,209,20,103,929,1196,-267
20,209,20,121,0,89,-89
20,209,20,161,94,0,94
20,209,20,173,112,111,1
20,209,20,177,208,153,55
20,209,29,21,82,65,17
20,209,29,37,89,143,-54
20,209,29,47,602,816,-214
20,209,29,95,2885,3003,-118
20,209,29,165,399,579,-180
20,209,48,201,75,60,15
21,1,21,207,201,216,-15
21,1,21,217,161,184,-23
21,3,21,9,120,111,9
21,3,21,213,85,60,25
21,3,21,227,378,409,-31
21,3,47,111,67,0,67
21,3,47,165,115,94,21
21,5,21,67,189,224,-35
21,5,21,73,481,483,-2
21,5,21,111,70,68,2
21,5,21,167,109,164,-55
21,5,21,209,58,0,58
21,5,21,211,100,93,7
21,5,21,239,163,81,82
21,7,21,145,234,228,6
21,9,21,3,111,120,-9
21,9,21,61,130,122,8
21,9,21,99,336,341,-5
21,9,21,111,93,79,14
21,9,21,169,290,271,19
21,9,21,171,125,108,17
21,9,21,227,610,532,78
21,11,21,173,236,263,-27
21,11,21,205,83,150,-67
21,13,21,95,69,71,-2
21,13,21,121,68,104,-36
21,13,47,25,281,392,-111
21,13,47,93,0,61,-61
21,15,4,13,0,63,-63
21,15,12,57,0,65,-65
21,15,12,71,0,67,-67
21,15,17,31,62,49,13
21,15,18,29,222,187,35
21,15,21,37,829,839,-10
21,15,21,67,226,185,41
21,15,21,77,166,237,-71
21,15,21,81,617,582,35
21,15,21,111,210,188,22
21,15,21,117,4983,4750,233
21,15,21,187,52,0,52
21,15,21,191,158,125,33
21,15,21,209,0,205,-205
21,15,39,17,225,218,7
21,15,39,25,233,202,31
21,15,39,49,147,100,47
21,15,39,61,1267,1019,248
21,15,39,113,0,70,-70
21,15,39,165,131,122,9
21,15,48,85,0,159,-159
21,17,21,49,71,70,1
21,17,21,67,420,467,-47
21,17,21,97,129,124,5
21,17,21,181,152,143,9
21,17,21,209,141,146,-5
21,19,21,43,255,228,27
21,19,21,67,86,107,-21
21,19,21,89,761,805,-44
21,19,21,111,0,53,-53
21,19,21,127,111,75,36
21,19,39,87,285,313,-28
21,19,39,145,0,74,-74
21,19,54,11,198,101,97
21,19,54,99,162,100,62
21,21,21,45,64,59,5
21,21,21,67,241,209,32
21,21,21,79,227,141,86
21,21,21,111,0,57,-57
21,21,21,113,161,121,40
21,21,21,137,427,402,25
21,21,21,167,311,294,17
21,23,21,37,61,0,61
21,23,21,117,66,53,13
21,23,21,161,150,106,44
21,23,21,191,82,0,82
21,25,21,193,69,66,3
21,27,21,59,70,67,3
21,27,21,85,144,171,-27
21,27,21,93,168,172,-4
21,27,21,111,281,156,125
21,27,21,163,245,196,49
21,29,18,19,117,181,-64
21,29,18,43,0,56,-56
21,29,21,85,0,71,-71
21,29,21,93,267,470,-203
21,29,21,111,4781,3096,1685
21,29,21,163,80,130,-50
21,29,21,179,310,518,-208
21,29,21,185,71,90,-19
21,29,21,211,0,108,-108
21,29,21,215,209,279,-70
21,31,21,183,0,92,-92
21,31,21,227,219,233,-14
21,33,21,55,111,0,111
21,33,21,107,138,103,35
21,33,21,143,125,94,31
21,35,21,83,250,266,-16
21,35,21,111,0,51,-51
21,35,21,145,149,152,-3
21,35,21,157,287,321,-34
21,35,47,79,170,151,19
21,37,18,29,58,0,58
21,37,21,15,839,829,10
21,37,21,23,0,61,-61
21,37,21,67,87,72,15
21,37,21,81,80,65,15
21,37,21,111,126,111,15
21,37,21,117,2230,2217,13
21,37,21,191,282,269,13
21,37,39,17,152,150,2
21,37,39,25,327,352,-25
21,37,39,49,0,48,-48
21,37,39,61,1602,1411,191
21,37,39,165,97,132,-35
21,39,21,83,113,0,113
21,39,21,145,0,68,-68
21,41,18,77,0,61,-61
21,41,21,77,91,113,-22
21,41,21,187,62,98,-36
21,41,21,223,103,101,2
21,43,21,19,228,255,-27
21,43,21,63,74,99,-25
21,43,21,89,94,112,-18
21,43,21,127,77,0,77
21,43,21,205,155,166,-11
21,45,21,21,59,64,-5
21,45,21,137,169,139,30
21,45,21,199,83,79,4
21,45,21,207,0,94,-94
21,47,2,90,78,0,78
21,47,4,13,88,61,27
21,47,6,37,62,71,-9
21,47,8,41,156,201,-45
21,47,13,179,0,113,-113
21,47,15,3,130,214,-84
21,47,20,61,97,0,97
21,47,21,67,0,50,-50
21,47,21,93,60,0,60
21,47,21,107,154,211,-57
21,47,21,111,60,90,-30
21,47,21,219,228,176,52
21,47,21,221,251,345,-94
21,47,21,227,61,57,4
21,47,36,45,94,104,-10
21,47,37,51,170,152,18
21,47,40,31,103,84,19
21,47,47,37,175,164,11
21,47,47,125,1946,2933,-987
21,47,48,27,141,148,-7
21,47,48,29,0,128,-128
21,47,48,141,147,126,21
21,47,48,201,58,0,58
21,47,53,53,117,217,-100
21,49,21,17,70,71,-1
21,49,21,67,809,663,146
21,49,21,111,50,0,50
21,49,21,113,65,0,65
21,49,21,151,190,243,-53
21,49,21,173,264,287,-23
21,49,21,197,168,152,16
21,49,21,209,115,94,21
21,51,21,109,0,66,-66
21,51,21,125,218,401,-183
21,53,21,57,69,0,69
21,53,21,231,84,96,-12
21,55,21,33,0,111,-111
21,55,21,139,58,77,-19
21,55,21,225,0,74,-74
21,57,21,53,0,69,-69
21,59,18,123,69,0,69
21,59,18,147,123,134,-11
21,59,18,163,161,210,-49
21,59,18,173,68,76,-8
21,59,21,27,67,70,-3
21,59,21,67,82,103,-21
21,59,21,91,262,291,-29
21,59,21,101,220,143,77
21,59,21,107,133,98,35
21,59,21,111,196,232,-36
21,59,21,149,258,246,12
21,59,21,177,135,84,51
21,59,21,183,609,429,180
21,59,21,227,129,141,-12
21,59,47,37,0,65,-65
21,61,21,9,122,130,-8
21,61,21,85,0,77,-77
21,61,21,227,471,370,101
21,63,21,43,99,74,25
21,63,21,205,0,104,-104
21,65,21,151,276,258,18
21,67,4,13,84,118,-34
21,67,6,37,116,141,-25
21,67,6,59,73,0,73
21,67,6,73,73,66,7
21,67,6,85,0,49,-49
21,67,8,31,0,58,-58
21,67,8,41,57,53,4
21,67,11,1,81,0,81
21,67,12,11,104,75,29
21,67,12,21,0,54,-54
21,67,12,31,59,48,11
21,67,12,57,71,117,-46
21,67,12,71,0,85,-85
21,67,12,81,0,90,-90
21,67,12,86,68,59,9
21,67,12,95,0,81,-81
21,67,12,99,0,68,-68
21,67,12,103,56,102,-46
21,67,13,67,0,62,-62
21,67,13,89,61,0,61
21,67,13,121,66,100,-34
21,67,17,31,214,165,49
21,67,18,57,0,83,-83
21,67,18,97,85,122,-37
21,67,21,5,224,189,35
21,67,21,15,185,226,-41
21,67,21,17,467,420,47
21,67,21,19,107,86,21
21,67,21,21,209,241,-32
21,67,21,37,72,87,-15
21,67,21,47,50,0,50
21,67,21,49,663,809,-146
21,67,21,59,103,82,21
21,67,21,71,128,51,77
21,67,21,73,589,476,113
21,67,21,79,192,193,-1
21,67,21,81,0,58,-58
21,67,21,89,52,0,52
21,67,21,93,145,108,37
21,67,21,95,0,56,-56
21,67,21,97,155,173,-18
21,67,21,111,979,1331,-352
21,67,21,113,1713,2326,-613
21,67,21,115,89,0,89
21,67,21,117,143,180,-37
21,67,21,121,78,0,78
21,67,21,125,170,87,83
21,67,21,133,53,0,53
21,67,21,137,66,98,-32
21,67,21,145,76,55,21
21,67,21,151,1160,1328,-168
21,67,21,155,62,0,62
21,67,21,161,57,56,1
21,67,21,167,143,170,-27
21,67,21,173,206,198,8
21,67,21,179,77,57,20
21,67,21,185,56,59,-3
21,67,21,193,77,0,77
21,67,21,195,192,130,62
21,67,21,197,50,95,-45
21,67,21,199,195,116,79
21,67,21,203,52,46,6
21,67,21,205,129,98,31
21,67,21,209,1084,1740,-656
21,67,21,211,58,132,-74
21,67,21,227,127,127,0
21,67,21,229,0,57,-57
21,67,21,239,619,749,-130
21,67,24,31,63,0,63
21,67,26,125,59,0,59
21,67,26,163,78,82,-4
21,67,29,189,0,59,-59
21,67,32,3,79,0,79
21,67,36,61,0,70,-70
21,67,37,119,98,94,4
21,67,37,183,59,90,-31
21,67,39,17,64,71,-7
21,67,39,25,0,72,-72
21,67,39,35,54,81,-27
21,67,39,49,134,184,-50
21,67,39,61,157,285,-128
21,67,39,113,91,96,-5
21,67,39,165,0,55,-55
21,67,42,3,0,66,-66
21,67,45,19,0,57,-57
21,67,47,37,149,233,-84
21,67,47,93,67,112,-45
21,67,47,157,0,63,-63
21,67,48,113,0,81,-81
21,67,48,201,62,121,-59
21,67,48,439,0,62,-62
21,67,48,453,60,103,-43
21,67,51,59,57,70,-13
21,67,53,33,0,85,-85
21,67,54,11,51,0,51
21,69,21,135,0,70,-70
21,69,21,161,153,99,54
21,69,21,205,127,132,-5
21,71,21,67,51,128,-77
21,71,21,115,227,278,-51
21,71,21,119,95,92,3
21,71,21,153,112,87,25
21,71,21,195,355,435,-80
21,71,21,209,0,54,-54
21,73,21,5,483,481,2
21,73,21,67,476,589,-113
21,73,21,111,232,278,-46
21,73,21,113,71,0,71
21,73,21,151,109,81,28
21,73,21,209,292,309,-17
21,73,21,211,302,300,2
21,73,21,239,242,195,47
21,75,47,131,117,174,-57
21,77,21,15,237,166,71
21,77,21,41,113,91,22
21,77,21,81,90,68,22
21,77,21,117,177,58,119
21,77,21,187,0,73,-73
21,79,21,21,141,227,-86
21,79,21,67,193,192,1
21,79,21,113,364,234,130
21,79,21,137,181,155,26
21,79,21,151,290,249,41
21,79,21,167,77,0,77
21,81,21,15,582,617,-35
21,81,21,37,65,80,-15
21,81,21,67,58,0,58
21,81,21,77,68,90,-22
21,81,21,97,73,0,73
21,81,21,117,450,462,-12
21,81,21,187,90,114,-24
21,81,21,191,173,189,-16
21,81,21,209,55,71,-16
21,81,39,61,70,61,9
21,83,21,35,266,250,16
21,83,21,39,0,113,-113
21,83,21,145,487,443,44
21,83,21,157,130,181,-51
21,83,47,131,76,66,10
21,83,47,183,62,0,62
21,85,21,27,171,144,27
21,85,21,29,71,0,71
21,85,21,61,77,0,77
21,85,21,93,269,285,-16
21,85,21,111,224,118,106
21,85,21,183,57,0,57
21,85,21,227,50,65,-15
21,87,21,217,203,235,-32
21,89,21,19,805,761,44
21,89,21,43,112,94,18
21,89,21,67,0,52,-52
21,89,39,87,148,236,-88
21,89,39,145,156,208,-52
21,89,54,11,74,0,74
21,91,18,123,80,117,-37
21,91,21,59,291,262,29
21,93,4,13,0,74,-74
21,93,8,41,101,151,-50
21,93,15,3,209,104,105
21,93,18,19,0,69,-69
21,93,21,27,172,168,4
21,93,21,29,470,267,203
21,93,21,47,0,60,-60
21,93,21,67,108,145,-37
21,93,21,85,285,269,16
21,93,21,99,129,110,19
21,93,21,111,1516,1205,311
21,93,21,123,490,537,-47
21,93,21,163,808,872,-64
21,93,21,179,262,212,50
21,93,21,217,70,0,70
21,93,21,227,144,95,49
21,93,29,169,0,73,-73
21,93,37,51,117,71,46
21,93,47,125,101,120,-19
21,93,48,27,141,92,49
21,93,48,29,89,94,-5
21,93,48,141,128,129,-1
21,93,51,59,0,129,-129
21,93,53,53,117,0,117
21,95,21,13,71,69,2
21,95,21,67,56,0,56
21,95,21,133,0,83,-83
21,95,21,151,0,65,-65
21,97,21,17,124,129,-5
21,97,21,67,173,155,18
21,97,21,81,0,73,-73
21,97,21,181,0,65,-65
21,97,21,209,352,253,99
21,99,21,9,341,336,5
21,99,21,93,110,129,-19
21,99,21,111,81,0,81
21,99,21,123,80,0,80
21,99,21,227,0,69,-69
21,101,18,163,481,586,-105
21,101,18,173,72,146,-74
21,101,21,59,143,220,-77
21,101,21,107,97,118,-21
21,101,21,111,52,47,5
21,101,21,225,202,218,-16
21,101,21,233,165,184,-19
21,103,21,111,199,147,52
21,103,21,185,347,251,96
21,103,21,211,248,316,-68
21,103,21,223,91,129,-38
21,107,18,163,0,99,-99
21,107,21,33,103,138,-35
21,107,21,47,211,154,57
21,107,21,59,98,133,-35
21,107,21,101,118,97,21
21,107,21,111,60,0,60
21,107,21,177,138,179,-41
21,107,21,227,0,46,-46
21,107,21,233,348,249,99
21,109,21,51,66,0,66
21,109,21,125,126,136,-10
21,109,21,151,117,197,-80
21,111,1,73,60,70,-10
21,111,1,89,56,86,-30
21,111,4,13,272,299,-27
21,111,4,19,77,71,6
21,111,6,1,72,61,11
21,111,6,37,252,274,-22
21,111,6,59,96,109,-13
21,111,6,65,72,0,72
21,111,6,71,63,0,63
21,111,6,73,158,209,-51
21,111,6,75,0,42,-42
21,111,6,85,0,71,-71
21,111,8,5,65,83,-18
21,111,8,31,87,141,-54
21,111,8,41,77,76,1
21,111,11,1,90,68,22
21,111,12,5,0,57,-57
21,111,12,9,0,79,-79
21,111,12,11,226,174,52
21,111,12,21,74,125,-51
21,111,12,31,161,163,-2
21,111,12,57,267,315,-48
21,111,12,71,128,225,-97
21,111,12,81,67,107,-40
21,111,12,86,831,346,485
21,111,12,95,169,179,-10
21,111,12,99,187,150,37
21,111,12,101,0,107,-107
21,111,12,103,151,291,-140
21,111,12,105,0,77,-77
21,111,12,115,53,134,-81
21,111,12,127,67,71,-4
21,111,13,51,55,0,55
21,111,13,67,89,135,-46
21,111,13,89,184,163,21
21,111,13,121,139,253,-114
21,111,13,135,76,166,-90
21,111,15,3,68,0,68
21,111,17,31,482,503,-21
21,111,17,43,93,68,25
21,111,17,97,0,69,-69
21,111,18,5,57,0,57
21,111,18,19,1746,2666,-920
21,111,18,37,69,0,69
21,111,18,43,943,1811,-868
21,111,18,57,100,203,-103
21,111,18,61,290,357,-67
21,111,18,77,96,50,46
21,111,18,97,405,449,-44
21,111,18,105,83,75,8
21,111,18,141,57,0,57
21,111,18,143,72,51,21
21,111,18,163,136,108,28
21,111,18,175,101,113,-12
21,111,19,153,0,59,-59
21,111,21,5,68,70,-2
21,111,21,9,79,93,-14
21,111,21,15,188,210,-22
21,111,21,19,53,0,53
21,111,21,21,57,0,57
21,111,21,27,156,281,-125
21,111,21,29,3096,4781,-1685
21,111,21,35,51,0,51
21,111,21,37,111,126,-15
21,111,21,47,90,60,30
21,111,21,49,0,50,-50
21,111,21,59,232,196,36
21,111,21,67,1331,979,352
21,111,21,73,278,232,46
21,111,21,85,118,224,-106
21,111,21,93,1205,1516,-311
21,111,21,99,0,81,-81
21,111,21,101,47,52,-5
21,111,21,103,147,199,-52
21,111,21,107,0,60,-60
21,111,21,113,61,75,-14
21,111,21,117,201,229,-28
21,111,21,123,61,78,-17
21,111,21,145,145,54,91
21,111,21,151,212,112,100
21,111,21,155,85,65,20
21,111,21,163,445,650,-205
21,111,21,167,56,0,56
21,111,21,179,540,757,-217
21,111,21,185,2258,3119,-861
21,111,21,199,0,59,-59
21,111,21,209,141,105,36
21,111,21,211,1144,1743,-599
21,111,21,215,568,937,-369
21,111,21,217,73,94,-21
21,111,21,223,85,60,25
21,111,21,227,476,288,188
21,111,21,229,71,67,4
21,111,21,239,76,0,76
21,111,22,71,0,57,-57
21,111,24,31,0,61,-61
21,111,24,33,66,0,66
21,111,25,17,73,57,16
21,111,25,25,0,66,-66
21,111,26,99,71,0,71
21,111,26,125,173,119,54
21,111,26,161,0,52,-52
21,111,26,163,199,210,-11
21,111,27,53,50,126,-76
21,111,29,95,65,0,65
21,111,29,189,111,133,-22
21,111,29,510,53,72,-19
21,111,31,55,52,0,52
21,111,32,3,146,159,-13
21,111,34,17,78,0,78
21,111,36,47,110,83,27
21,111,36,61,113,118,-5
21,111,36,81,77,0,77
21,111,37,63,59,0,59
21,111,37,67,0,55,-55
21,111,37,119,128,148,-20
21,111,37,183,74,105,-31
21,111,39,17,80,114,-34
21,111,39,25,62,54,8
21,111,39,35,83,153,-70
21,111,39,49,217,316,-99
21,111,39,61,295,356,-61
21,111,39,113,88,137,-49
21,111,39,165,0,60,-60
21,111,40,109,56,0,56
21,111,41,51,0,59,-59
21,111,42,3,73,107,-34
21,111,42,101,54,82,-28
21,111,45,19,0,83,-83
21,111,45,45,66,0,66
21,111,45,79,69,0,69
21,111,47,37,359,361,-2
21,111,47,65,0,50,-50
21,111,47,93,93,85,8
21,111,47,125,91,95,-4
21,111,47,149,88,81,7
21,111,47,157,124,112,12
21,111,47,165,0,67,-67
21,111,47,187,67,101,-34
21,111,48,29,82,124,-42
21,111,48,85,70,91,-21
21,111,48,113,164,179,-15
21,111,48,121,72,72,0
21,111,48,201,310,245,65
21,111,48,439,138,120,18
21,111,48,453,121,115,6
21,111,49,35,0,58,-58
21,111,51,13,53,0,53
21,111,51,59,125,0,125
21,111,51,810,0,68,-68
21,111,53,33,110,184,-74
21,111,54,11,53,0,53
21,111,54,39,53,0,53
21,111,55,25,68,0,68
21,111,55,79,63,76,-13
21,113,21,21,121,161,-40
21,113,21,49,0,65,-65
21,113,21,67,2326,1713,613
21,113,21,73,0,71,-71
21,113,21,79,234,364,-130
21,113,21,111,75,61,14
21,113,21,137,0,67,-67
21,113,21,151,144,219,-75
21,113,21,167,0,83,-83
21,113,21,209,144,113,31
21,113,21,239,97,126,-29
21,115,21,67,0,89,-89
21,115,21,71,278,227,51
21,115,21,127,105,0,105
21,115,21,153,84,78,6
21,115,21,195,0,71,-71
21,117,4,13,0,67,-67
21,117,17,31,71,0,71
21,117,18,29,148,104,44
21,117,21,15,4750,4983,-233
21,117,21,23,53,66,-13
21,117,21,37,2217,2230,-13
21,117,21,67,180,143,37
21,117,21,77,58,177,-119
21,117,21,81,462,450,12
21,117,21,111,229,201,28
21,117,21,151,59,0,59
21,117,21,187,71,61,10
21,117,21,191,178,185,-7
21,117,21,209,0,93,-93
21,117,39,17,217,236,-19
21,117,39,25,458,446,12
21,117,39,49,109,75,34
21,117,39,61,2460,2370,90
21,117,39,113,64,106,-42
21,117,39,165,125,137,-12
21,117,48,85,0,97,-97
21,119,21,71,92,95,-3
21,119,21,193,157,167,-10
21,121,21,13,104,68,36
21,121,21,67,0,78,-78
21,121,21,125,543,618,-75
21,121,21,235,564,631,-67
21,123,21,93,537,490,47
21,123,21,99,0,80,-80
21,123,21,111,78,61,17
21,123,21,179,120,99,21
21,125,21,51,401,218,183
21,125,21,67,87,170,-83
21,125,21,109,136,126,10
21,125,21,121,618,543,75
21,125,21,131,114,0,114
21,125,21,151,151,183,-32
21,125,21,199,124,129,-5
21,125,21,235,739,659,80
21,127,21,19,75,111,-36
21,127,21,43,0,77,-77
21,127,21,115,0,105,-105
21,127,21,159,76,0,76
21,127,54,99,158,123,35
21,129,21,151,0,59,-59
21,131,21,125,0,114,-114
21,133,21,67,0,53,-53
21,133,21,95,83,0,83
21,133,21,193,0,81,-81
21,133,21,195,0,104,-104
21,135,21,69,70,0,70
21,135,21,161,136,115,21
21,135,39,145,0,64,-64
21,137,21,21,402,427,-25
21,137,21,45,139,169,-30
21,137,21,67,98,66,32
21,137,21,79,155,181,-26
21,137,21,113,67,0,67
21,137,21,151,77,63,14
21,137,21,167,62,82,-20
21,137,21,199,154,172,-18
21,137,21,203,78,0,78
21,139,21,55,77,58,19
21,139,21,145,194,244,-50
21,139,21,157,135,137,-2
21,141,21,177,83,0,83
21,141,21,213,131,148,-17
21,141,21,219,180,130,50
21,141,21,227,387,453,-66
21,141,47,125,0,74,-74
21,141,47,147,110,79,31
21,143,21,33,94,125,-31
21,143,21,145,78,64,14
21,145,17,127,309,220,89
21,145,21,7,228,234,-6
21,145,21,35,152,149,3
21,145,21,39,68,0,68
21,145,21,67,55,76,-21
21,145,21,83,443,487,-44
21,145,21,111,54,145,-91
21,145,21,139,244,194,50
21,145,21,143,64,78,-14
21,145,21,157,477,521,-44
21,145,47,37,64,84,-20
21,145,47,125,0,58,-58
21,147,21,199,124,172,-48
21,147,47,151,71,0,71
21,149,21,59,246,258,-12
21,149,21,177,81,88,-7
21,149,21,183,72,0,72
21,151,21,49,243,190,53
21,151,21,65,258,276,-18
21,151,21,67,1328,1160,168
21,151,21,73,81,109,-28
21,151,21,79,249,290,-41
21,151,21,95,65,0,65
21,151,21,109,197,117,80
21,151,21,111,112,212,-100
21,151,21,113,219,144,75
21,151,21,117,0,59,-59
21,151,21,125,183,151,32
21,151,21,129,59,0,59
21,151,21,137,63,77,-14
21,151,21,173,0,73,-73
21,151,21,193,71,0,71
21,151,21,195,54,0,54
21,151,21,199,103,108,-5
21,151,21,203,318,337,-19
21,151,21,209,110,169,-59
21,151,21,235,53,0,53
21,153,21,71,87,112,-25
21,153,21,115,78,84,-6
21,155,21,67,0,62,-62
21,155,21,111,65,85,-20
21,155,21,179,189,194,-5
21,155,21,217,148,174,-26
21,155,21,229,169,127,42
21,157,21,35,321,287,34
21,157,21,83,181,130,51
21,157,21,139,137,135,2
21,157,21,145,521,477,44
21,159,21,127,0,76,-76
21,161,21,23,106,150,-44
21,161,21,67,56,57,-1
21,161,21,69,99,153,-54
21,161,21,135,115,136,-21
21,161,39,15,110,107,3
21,163,21,27,196,245,-49
21,163,21,29,130,80,50
21,163,21,93,872,808,64
21,163,21,111,650,445,205
21,165,21,173,94,132,-38
21,167,21,5,164,109,55
21,167,21,21,294,311,-17
21,167,21,67,170,143,27
21,167,21,79,0,77,-77
21,167,21,111,0,56,-56
21,167,21,113,83,0,83
21,167,21,137,82,62,20
21,167,21,229,69,0,69
21,169,21,9,271,290,-19
21,171,21,9,108,125,-17
21,173,21,11,263,236,27
21,173,21,49,287,264,23
21,173,21,67,198,206,-8
21,173,21,151,73,0,73
21,173,21,165,132,94,38
21,173,21,197,129,104,25
21,173,21,205,92,96,-4
21,175,21,205,79,97,-18
21,175,21,237,0,75,-75
21,177,21,59,84,135,-51
21,177,21,107,179,138,41
21,177,21,141,0,83,-83
21,177,21,149,88,81,7
21,177,21,183,108,76,32
21,177,21,227,52,66,-14
21,179,21,29,518,310,208
21,179,21,67,57,77,-20
21,179,21,93,212,262,-50
21,179,21,111,757,540,217
21,179,21,123,99,120,-21
21,179,21,155,194,189,5
21,179,21,215,124,95,29
21,179,21,229,204,260,-56
21,181,21,17,143,152,-9
21,181,21,97,65,0,65
21,183,21,31,92,0,92
21,183,21,59,429,609,-180
21,183,21,85,0,57,-57
21,183,21,149,0,72,-72
21,183,21,177,76,108,-32
21,183,21,227,0,81,-81
21,185,18,19,84,115,-31
21,185,21,29,90,71,19
21,185,21,67,59,56,3
21,185,21,103,251,347,-96
21,185,21,111,3119,2258,861
21,185,21,211,166,225,-59
21,185,21,223,76,103,-27
21,187,21,15,0,52,-52
21,187,21,41,98,62,36
21,187,21,77,73,0,73
21,187,21,81,114,90,24
21,187,21,117,61,71,-10
21,191,21,15,125,158,-33
21,191,21,23,0,82,-82
21,191,21,37,269,282,-13
21,191,21,81,189,173,16
21,191,21,117,185,178,7
21,193,21,25,66,69,-3
21,193,21,67,0,77,-77
21,193,21,119,167,157,10
21,193,21,133,81,0,81
21,193,21,151,0,71,-71
21,193,21,209,0,60,-60
21,195,21,67,130,192,-62
21,195,21,71,435,355,80
21,195,21,115,71,0,71
21,195,21,133,104,0,104
21,195,21,151,0,54,-54
21,195,21,209,0,113,-113
21,195,54,59,233,153,80
21,197,21,49,152,168,-16
21,197,21,67,95,50,45
21,197,21,173,104,129,-25
21,199,21,45,79,83,-4
21,199,21,67,116,195,-79
21,199,21,111,59,0,59
21,199,21,125,129,124,5
21,199,21,137,172,154,18
21,199,21,147,172,124,48
21,199,21,151,108,103,5
21,199,21,203,101,0,101
21,199,21,207,152,138,14
21,199,21,231,260,200,60
21,203,21,67,46,52,-6
21,203,21,137,0,78,-78
21,203,21,151,337,318,19
21,203,21,199,0,101,-101
21,205,21,11,150,83,67
21,205,21,43,166,155,11
21,205,21,63,104,0,104
21,205,21,67,98,129,-31
21,205,21,69,132,127,5
21,205,21,173,96,92,4
21,205,21,175,97,79,18
21,207,21,1,216,201,15
21,207,21,45,94,0,94
21,207,21,199,138,152,-14
21,209,21,5,0,58,-58
21,209,21,15,205,0,205
21,209,21,17,146,141,5
21,209,21,49,94,115,-21
21,209,21,67,1740,1084,656
21,209,21,71,54,0,54
21,209,21,73,309,292,17
21,209,21,81,71,55,16
21,209,21,97,253,352,-99
21,209,21,111,105,141,-36
21,209,21,113,113,144,-31
21,209,21,117,93,0,93
21,209,21,151,169,110,59
21,209,21,193,60,0,60
21,209,21,195,113,0,113
21,209,21,239,124,105,19
21,211,18,19,0,62,-62
21,211,21,5,93,100,-7
21,211,21,29,108,0,108
21,211,21,67,132,58,74
21,211,21,73,300,302,-2
21,211,21,103,316,248,68
21,211,21,111,1743,1144,599
21,211,21,185,225,166,59
21,211,21,215,316,139,177
21,213,21,3,60,85,-25
21,213,21,141,148,131,17
21,213,21,227,402,353,49
21,213,47,37,102,0,102
21,213,47,147,71,71,0
21,213,47,165,279,155,124
21,215,21,29,279,209,70
21,215,21,111,937,568,369
21,215,21,179,95,124,-29
21,215,21,211,139,316,-177
21,217,21,1,184,161,23
21,217,21,87,235,203,32
21,217,21,93,0,70,-70
21,217,21,111,94,73,21
21,217,21,155,174,148,26
21,219,21,47,176,228,-52
21,219,21,141,130,180,-50
21,219,47,125,145,127,18
21,221,21,47,345,251,94
21,223,18,77,100,105,-5
21,223,21,41,101,103,-2
21,223,21,103,129,91,38
21,223,21,111,60,85,-25
21,223,21,185,103,76,27
21,225,18,163,0,61,-61
21,225,21,55,74,0,74
21,225,21,101,218,202,16
21,225,21,233,0,70,-70
21,227,18,97,0,54,-54
21,227,21,3,409,378,31
21,227,21,9,532,610,-78
21,227,21,31,233,219,14
21,227,21,47,57,61,-4
21,227,21,59,141,129,12
21,227,21,61,370,471,-101
21,227,21,67,127,127,0
21,227,21,85,65,50,15
21,227,21,93,95,144,-49
21,227,21,99,69,0,69
21,227,21,107,46,0,46
21,227,21,111,288,476,-188
21,227,21,141,453,387,66
21,227,21,177,66,52,14
21,227,21,183,81,0,81
21,227,21,213,353,402,-49
21,227,39,49,0,61,-61
21,227,47,37,222,335,-113
21,227,47,125,60,101,-41
21,227,47,147,61,0,61
21,227,47,149,49,76,-27
21,227,47,165,218,226,-8
21,227,47,187,0,54,-54
21,229,21,67,57,0,57
21,229,21,111,67,71,-4
21,229,21,155,127,169,-42
21,229,21,167,0,69,-69
21,229,21,179,260,204,56
21,231,21,53,96,84,12
21,231,21,199,200,260,-60
21,233,21,101,184,165,19
21,233,21,107,249,348,-99
21,233,21,225,70,0,70
21,235,21,121,631,564,67
21,235,21,125,659,739,-80
21,235,21,151,0,53,-53
21,235,47,13,156,141,15
21,237,21,175,75,0,75
21,239,21,5,81,163,-82
21,239,21,67,749,619,130
21,239,21,73,195,242,-47
21,239,21,111,0,76,-76
21,239,21,113,126,97,29
21,239,21,209,105,124,-19
22,1,22,19,167,202,-35
22,1,22,33,59,51,8
22,1,22,39,123,121,2
22,1,22,53,282,228,54
22,1,22,55,932,1202,-270
22,1,22,97,596,496,100
22,1,22,99,72,109,-37
22,1,22,113,235,252,-17
22,1,48,201,74,111,-37
22,3,22,11,93,95,-2
22,3,22,19,322,352,-30
22,3,22,39,0,103,-103
22,3,22,53,206,180,26
22,3,22,79,139,129,10
22,5,22,7,312,236,76
22,5,22,19,80,115,-35
22,5,22,33,3397,2416,981
22,5,22,47,274,275,-1
22,5,22,51,429,205,224
22,5,22,55,99,143,-44
22,5,22,57,126,0,126
22,5,22,63,884,1030,-146
22,5,22,71,172,124,48
22,5,22,89,127,0,127
22,5,22,93,391,192,199
22,5,22,95,303,120,183
22,5,22,103,105,139,-34
22,5,22,105,150,191,-41
22,5,22,109,71,0,71
22,5,22,121,126,66,60
22,5,48,201,256,177,79
22,7,22,5,236,312,-76
22,7,22,33,0,107,-107
22,7,22,57,254,274,-20
22,7,22,101,189,157,32
22,7,22,109,85,97,-12
22,9,22,33,61,91,-30
22,9,22,55,0,137,-137
22,9,22,77,75,87,-12
22,9,22,79,361,568,-207
22,9,22,97,77,75,2
22,11,22,3,95,93,2
22,11,22,19,1072,752,320
22,11,22,115,618,595,23
22,13,22,15,69,117,-48
22,13,22,17,88,72,16
22,13,22,27,0,81,-81
22,13,22,49,71,112,-41
22,13,22,61,104,168,-64
22,13,22,69,84,0,84
22,13,22,119,130,171,-41
22,15,4,13,0,66,-66
22,15,6,37,65,0,65
22,15,8,41,0,101,-101
22,15,12,33,88,0,88
22,15,12,91,0,90,-90
22,15,22,13,117,69,48
22,15,22,17,5300,4971,329
22,15,22,19,0,76,-76
22,15,22,27,90,79,11
22,15,22,31,156,219,-63
22,15,22,33,90,98,-8
22,15,22,55,66,0,66
22,15,22,61,156,84,72
22,15,22,69,144,0,144
22,15,22,73,184,104,80
22,15,22,79,74,77,-3
22,15,22,119,642,586,56
22,15,31,153,0,120,-120
22,15,32,3,0,94,-94
22,15,38,101,92,170,-78
22,15,40,109,0,80,-80
22,15,48,29,101,180,-79
22,15,48,85,63,142,-79
22,15,48,113,141,291,-150
22,15,48,121,0,87,-87
22,15,48,183,78,81,-3
22,15,48,201,181,220,-39
22,15,48,203,0,88,-88
22,15,48,423,54,0,54
22,15,48,439,152,210,-58
22,15,51,59,0,96,-96
22,17,4,13,0,94,-94
22,17,5,119,0,56,-56
22,17,6,37,85,89,-4
22,17,8,41,0,59,-59
22,17,13,89,0,58,-58
22,17,22,13,72,88,-16
22,17,22,15,4971,5300,-329
22,17,22,19,78,124,-46
22,17,22,27,0,70,-70
22,17,22,31,745,1065,-320
22,17,22,33,182,188,-6
22,17,22,51,66,90,-24
22,17,22,55,94,91,3
22,17,22,61,174,98,76
22,17,22,69,196,118,78
22,17,22,71,77,83,-6
22,17,22,73,241,227,14
22,17,22,79,102,91,11
22,17,22,81,97,91,6
22,17,22,85,73,82,-9
22,17,22,103,0,81,-81
22,17,22,119,340,285,55
22,17,32,3,0,75,-75
22,17,40,109,0,87,-87
22,17,48,27,0,71,-71
22,17,48,29,90,115,-25
22,17,48,37,49,66,-17
22,17,48,67,71,85,-14
22,17,48,85,83,298,-215
22,17,48,113,444,949,-505
22,17,48,121,113,244,-131
22,17,48,183,106,140,-34
22,17,48,201,332,427,-95
22,17,48,203,236,206,30
22,17,48,315,0,65,-65
22,17,48,365,66,80,-14
22,17,48,423,0,84,-84
22,17,48,439,298,645,-347
22,17,48,453,0,97,-97
22,19,22,1,202,167,35
22,19,22,3,352,322,30
22,19,22,5,115,80,35
22,19,22,11,752,1072,-320
22,19,22,15,76,0,76
22,19,22,17,124,78,46
22,19,22,23,667,487,180
22,19,22,33,326,314,12
22,19,22,39,175,93,82
22,19,22,45,85,0,85
22,19,22,51,165,88,77
22,19,22,53,589,716,-127
22,19,22,55,402,411,-9
22,19,22,63,59,72,-13
22,19,22,71,130,109,21
22,19,22,73,96,67,29
22,19,22,79,173,146,27
22,19,22,97,232,145,87
22,19,22,103,87,89,-2
22,19,22,113,71,77,-6
22,19,22,115,162,170,-8
22,19,48,29,82,0,82
22,19,48,39,81,98,-17
22,19,48,113,62,100,-38
22,19,48,157,109,162,-53
22,19,48,167,59,104,-45
22,19,48,201,807,826,-19
22,19,48,215,78,0,78
22,19,48,245,302,213,89
22,19,48,339,114,99,15
22,19,48,355,66,0,66
22,19,48,361,421,311,110
22,19,48,439,86,90,-4
22,19,48,453,62,61,1
22,21,22,59,75,0,75
22,21,22,73,144,119,25
22,23,22,19,487,667,-180
22,25,22,29,88,76,12
22,25,22,59,0,136,-136
22,27,22,13,81,0,81
22,27,22,15,79,90,-11
22,27,22,17,70,0,70
22,27,22,61,0,87,-87
22,27,22,119,197,135,62
22,29,22,25,76,88,-12
22,29,22,33,84,104,-20
22,29,28,1,308,305,3
22,31,22,15,219,156,63
22,31,22,17,1065,745,320
22,31,22,85,93,88,5
22,31,48,419,63,70,-7
22,33,1,3,0,71,-71
22,33,1,73,0,54,-54
22,33,1,97,86,59,27
22,33,4,13,59,160,-101
22,33,6,37,120,170,-50
22,33,6,59,0,60,-60
22,33,6,73,64,96,-32
22,33,8,31,0,109,-109
22,33,12,31,0,90,-90
22,33,12,33,0,75,-75
22,33,12,57,0,79,-79
22,33,12,86,67,0,67
22,33,12,95,0,104,-104
22,33,12,103,0,63,-63
22,33,13,67,0,95,-95
22,33,13,89,57,111,-54
22,33,13,121,0,150,-150
22,33,13,135,0,62,-62
22,33,17,31,100,138,-38
22,33,22,1,51,59,-8
22,33,22,5,2416,3397,-981
22,33,22,7,107,0,107
22,33,22,9,91,61,30
22,33,22,15,98,90,8
22,33,22,17,188,182,6
22,33,22,19,314,326,-12
22,33,22,29,104,84,20
22,33,22,37,713,673,40
22,33,22,45,149,56,93
22,33,22,47,606,759,-153
22,33,22,51,853,875,-22
22,33,22,55,669,628,41
22,33,22,57,171,116,55
22,33,22,61,69,0,69
22,33,22,63,2348,4115,-1767
22,33,22,71,826,1099,-273
22,33,22,73,228,160,68
22,33,22,77,479,282,197
22,33,22,79,249,153,96
22,33,22,87,0,60,-60
22,33,22,89,53,57,-4
22,33,22,91,100,71,29
22,33,22,93,89,94,-5
22,33,22,95,145,116,29
22,33,22,97,163,154,9
22,33,22,99,81,74,7
22,33,22,101,80,89,-9
22,33,22,103,552,660,-108
22,33,22,105,409,628,-219
22,33,22,109,217,150,67
22,33,22,117,75,94,-19
22,33,22,121,897,946,-49
22,33,22,125,248,321,-73
22,33,28,1,77,0,77
22,33,28,47,74,105,-31
22,33,28,49,72,68,4
22,33,28,59,0,62,-62
22,33,28,157,87,75,12
22,33,32,3,70,169,-99
22,33,36,47,0,55,-55
22,33,36,61,0,52,-52
22,33,37,119,0,112,-112
22,33,37,183,0,69,-69
22,33,47,37,0,84,-84
22,33,47,157,104,108,-4
22,33,48,29,93,142,-49
22,33,48,39,103,85,18
22,33,48,85,61,168,-107
22,33,48,113,205,337,-132
22,33,48,121,66,139,-73
22,33,48,157,127,235,-108
22,33,48,201,742,1410,-668
22,33,48,245,81,112,-31
22,33,48,339,105,193,-88
22,33,48,439,181,263,-82
22,33,48,453,115,225,-110
22,33,48,491,0,79,-79
22,33,51,59,0,54,-54
22,33,53,33,0,107,-107
22,33,53,53,0,60,-60
22,35,22,73,72,87,-15
22,35,22,123,0,124,-124
22,35,48,439,0,69,-69
22,37,22,33,673,713,-40
22,37,22,63,110,144,-34
22,37,22,125,89,111,-22
22,39,22,1,121,123,-2
22,39,22,3,103,0,103
22,39,22,19,93,175,-82
22,39,22,55,112,222,-110
22,39,22,79,91,113,-22
22,39,22,97,500,466,34
22,39,48,201,0,66,-66
22,41,22,73,169,229,-60
22,41,22,83,195,197,-2
22,43,22,59,95,0,95
22,43,22,73,82,138,-56
22,43,22,79,826,837,-11
22,43,22,127,100,88,12
22,45,22,19,0,85,-85
22,45,22,33,56,149,-93
22,45,22,51,0,67,-67
22,45,22,55,908,1394,-486
22,45,22,97,0,92,-92
22,45,22,99,378,471,-93
22,45,22,101,466,365,101
22,45,22,113,422,495,-73
22,45,48,201,117,203,-86
22,47,22,5,275,274,1
22,47,22,33,759,606,153
22,47,22,63,0,122,-122
22,47,22,77,109,85,24
22,47,22,121,312,471,-159
22,49,22,13,112,71,41
22,49,22,61,211,216,-5
22,49,22,73,184,193,-9
22,49,22,127,69,0,69
22,51,1,73,0,74,-74
22,51,1,97,111,87,24
22,51,4,13,70,77,-7
22,51,6,37,190,137,53
22,51,6,59,60,0,60
22,51,6,73,98,101,-3
22,51,8,31,0,50,-50
22,51,12,11,86,104,-18
22,51,12,31,62,77,-15
22,51,12,33,67,63,4
22,51,12,57,109,105,4
22,51,12,86,151,187,-36
22,51,12,95,71,78,-7
22,51,12,99,0,58,-58
22,51,12,103,0,58,-58
22,51,13,67,0,88,-88
22,51,13,89,68,95,-27
22,51,13,121,69,160,-91
22,51,13,135,0,130,-130
22,51,17,31,107,116,-9
22,51,22,5,205,429,-224
22,51,22,17,90,66,24
22,51,22,19,88,165,-77
22,51,22,33,875,853,22
22,51,22,45,67,0,67
22,51,22,55,230,239,-9
22,51,22,57,187,214,-27
22,51,22,63,152,214,-62
22,51,22,71,10240,8666,1574
22,51,22,73,82,0,82
22,51,22,75,614,734,-120
22,51,22,79,69,57,12
22,51,22,87,605,644,-39
22,51,22,89,1262,1545,-283
22,51,22,93,60,0,60
22,51,22,95,803,979,-176
22,51,22,97,70,0,70
22,51,22,101,56,0,56
22,51,22,103,1547,3124,-1577
22,51,22,105,376,759,-383
22,51,22,109,265,214,51
22,51,22,117,57,106,-49
22,51,28,45,96,213,-117
22,51,28,47,130,240,-110
22,51,28,49,93,0,93
22,51,28,59,72,146,-74
22,51,28,109,157,223,-66
22,51,32,3,0,81,-81
22,51,36,5,92,0,92
22,51,36,47,63,64,-1
22,51,36,61,0,56,-56
22,51,36,81,53,0,53
22,51,37,119,0,89,-89
22,51,47,37,49,72,-23
22,51,47,157,95,80,15
22,51,48,27,0,76,-76
22,51,48,29,80,107,-27
22,51,48,39,0,66,-66
22,51,48,85,105,106,-1
22,51,48,113,216,319,-103
22,51,48,121,55,138,-83
22,51,48,157,62,158,-96
22,51,48,201,707,1033,-326
22,51,48,245,0,74,-74
22,51,48,339,0,146,-146
22,51,48,439,71,170,-99
22,51,48,453,132,146,-14
22,51,51,59,55,75,-20
22,51,53,33,0,71,-71
22,53,22,1,228,282,-54
22,53,22,3,180,206,-26
22,53,22,19,716,589,127
22,53,22,55,130,128,2
22,53,22,113,63,0,63
22,53,48,201,80,0,80
22,55,1,3,0,62,-62
22,55,4,13,0,83,-83
22,55,6,37,64,81,-17
22,55,12,57,0,65,-65
22,55,22,1,1202,932,270
22,55,22,5,143,99,44
22,55,22,9,137,0,137
22,55,22,15,0,66,-66
22,55,22,17,91,94,-3
22,55,22,19,411,402,9
22,55,22,33,628,669,-41
22,55,22,39,222,112,110
22,55,22,45,1394,908,486
22,55,22,51,239,230,9
22,55,22,53,128,130,-2
22,55,22,57,136,52,84
22,55,22,63,0,69,-69
22,55,22,71,253,375,-122
22,55,22,73,118,75,43
22,55,22,79,252,144,108
22,55,22,97,1499,1316,183
22,55,22,99,1657,1496,161
22,55,22,101,407,228,179
22,55,22,103,280,246,34
22,55,22,105,50,80,-30
22,55,22,109,191,131,60
22,55,22,113,1485,1132,353
22,55,36,61,51,0,51
22,55,48,29,76,105,-29
22,55,48,85,0,78,-78
22,55,48,113,129,207,-78
22,55,48,121,0,72,-72
22,55,48,157,75,161,-86
22,55,48,201,556,1162,-606
22,55,48,245,0,68,-68
22,55,48,329,0,93,-93
22,55,48,339,85,213,-128
22,55,48,439,114,120,-6
22,55,48,453,74,131,-57
22,55,53,33,0,47,-47
22,57,22,5,0,126,-126
22,57,22,7,274,254,20
22,57,22,33,116,171,-55
22,57,22,51,214,187,27
22,57,22,55,52,136,-84
22,57,22,71,99,95,4
22,57,22,89,154,131,23
22,57,22,93,91,0,91
22,57,22,101,63,114,-51
22,57,22,103,61,75,-14
22,57,22,109,2347,2259,88
22,57,48,201,64,139,-75
22,59,22,21,0,75,-75
22,59,22,25,136,0,136
22,59,22,43,0,95,-95
22,59,22,79,82,72,10
22,61,22,13,168,104,64
22,61,22,15,84,156,-72
22,61,22,17,98,174,-76
22,61,22,27,87,0,87
22,61,22,33,0,69,-69
22,61,22,49,216,211,5
22,61,22,73,418,419,-1
22,61,22,79,54,0,54
22,61,22,111,211,263,-52
22,61,48,113,0,114,-114
22,61,48,201,0,105,-105
22,61,48,439,0,92,-92
22,63,22,5,1030,884,146
22,63,22,19,72,59,13
22,63,22,33,4115,2348,1767
22,63,22,37,144,110,34
22,63,22,47,122,0,122
22,63,22,51,214,152,62
22,63,22,55,69,0,69
22,63,22,71,63,89,-26
22,63,22,77,69,0,69
22,63,22,91,188,212,-24
22,63,22,103,267,266,1
22,63,22,105,1272,1170,102
22,63,22,109,62,0,62
22,63,22,121,105,108,-3
22,63,28,47,0,68,-68
22,63,28,113,65,0,65
22,63,48,201,110,112,-2
22,65,22,73,77,82,-5
22,65,28,149,87,111,-24
22,67,5,3,0,65,-65
22,67,22,73,474,581,-107
22,67,22,83,80,81,-1
22,67,48,113,0,62,-62
22,69,22,13,0,84,-84
22,69,22,15,0,144,-144
22,69,22,17,118,196,-78
22,69,22,79,233,257,-24
22,69,22,81,113,150,-37
22,69,22,85,127,159,-32
22,69,22,127,117,80,37
22,69,48,201,73,132,-59
22,71,1,3,52,0,52
22,71,1,73,114,84,30
22,71,1,97,104,76,28
22,71,4,13,82,130,-48
22,71,5,119,53,0,53
22,71,6,1,98,101,-3
22,71,6,37,313,427,-114
22,71,6,59,89,77,12
22,71,6,73,164,131,33
22,71,6,75,95,78,17
22,71,6,85,49,77,-28
22,71,8,5,0,55,-55
22,71,8,31,123,156,-33
22,71,11,1,149,114,35
22,71,12,11,78,91,-13
22,71,12,31,70,82,-12
22,71,12,33,72,46,26
22,71,12,57,96,87,9
22,71,12,86,131,104,27
22,71,12,95,63,93,-30
22,71,12,99,62,57,5
22,71,12,103,0,50,-50
22,71,13,63,0,71,-71
22,71,13,67,69,99,-30
22,71,13,89,124,217,-93
22,71,13,121,217,195,22
22,71,13,135,66,0,66
22,71,17,31,255,288,-33
22,71,18,97,62,55,7
22,71,21,111,57,0,57
22,71,22,5,124,172,-48
22,71,22,17,83,77,6
22,71,22,19,109,130,-21
22,71,22,33,1099,826,273
22,71,22,51,8666,10240,-1574
22,71,22,55,375,253,122
22,71,22,57,95,99,-4
22,71,22,63,89,63,26
22,71,22,73,56,0,56
22,71,22,75,257,238,19
22,71,22,79,80,63,17
22,71,22,87,882,1372,-490
22,71,22,89,208,240,-32
22,71,22,95,273,291,-18
22,71,22,103,1503,2310,-807
22,71,22,105,166,213,-47
22,71,22,109,110,95,15
22,71,24,31,77,87,-10
22,71,24,510,0,50,-50
22,71,25,17,92,108,-16
22,71,25,25,76,62,14
22,71,26,125,63,0,63
22,71,26,161,0,55,-55
22,71,27,53,44,71,-27
22,71,28,45,76,136,-60
22,71,28,47,167,180,-13
22,71,28,49,120,57,63
22,71,28,59,0,59,-59
22,71,28,89,50,0,50
22,71,28,109,68,103,-35
22,71,28,113,69,0,69
22,71,32,3,77,105,-28
22,71,36,47,212,241,-29
22,71,36,61,242,211,31
22,71,36,81,0,47,-47
22,71,36,103,60,0,60
22,71,37,119,51,74,-23
22,71,41,51,74,103,-29
22,71,42,3,51,76,-25
22,71,42,101,111,123,-12
22,71,45,19,53,60,-7
22,71,45,79,0,60,-60
22,71,47,37,94,119,-25
22,71,47,157,179,72,107
22,71,48,27,0,72,-72
22,71,48,29,170,140,30
22,71,48,85,61,129,-68
22,71,48,113,314,350,-36
22,71,48,121,0,90,-90
22,71,48,157,100,143,-43
22,71,48,201,921,1245,-324
22,71,48,339,61,75,-14
22,71,48,439,132,227,-95
22,71,48,453,271,278,-7
22,71,51,59,74,106,-32
22,71,53,33,163,151,12
22,73,5,119,0,108,-108
22,73,22,15,104,184,-80
22,73,22,17,227,241,-14
22,73,22,19,67,96,-29
22,73,22,21,119,144,-25
22,73,22,33,160,228,-68
22,73,22,35,87,72,15
22,73,22,41,229,169,60
22,73,22,43,138,82,56
22,73,22,49,193,184,9
22,73,22,51,0,82,-82
22,73,22,55,75,118,-43
22,73,22,61,419,418,1
22,73,22,65,82,77,5
22,73,22,67,581,474,107
22,73,22,71,0,56,-56
22,73,22,79,149,103,46
22,73,22,83,542,412,130
22,73,22,103,0,81,-81
22,73,22,111,503,516,-13
22,73,22,123,115,80,35
22,73,48,85,0,171,-171
22,73,48,113,206,430,-224
22,73,48,121,0,122,-122
22,73,48,201,177,306,-129
22,73,48,439,144,371,-227
22,73,48,453,0,69,-69
22,75,6,73,102,0,102
22,75,22,51,734,614,120
22,75,22,71,238,257,-19
22,75,22,87,79,102,-23
22,75,22,103,94,136,-42
22,77,22,9,87,75,12
22,77,22,33,282,479,-197
22,77,22,47,85,109,-24
22,77,22,63,0,69,-69
22,77,22,121,217,152,65
22,79,22,3,129,139,-10
22,79,22,9,568,361,207
22,79,22,15,77,74,3
22,79,22,17,91,102,-11
22,79,22,19,146,173,-27
22,79,22,33,153,249,-96
22,79,22,39,113,91,22
22,79,22,43,837,826,11
22,79,22,51,57,69,-12
22,79,22,55,144,252,-108
22,79,22,59,72,82,-10
22,79,22,61,0,54,-54
22,79,22,69,257,233,24
22,79,22,71,63,80,-17
22,79,22,73,103,149,-46
22,79,22,97,64,67,-3
22,79,22,103,0,62,-62
22,79,22,115,240,173,67
22,79,48,29,0,65,-65
22,79,48,113,55,131,-76
22,79,48,201,196,399,-203
22,79,48,339,0,58,-58
22,79,48,439,0,144,-144
22,81,22,17,91,97,-6
22,81,22,69,150,113,37
22,83,22,41,197,195,2
22,83,22,67,81,80,1
22,83,22,73,412,542,-130
22,83,22,123,0,65,-65
22,85,22,17,82,73,9
22,85,22,31,88,93,-5
22,85,22,69,159,127,32
22,85,22,115,135,104,31
22,87,22,33,60,0,60
22,87,22,51,644,605,39
22,87,22,71,1372,882,490
22,87,22,75,102,79,23
22,87,22,103,307,457,-150
22,87,28,109,62,0,62
22,87,48,201,0,72,-72
22,89,22,5,0,127,-127
22,89,22,33,57,53,4
22,89,22,51,1545,1262,283
22,89,22,57,131,154,-23
22,89,22,71,240,208,32
22,89,22,95,370,377,-7
22,89,22,103,76,192,-116
22,89,22,105,106,151,-45
22,89,22,109,0,60,-60
22,89,48,201,0,58,-58
22,91,22,33,71,100,-29
22,91,22,63,212,188,24
22,91,22,105,474,492,-18
22,93,22,5,192,391,-199
22,93,22,33,94,89,5
22,93,22,51,0,60,-60
22,93,22,57,0,91,-91
22,93,22,95,255,240,15
22,95,22,5,120,303,-183
22,95,22,33,116,145,-29
22,95,22,51,979,803,176
22,95,22,71,291,273,18
22,95,22,89,377,370,7
22,95,22,93,240,255,-15
22,95,22,103,0,121,-121
22,95,22,105,80,179,-99
22,95,48,201,70,75,-5
22,97,22,1,496,596,-100
22,97,22,9,75,77,-2
22,97,22,19,145,232,-87
22,97,22,33,154,163,-9
22,97,22,39,466,500,-34
22,97,22,45,92,0,92
22,97,22,51,0,70,-70
22,97,22,55,1316,1499,-183
22,97,22,79,67,64,3
22,97,22,99,256,208,48
22,97,22,113,0,79,-79
22,97,48,201,161,246,-85
22,99,22,1,109,72,37
22,99,22,33,74,81,-7
22,99,22,45,471,378,93
22,99,22,55,1496,1657,-161
22,99,22,97,208,256,-48
22,99,22,101,96,103,-7
22,99,22,113,119,109,10
22,99,48,201,72,148,-76
22,101,22,7,157,189,-32
22,101,22,33,89,80,9
22,101,22,45,365,466,-101
22,101,22,51,0,56,-56
22,101,22,55,228,407,-179
22,101,22,57,114,63,51
22,101,22,99,103,96,7
22,101,22,109,171,281,-110
22,101,48,201,77,171,-94
22,103,1,3,54,77,-23
22,103,1,97,94,77,17
22,103,4,13,0,73,-73
22,103,6,13,89,0,89
22,103,6,37,104,61,43
22,103,6,73,150,104,46
22,103,12,11,0,72,-72
22,103,12,33,0,80,-80
22,103,22,5,139,105,34
22,103,22,17,81,0,81
22,103,22,19,89,87,2
22,103,22,33,660,552,108
22,103,22,51,3124,1547,1577
22,103,22,55,246,280,-34
22,103,22,57,75,61,14
22,103,22,63,266,267,-1
22,103,22,71,2310,1503,807
22,103,22,73,81,0,81
22,103,22,75,136,94,42
22,103,22,79,62,0,62
22,103,22,87,457,307,150
22,103,22,89,192,76,116
22,103,22,95,121,0,121
22,103,22,105,1280,1427,-147
22,103,22,109,123,0,123
22,103,22,117,560,649,-89
22,103,28,45,372,404,-32
22,103,28,47,279,269,10
22,103,28,59,96,0,96
22,103,28,73,68,0,68
22,103,28,89,84,0,84
22,103,28,109,596,776,-180
22,103,47,157,56,0,56
22,103,48,29,71,0,71
22,103,48,85,0,80,-80
22,103,48,113,86,77,9
22,103,48,121,0,78,-78
22,103,48,157,79,102,-23
22,103,48,201,370,375,-5
22,103,48,339,75,120,-45
22,103,48,439,76,67,9
22,103,48,453,0,68,-68
22,103,53,33,0,59,-59
22,105,22,5,191,150,41
22,105,22,33,628,409,219
22,105,22,51,759,376,383
22,105,22,55,80,50,30
22,105,22,63,1170,1272,-102
22,105,22,71,213,166,47
22,105,22,89,151,106,45
22,105,22,91,492,474,18
22,105,22,95,179,80,99
22,105,22,103,1427,1280,147
22,105,22,117,284,207,77
22,105,28,47,0,63,-63
22,105,28,113,112,168,-56
22,105,48,113,0,53,-53
22,105,48,201,123,242,-119
22,109,22,5,0,71,-71
22,109,22,7,97,85,12
22,109,22,33,150,217,-67
22,109,22,51,214,265,-51
22,109,22,55,131,191,-60
22,109,22,57,2259,2347,-88
22,109,22,63,0,62,-62
22,109,22,71,95,110,-15
22,109,22,89,60,0,60
22,109,22,101,281,171,110
22,109,22,103,0,123,-123
22,109,48,201,111,266,-155
22,111,5,139,88,130,-42
22,111,22,61,263,211,52
22,111,22,73,516,503,13
22,113,22,1,252,235,17
22,113,22,19,77,71,6
22,113,22,45,495,422,73
22,113,22,53,0,63,-63
22,113,22,55,1132,1485,-353
22,113,22,97,79,0,79
22,113,22,99,109,119,-10
22,113,48,201,0,91,-91
22,115,2,90,90,0,90
22,115,4,13,0,62,-62
22,115,6,37,0,63,-63
22,115,8,41,168,160,8
22,115,13,215,73,116,-43
22,115,15,3,154,172,-18
22,115,20,103,0,105,-105
22,115,22,11,595,618,-23
22,115,22,19,170,162,8
22,115,22,79,173,240,-67
22,115,22,85,104,135,-31
22,115,29,169,0,123,-123
22,115,37,51,160,214,-54
22,115,45,79,0,81,-81
22,115,47,125,126,115,11
22,115,48,27,134,222,-88
22,115,48,29,102,182,-80
22,115,48,141,163,226,-63
22,115,48,201,94,169,-75
22,115,53,53,152,130,22
22,117,22,33,94,75,19
22,117,22,51,106,57,49
22,117,22,103,649,560,89
22,117,22,105,207,284,-77
22,117,28,109,0,102,-102
22,117,28,147,72,0,72
22,119,5,27,71,0,71
22,119,22,13,171,130,41
22,119,22,15,586,642,-56
22,119,22,17,285,340,-55
22,119,22,27,135,197,-62
22,119,48,113,0,67,-67
22,121,22,5,66,126,-60
22,121,22,33,946,897,49
22,121,22,47,471,312,159
22,121,22,63,108,105,3
22,121,22,77,152,217,-65
22,123,22,35,124,0,124
22,123,22,73,80,115,-35
22,123,22,83,65,0,65
22,125,22,33,321,248,73
22,125,22,37,111,89,22
22,127,22,43,88,100,-12
22,127,22,49,0,69,-69
22,127,22,69,80,117,-37
23,1,23,3,58,0,58
23,1,23,5,2049,1413,636
23,1,23,7,273,323,-50
23,1,23,11,761,916,-155
23,1,23,13,54,0,54
23,1,23,15,0,54,-54
23,1,23,17,740,842,-102
23,1,23,19,124,147,-23
23,1,23,23,352,419,-67
23,1,23,25,54,84,-30
23,1,23,31,349,285,64
23,1,33,11,62,0,62
23,3,23,1,0,58,-58
23,3,23,5,79,181,-102
23,3,23,11,98,82,16
23,3,23,19,281,504,-223
23,3,23,29,64,66,-2
23,3,23,31,91,110,-19
23,5,4,13,107,115,-8
23,5,6,1,56,0,56
23,5,6,37,176,108,68
23,5,6,73,122,178,-56
23,5,6,75,58,0,58
23,5,8,31,80,45,35
23,5,9,1,93,60,33
23,5,9,3,182,88,94
23,5,9,9,114,43,71
23,5,9,11,49,0,49
23,5,11,1,155,95,60
23,5,12,11,70,0,70
23,5,12,21,75,0,75
23,5,12,31,0,93,-93
23,5,12,57,0,78,-78
23,5,12,71,68,106,-38
23,5,12,81,0,66,-66
23,5,12,95,0,57,-57
23,5,12,99,93,67,26
23,5,12,101,0,85,-85
23,5,12,103,79,80,-1
23,5,12,105,0,60,-60
23,5,12,115,63,115,-52
23,5,17,31,102,89,13
23,5,23,1,1413,2049,-636
23,5,23,3,181,79,102
23,5,23,7,143,131,12
23,5,23,9,208,99,109
23,5,23,11,790,746,44
23,5,23,13,208,175,33
23,5,23,15,300,278,22
23,5,23,17,607,727,-120
23,5,23,19,597,375,222
23,5,23,23,957,1273,-316
23,5,23,25,117,128,-11
23,5,23,27,154,114,40
23,5,23,29,85,62,23
23,5,23,31,3496,4084,-588
23,5,24,31,74,0,74
23,5,25,1,100,0,100
23,5,25,5,53,47,6
23,5,25,9,337,200,137
23,5,25,13,72,0,72
23,5,25,15,57,0,57
23,5,25,17,717,401,316
23,5,25,21,280,109,171
23,5,25,23,151,62,89
23,5,25,25,430,223,207
23,5,25,27,214,99,115
23,5,27,53,0,96,-96
23,5,32,3,0,72,-72
23,5,33,1,52,48,4
23,5,33,3,90,86,4
23,5,33,5,51,0,51
23,5,33,9,87,55,32
23,5,33,11,217,135,82
23,5,33,13,122,67,55
23,5,33,15,313,216,97
23,5,33,17,174,116,58
23,5,36,47,211,124,87
23,5,36,55,56,0,56
23,5,36,61,151,120,31
23,5,36,81,80,49,31
23,5,36,103,75,0,75
23,5,37,119,72,68,4
23,5,37,183,0,59,-59
23,5,41,51,65,62,3
23,5,42,101,60,46,14
23,5,44,7,69,58,11
23,5,48,201,0,66,-66
23,5,48,439,0,66,-66
23,5,48,453,0,67,-67
23,5,50,7,123,52,71
23,5,51,59,75,0,75
23,5,53,33,112,83,29
23,7,23,1,323,273,50
23,7,23,5,131,143,-12
23,7,23,11,196,248,-52
23,7,23,17,180,145,35
23,7,23,19,88,0,88
23,7,23,25,179,182,-3
23,7,23,31,0,91,-91
23,9,23,5,99,208,-109
23,9,23,11,74,53,21
23,9,23,19,751,695,56
23,9,23,27,231,168,63
23,9,23,29,211,144,67
23,9,23,31,55,53,2
23,9,25,17,48,0,48
23,11,23,1,916,761,155
23,11,23,3,82,98,-16
23,11,23,5,746,790,-44
23,11,23,7,248,196,52
23,11,23,9,53,74,-21
23,11,23,13,152,120,32
23,11,23,15,383,366,17
23,11,23,17,136,108,28
23,11,23,19,411,394,17
23,11,23,23,350,299,51
23,11,23,25,1107,1074,33
23,11,23,27,329,307,22
23,11,23,31,219,230,-11
23,11,25,9,77,0,77
23,11,25,17,76,57,19
23,11,33,11,0,56,-56
23,11,33,15,0,66,-66
23,13,23,1,0,54,-54
23,13,23,5,175,208,-33
23,13,23,11,120,152,-32
23,13,23,15,330,360,-30
23,13,23,19,97,122,-25
23,13,23,27,270,309,-39
23,13,23,31,0,77,-77
23,13,25,17,68,0,68
23,13,25,25,0,42,-42
23,15,23,1,54,0,54
23,15,23,5,278,300,-22
23,15,23,11,366,383,-17
23,15,23,13,360,330,30
23,15,23,19,67,65,2
23,15,23,23,265,202,63
23,15,23,27,62,52,10
23,15,25,9,50,0,50
23,15,25,17,66,53,13
23,17,23,1,842,740,102
23,17,23,5,727,607,120
23,17,23,7,145,180,-35
23,17,23,11,108,136,-28
23,17,23,19,56,0,56
23,17,23,31,282,212,70
23,17,25,9,87,0,87
23,17,25,17,79,0,79
23,17,25,23,66,0,66
23,17,33,3,181,172,9
23,19,4,13,0,59,-59
23,19,12,101,0,52,-52
23,19,12,103,0,53,-53
23,19,12,105,0,53,-53
23,19,23,1,147,124,23
23,19,23,3,504,281,223
23,19,23,5,375,597,-222
23,19,23,7,0,88,-88
23,19,23,9,695,751,-56
23,19,23,11,394,411,-17
23,19,23,13,122,97,25
23,19,23,15,65,67,-2
23,19,23,17,0,56,-56
23,19,23,21,400,385,15
23,19,23,23,63,55,8
23,19,23,25,489,536,-47
23,19,23,27,506,456,50
23,19,23,29,216,211,5
23,19,23,31,182,295,-113
23,19,25,17,101,100,1
23,19,25,25,0,70,-70
23,19,25,27,53,53,0
23,19,33,11,51,78,-27
23,21,23,19,385,400,-15
23,21,23,25,105,62,43
23,23,6,73,0,64,-64
23,23,23,1,419,352,67
23,23,23,5,1273,957,316
23,23,23,11,299,350,-51
23,23,23,15,202,265,-63
23,23,23,19,55,63,-8
23,23,23,31,101,71,30
23,23,25,17,55,0,55
23,25,23,1,84,54,30
23,25,23,5,128,117,11
23,25,23,7,182,179,3
23,25,23,11,1074,1107,-33
23,25,23,19,536,489,47
23,25,23,21,62,105,-43
23,25,23,27,122,98,24
23,25,23,31,70,75,-5
23,27,23,5,114,154,-40
23,27,23,9,168,231,-63
23,27,23,11,307,329,-22
23,27,23,13,309,270,39
23,27,23,15,52,62,-10
23,27,23,19,456,506,-50
23,27,23,25,98,122,-24
23,27,23,31,0,62,-62
23,29,23,3,66,64,2
23,29,23,5,62,85,-23
23,29,23,9,144,211,-67
23,29,23,19,211,216,-5
23,31,4,13,0,57,-57
23,31,6,37,81,54,27
23,31,6,73,80,113,-33
23,31,9,3,94,57,37
23,31,9,9,83,0,83
23,31,9,11,145,70,75
23,31,12,11,70,56,14
23,31,12,71,0,62,-62
23,31,12,99,49,0,49
23,31,12,101,0,71,-71
23,31,12,103,50,76,-26
23,31,12,115,0,61,-61
23,31,23,1,285,349,-64
23,31,23,3,110,91,19
23,31,23,5,4084,3496,588
23,31,23,7,91,0,91
23,31,23,9,53,55,-2
23,31,23,11,230,219,11
23,31,23,13,77,0,77
23,31,23,17,212,282,-70
23,31,23,19,295,182,113
23,31,23,23,71,101,-30
23,31,23,25,75,70,5
23,31,23,27,62,0,62
23,31,25,1,66,51,15
23,31,25,5,86,0,86
23,31,25,9,592,223,369
23,31,25,13,80,0,80
23,31,25,17,750,276,474
23,31,25,21,170,59,111
23,31,25,23,88,63,25
23,31,25,25,224,116,108
23,31,25,27,226,94,132
23,31,33,1,69,69,0
23,31,33,3,139,147,-8
23,31,33,5,68,0,68
23,31,33,9,72,0,72
23,31,33,11,342,186,156
23,31,33,13,156,83,73
23,31,33,15,1122,829,293
23,31,33,17,1543,1359,184
23,31,36,47,87,0,87
23,31,50,7,65,0,65
24,1,24,3,68,68,0
24,1,24,5,58,0,58
24,1,24,21,0,44,-44
24,1,24,23,262,202,60
24,1,24,43,134,136,-2
24,1,42,9,111,78,33
24,1,42,111,59,78,-19
24,1,54,3,0,64,-64
24,1,54,57,429,544,-115
24,3,1,89,0,62,-62
24,3,2,20,108,0,108
24,3,4,3,0,94,-94
24,3,4,13,156,236,-80
24,3,4,19,87,55,32
24,3,6,1,0,82,-82
24,3,6,37,246,277,-31
24,3,6,53,236,116,120
24,3,6,59,100,103,-3
24,3,6,65,127,119,8
24,3,6,67,0,56,-56
24,3,6,71,92,61,31
24,3,6,73,463,511,-48
24,3,6,75,46,50,-4
24,3,6,85,0,61,-61
24,3,8,5,0,108,-108
24,3,8,31,0,76,-76
24,3,8,41,168,227,-59
24,3,9,1,75,0,75
24,3,9,3,0,59,-59
24,3,9,9,65,0,65
24,3,10,1,109,92,17
24,3,10,3,156,108,48
24,3,10,5,196,616,-420
24,3,11,1,855,692,163
24,3,12,9,64,212,-148
24,3,12,11,184,169,15
24,3,12,19,0,99,-99
24,3,12,21,0,87,-87
24,3,12,31,135,180,-45
24,3,12,33,181,144,37
24,3,12,57,137,290,-153
24,3,12,69,0,88,-88
24,3,12,71,104,199,-95
24,3,12,81,0,69,-69
24,3,12,86,147,115,32
24,3,12,87,0,71,-71
24,3,12,91,0,81,-81
24,3,12,95,98,139,-41
24,3,12,99,99,193,-94
24,3,12,101,0,94,-94
24,3,12,103,69,200,-131
24,3,12,105,0,109,-109
24,3,12,109,0,117,-117
24,3,12,113,0,95,-95
24,3,12,115,57,145,-88
24,3,12,127,51,101,-50
24,3,13,51,0,69,-69
24,3,13,67,0,76,-76
24,3,13,73,232,390,-158
24,3,13,89,67,68,-1
24,3,13,121,85,143,-58
24,3,13,135,87,116,-29
24,3,13,245,162,128,34
24,3,15,3,729,506,223
24,3,16,1,0,66,-66
24,3,17,31,114,113,1
24,3,24,1,68,68,0
24,3,24,5,4543,4265,278
24,3,24,9,993,1107,-114
24,3,24,11,162,341,-179
24,3,24,13,441,874,-433
24,3,24,15,79,101,-22
24,3,24,17,488,436,52
24,3,24,19,75,120,-45
24,3,24,21,340,631,-291
24,3,24,25,642,655,-13
24,3,24,27,4389,4059,330
24,3,24,29,68,115,-47
24,3,24,31,2638,1599,1039
24,3,24,33,8756,4420,4336
24,3,24,35,688,1291,-603
24,3,24,37,296,207,89
24,3,24,41,236,260,-24
24,3,24,43,112,223,-111
24,3,24,45,194,191,3
24,3,24,47,156,249,-93
24,3,24,510,4583,3291,1292
24,3,25,17,93,111,-18
24,3,27,53,67,0,67
24,3,32,3,135,169,-34
24,3,34,1,55,0,55
24,3,34,3,63,0,63
24,3,34,5,97,82,15
24,3,34,7,54,0,54
24,3,34,13,60,0,60
24,3,34,23,137,96,41
24,3,34,25,86,68,18
24,3,34,29,52,0,52
24,3,34,39,62,0,62
24,3,35,1,65,0,65
24,3,36,5,81,0,81
24,3,36,47,148,109,39
24,3,36,55,47,0,47
24,3,36,59,104,0,104
24,3,36,61,108,127,-19
24,3,36,81,130,98,32
24,3,36,103,115,73,42
24,3,37,19,0,79,-79
24,3,37,51,184,183,1
24,3,37,119,76,184,-108
24,3,37,129,0,82,-82
24,3,37,133,206,129,77
24,3,37,183,121,263,-142
24,3,39,35,61,0,61
24,3,39,49,84,46,38
24,3,41,51,0,51,-51
24,3,42,1,69,84,-15
24,3,42,3,131,129,2
24,3,42,17,58,0,58
24,3,42,29,85,85,0
24,3,42,43,0,52,-52
24,3,42,45,70,0,70
24,3,42,71,59,95,-36
24,3,42,91,97,89,8
24,3,42,101,190,116,74
24,3,42,133,184,333,-149
24,3,44,5,93,0,93
24,3,45,15,0,62,-62
24,3,45,19,73,171,-98
24,3,45,35,0,61,-61
24,3,45,45,0,65,-65
24,3,45,51,74,223,-149
24,3,45,79,0,67,-67
24,3,47,125,72,0,72
24,3,47,157,0,66,-66
24,3,48,27,122,84,38
24,3,48,29,395,447,-52
24,3,48,85,0,71,-71
24,3,48,113,84,107,-23
24,3,48,141,113,112,1
24,3,48,201,140,191,-51
24,3,48,439,107,131,-24
24,3,48,451,218,97,121
24,3,48,453,60,116,-56
24,3,49,35,0,60,-60
24,3,51,13,301,269,32
24,3,51,41,55,107,-52
24,3,51,59,975,714,261
24,3,51,87,58,87,-29
24,3,51,107,190,250,-60
24,3,51,153,353,259,94
24,3,51,177,0,87,-87
24,3,51,179,89,107,-18
24,3,51,510,260,219,41
24,3,51,550,110,103,7
24,3,51,700,78,54,24
24,3,51,710,143,122,21
24,3,51,760,58,0,58
24,3,51,810,236,269,-33
24,3,53,33,103,171,-68
24,3,53,35,82,0,82
24,3,53,53,116,113,3
24,3,54,3,69,94,-25
24,5,4,13,103,232,-129
24,5,4,19,0,55,-55
24,5,6,1,0,70,-70
24,5,6,13,0,51,-51
24,5,6,37,235,295,-60
24,5,6,59,60,116,-56
24,5,6,65,0,58,-58
24,5,6,67,0,78,-78
24,5,6,73,152,247,-95
24,5,6,75,0,50,-50
24,5,6,85,0,121,-121
24,5,8,5,0,69,-69
24,5,8,31,47,85,-38
24,5,8,41,0,88,-88
24,5,9,1,61,64,-3
24,5,9,3,90,91,-1
24,5,10,1,56,84,-28
24,5,10,3,202,271,-69
24,5,10,5,177,675,-498
24,5,11,1,359,399,-40
24,5,12,9,0,94,-94
24,5,12,11,155,244,-89
24,5,12,15,0,55,-55
24,5,12,21,0,102,-102
24,5,12,31,78,143,-65
24,5,12,57,144,217,-73
24,5,12,69,0,72,-72
24,5,12,71,61,170,-109
24,5,12,81,0,72,-72
24,5,12,86,81,139,-58
24,5,12,95,101,187,-86
24,5,12,97,0,75,-75
24,5,12,99,160,288,-128
24,5,12,101,0,71,-71
24,5,12,103,0,180,-180
24,5,12,105,0,77,-77
24,5,12,115,0,103,-103
24,5,12,117,0,78,-78
24,5,12,127,0,59,-59
24,5,13,67,59,111,-52
24,5,13,89,96,91,5
24,5,13,121,114,217,-103
24,5,13,135,76,100,-24
24,5,15,3,89,100,-11
24,5,17,31,185,189,-4
24,5,18,97,0,86,-86
24,5,24,1,0,58,-58
24,5,24,3,4265,4543,-278
24,5,24,9,128,84,44
24,5,24,11,0,73,-73
24,5,24,13,1530,2888,-1358
24,5,24,15,230,447,-217
24,5,24,17,205,188,17
24,5,24,19,0,61,-61
24,5,24,21,350,655,-305
24,5,24,25,4131,6745,-2614
24,5,24,27,3811,4597,-786
24,5,24,29,61,0,61
24,5,24,31,1444,1474,-30
24,5,24,33,1874,1654,220
24,5,24,35,75,177,-102
24,5,24,37,100,55,45
24,5,24,41,62,139,-77
24,5,24,43,189,222,-33
24,5,24,45,201,163,38
24,5,24,47,159,360,-201
24,5,24,510,27448,18758,8690
24,5,25,17,69,125,-56
24,5,25,21,0,69,-69
24,5,25,25,77,92,-15
24,5,26,163,0,67,-67
24,5,27,53,0,86,-86
24,5,29,189,0,66,-66
24,5,32,3,115,170,-55
24,5,34,1,72,0,72
24,5,34,3,91,60,31
24,5,34,5,78,69,9
24,5,34,7,58,55,3
24,5,34,13,138,100,38
24,5,34,17,89,110,-21
24,5,34,23,164,137,27
24,5,34,25,52,79,-27
24,5,34,27,57,0,57
24,5,34,29,58,0,58
24,5,34,35,0,62,-62
24,5,34,39,76,71,5
24,5,36,5,204,86,118
24,5,36,29,65,0,65
24,5,36,47,372,254,118
24,5,36,59,129,84,45
24,5,36,61,237,216,21
24,5,36,67,54,0,54
24,5,36,81,358,211,147
24,5,36,103,88,71,17
24,5,36,119,103,83,20
24,5,37,51,0,60,-60
24,5,37,63,0,68,-68
24,5,37,81,0,88,-88
24,5,37,119,148,226,-78
24,5,37,133,0,60,-60
24,5,37,183,150,222,-72
24,5,39,35,52,88,-36
24,5,39,49,74,152,-78
24,5,39,61,0,56,-56
24,5,41,51,0,61,-61
24,5,42,1,95,196,-101
24,5,42,3,131,169,-38
24,5,42,11,48,0,48
24,5,42,17,106,55,51
24,5,42,29,96,125,-29
24,5,42,41,62,73,-11
24,5,42,43,101,105,-4
24,5,42,45,78,89,-11
24,5,42,55,79,62,17
24,5,42,71,121,133,-12
24,5,42,91,118,150,-32
24,5,42,101,296,247,49
24,5,42,133,952,1882,-930
24,5,45,13,0,62,-62
24,5,45,15,0,59,-59
24,5,45,19,0,85,-85
24,5,45,45,0,56,-56
24,5,45,51,61,200,-139
24,5,47,37,0,85,-85
24,5,48,29,0,86,-86
24,5,48,85,0,111,-111
24,5,48,113,86,161,-75
24,5,48,121,0,53,-53
24,5,48,201,158,186,-28
24,5,48,439,0,102,-102
24,5,48,453,56,128,-72
24,5,49,35,60,72,-12
24,5,51,13,92,146,-54
24,5,51,41,0,87,-87
24,5,51,59,450,527,-77
24,5,51,87,110,83,27
24,5,51,107,118,159,-41
24,5,51,153,119,169,-50
24,5,51,179,0,54,-54
24,5,51,510,121,81,40
24,5,51,710,0,58,-58
24,5,51,760,70,0,70
24,5,51,810,86,76,10
24,5,53,33,64,150,-86
24,5,54,3,61,135,-74
24,9,10,5,0,97,-97
24,9,11,1,98,86,12
24,9,24,3,1107,993,114
24,9,24,5,84,128,-44
24,9,24,17,589,359,230
24,9,24,21,0,61,-61
24,9,24,27,79,65,14
24,9,24,31,211,83,128
24,9,24,33,1113,439,674
24,9,24,37,1009,1041,-32
24,9,24,510,96,93,3
24,9,45,51,0,76,-76
24,9,51,13,67,0,67
24,9,51,59,182,126,56
24,9,51,510,56,46,10
24,11,10,1,127,181,-54
24,11,10,5,191,192,-1
24,11,24,3,341,162,179
24,11,24,5,73,0,73
24,11,24,19,310,311,-1
24,11,24,33,61,0,61
24,11,24,35,372,333,39
24,11,24,41,336,345,-9
24,11,24,45,61,86,-25
24,13,10,5,50,181,-131
24,13,11,1,0,44,-44
24,13,24,3,874,441,433
24,13,24,5,2888,1530,1358
24,13,24,21,978,1303,-325
24,13,24,25,170,171,-1
24,13,24,27,1695,862,833
24,13,24,31,643,422,221
24,13,24,33,230,117,113
24,13,24,43,97,200,-103
24,13,24,47,0,106,-106
24,13,24,510,570,564,6
24,13,42,1,295,553,-258
24,13,42,55,0,59,-59
24,13,42,133,487,897,-410
24,13,45,51,0,83,-83
24,13,51,59,85,50,35
24,13,54,3,0,85,-85
24,15,10,1,121,181,-60
24,15,10,3,1853,1654,199
24,15,10,5,68,165,-97
24,15,24,3,101,79,22
24,15,24,5,447,230,217
24,15,24,25,1169,995,174
24,15,24,29,78,138,-60
24,15,24,33,71,0,71
24,15,24,510,114,98,16
24,15,34,5,61,0,61
24,15,42,17,51,0,51
24,15,42,29,384,321,63
24,15,42,45,124,52,72
24,15,42,71,152,122,30
24,15,42,91,65,0,65
24,15,42,101,95,101,-6
24,15,42,133,0,85,-85
24,17,6,37,59,0,59
24,17,6,73,74,104,-30
24,17,10,5,0,82,-82
24,17,11,1,871,513,358
24,17,12,57,0,77,-77
24,17,15,3,93,0,93
24,17,24,3,436,488,-52
24,17,24,5,188,205,-17
24,17,24,9,359,589,-230
24,17,24,21,0,77,-77
24,17,24,27,125,163,-38
24,17,24,31,551,362,189
24,17,24,33,7127,3302,3825
24,17,24,37,982,1514,-532
24,17,24,510,146,138,8
24,17,32,3,0,78,-78
24,17,37,183,0,83,-83
24,17,45,51,0,98,-98
24,17,51,13,50,103,-53
24,17,51,59,628,463,165
24,17,51,99,120,227,-107
24,17,51,107,84,0,84
24,17,51,153,288,235,53
24,17,51,179,0,86,-86
24,17,51,193,0,93,-93
24,17,51,510,208,191,17
24,17,51,810,107,0,107
24,19,10,5,146,168,-22
24,19,24,3,120,75,45
24,19,24,5,61,0,61
24,19,24,11,311,310,1
24,19,24,33,56,0,56
24,19,24,41,350,423,-73
24,19,24,45,162,331,-169
24,19,24,510,52,0,52
24,21,4,13,90,104,-14
24,21,6,37,66,94,-28
24,21,6,73,87,103,-16
24,21,10,5,56,168,-112
24,21,11,1,229,240,-11
24,21,12,57,0,96,-96
24,21,12,95,0,89,-89
24,21,12,99,0,70,-70
24,21,12,103,0,71,-71
24,21,17,31,50,0,50
24,21,24,1,44,0,44
24,21,24,3,631,340,291
24,21,24,5,655,350,305
24,21,24,9,61,0,61
24,21,24,13,1303,978,325
24,21,24,17,77,0,77
24,21,24,25,85,74,11
24,21,24,27,1142,426,716
24,21,24,31,7251,2388,4863
24,21,24,33,740,424,316
24,21,24,43,1607,2282,-675
24,21,24,45,0,50,-50
24,21,24,47,0,59,-59
24,21,24,510,286,307,-21
24,21,32,3,73,0,73
24,21,36,47,67,0,67
24,21,36,59,75,0,75
24,21,36,81,57,0,57
24,21,37,119,0,87,-87
24,21,37,183,0,101,-101
24,21,42,1,272,367,-95
24,21,42,3,81,73,8
24,21,42,41,51,0,51
24,21,42,55,232,339,-107
24,21,42,101,0,53,-53
24,21,42,133,95,134,-39
24,21,45,51,0,115,-115
24,21,48,29,70,0,70
24,21,51,13,96,87,9
24,21,51,59,440,341,99
24,21,51,107,434,338,96
24,21,51,153,151,123,28
24,21,51,510,95,0,95
24,21,54,3,281,451,-170
24,21,54,37,237,399,-162
24,23,24,1,202,262,-60
24,23,54,61,0,49,-49
24,23,54,77,108,118,-10
24,25,4,13,0,85,-85
24,25,6,37,0,76,-76
24,25,6,73,0,91,-91
24,25,8,41,0,77,-77
24,25,10,1,0,68,-68
24,25,10,3,292,194,98
24,25,10,5,92,312,-220
24,25,11,1,57,61,-4
24,25,12,9,0,71,-71
24,25,12,57,0,78,-78
24,25,12,95,0,94,-94
24,25,12,99,51,0,51
24,25,12,103,0,61,-61
24,25,15,3,0,78,-78
24,25,24,3,655,642,13
24,25,24,5,6745,4131,2614
24,25,24,13,171,170,1
24,25,24,15,995,1169,-174
24,25,24,21,74,85,-11
24,25,24,27,320,336,-16
24,25,24,31,183,228,-45
24,25,24,33,267,248,19
24,25,24,47,63,185,-122
24,25,24,510,1996,1290,706
24,25,34,7,56,0,56
24,25,34,25,72,0,72
24,25,34,29,71,0,71
24,25,36,47,89,0,89
24,25,36,61,66,0,66
24,25,36,81,74,0,74
24,25,37,51,85,91,-6
24,25,37,119,0,72,-72
24,25,42,29,103,79,24
24,25,42,71,138,116,22
24,25,42,91,67,0,67
24,25,42,101,69,83,-14
24,25,42,133,570,699,-129
24,25,45,51,0,130,-130
24,25,48,141,87,109,-22
24,25,51,59,140,158,-18
24,27,4,13,134,107,27
24,27,4,19,0,85,-85
24,27,6,1,64,0,64
24,27,6,37,199,201,-2
24,27,6,59,80,97,-17
24,27,6,73,135,106,29
24,27,6,75,0,55,-55
24,27,6,85,72,85,-13
24,27,9,1,68,0,68
24,27,10,3,118,112,6
24,27,10,5,84,300,-216
24,27,11,1,373,449,-76
24,27,12,9,0,69,-69
24,27,12,11,117,101,16
24,27,12,31,0,64,-64
24,27,12,57,79,106,-27
24,27,12,71,0,73,-73
24,27,12,95,70,74,-4
24,27,12,99,70,81,-11
24,27,12,103,0,69,-69
24,27,12,115,0,56,-56
24,27,13,73,85,0,85
24,27,13,121,82,78,4
24,27,13,135,0,72,-72
24,27,15,3,182,103,79
24,27,17,31,105,136,-31
24,27,18,97,0,96,-96
24,27,24,3,4059,4389,-330
24,27,24,5,4597,3811,786
24,27,24,9,65,79,-14
24,27,24,13,862,1695,-833
24,27,24,17,163,125,38
24,27,24,21,426,1142,-716
24,27,24,25,336,320,16
24,27,24,31,3714,2222,1492
24,27,24,33,4450,2476,1974
24,27,24,35,64,120,-56
24,27,24,37,59,0,59
24,27,24,43,92,148,-56
24,27,24,45,89,0,89
24,27,24,47,64,79,-15
24,27,24,510,2717,2077,640
24,27,25,17,93,88,5
24,27,32,3,77,102,-25
24,27,34,3,71,0,71
24,27,34,17,65,0,65
24,27,34,23,100,0,100
24,27,36,47,149,87,62
24,27,36,61,114,145,-31
24,27,36,81,145,81,64
24,27,37,19,0,70,-70
24,27,37,51,68,0,68
24,27,37,119,130,150,-20
24,27,37,183,105,148,-43
24,27,39,49,69,62,7
24,27,42,3,71,92,-21
24,27,42,91,0,86,-86
24,27,42,101,103,131,-28
24,27,42,133,113,171,-58
24,27,45,19,0,49,-49
24,27,47,37,0,50,-50
24,27,48,29,120,134,-14
24,27,48,85,64,74,-10
24,27,48,113,69,85,-16
24,27,48,201,148,79,69
24,27,48,439,69,0,69
24,27,48,453,0,87,-87
24,27,51,13,149,186,-37
24,27,51,59,631,676,-45
24,27,51,107,151,276,-125
24,27,51,153,179,132,47
24,27,51,510,149,78,71
24,27,51,810,84,0,84
24,27,53,33,65,131,-66
24,27,54,37,0,53,-53
24,29,10,1,86,68,18
24,29,10,3,118,59,59
24,29,24,3,115,68,47
24,29,24,5,0,61,-61
24,29,24,15,138,78,60
24,29,24,35,351,273,78
24,31,4,13,299,369,-70
24,31,4,19,137,130,7
24,31,6,1,255,312,-57
24,31,6,13,73,93,-20
24,31,6,37,727,1040,-313
24,31,6,59,215,275,-60
24,31,6,65,84,86,-2
24,31,6,67,0,116,-116
24,31,6,71,101,109,-8
24,31,6,73,444,749,-305
24,31,6,75,187,294,-107
24,31,6,81,99,155,-56
24,31,6,85,222,357,-135
24,31,6,111,61,0,61
24,31,8,5,103,79,24
24,31,8,13,56,117,-61
24,31,8,31,137,219,-82
24,31,8,41,117,121,-4
24,31,8,59,0,93,-93
24,31,8,69,0,59,-59
24,31,9,1,202,160,42
24,31,9,3,152,104,48
24,31,9,9,169,79,90
24,31,9,11,63,63,0
24,31,10,3,180,141,39
24,31,10,5,141,595,-454
24,31,11,1,8632,6781,1851
24,31,12,1,106,64,42
24,31,12,9,82,115,-33
24,31,12,11,417,410,7
24,31,12,21,73,158,-85
24,31,12,31,169,177,-8
24,31,12,57,197,321,-124
24,31,12,69,0,68,-68
24,31,12,71,73,167,-94
24,31,12,81,0,163,-163
24,31,12,86,420,409,11
24,31,12,91,66,0,66
24,31,12,95,240,334,-94
24,31,12,97,52,0,52
24,31,12,99,335,548,-213
24,31,12,101,0,69,-69
24,31,12,103,99,193,-94
24,31,12,105,55,80,-25
24,31,12,109,0,87,-87
24,31,12,111,0,76,-76
24,31,12,115,67,156,-89
24,31,12,117,0,59,-59
24,31,12,127,0,66,-66
24,31,13,51,52,56,-4
24,31,13,67,122,160,-38
24,31,13,73,71,0,71
24,31,13,89,189,154,35
24,31,13,121,249,328,-79
24,31,13,135,170,171,-1
24,31,15,3,285,270,15
24,31,17,31,535,472,63
24,31,17,43,80,80,0
24,31,17,97,84,87,-3
24,31,18,97,90,75,15
24,31,20,91,55,67,-12
24,31,21,67,0,63,-63
24,31,21,111,61,0,61
24,31,22,71,87,77,10
24,31,23,5,0,74,-74
24,31,24,3,1599,2638,-1039
24,31,24,5,1474,1444,30
24,31,24,9,83,211,-128
24,31,24,13,422,643,-221
24,31,24,17,362,551,-189
24,31,24,21,2388,7251,-4863
24,31,24,25,228,183,45
24,31,24,27,2222,3714,-1492
24,31,24,33,12488,12629,-141
24,31,24,35,0,175,-175
24,31,24,37,111,117,-6
24,31,24,41,80,74,6
24,31,24,43,371,982,-611
24,31,24,45,95,66,29
24,31,24,47,77,153,-76
24,31,24,510,1357,1527,-170
24,31,25,1,0,55,-55
24,31,25,9,100,68,32
24,31,25,17,413,471,-58
24,31,25,21,183,158,25
24,31,25,25,260,230,30
24,31,25,27,78,101,-23
24,31,26,81,61,0,61
24,31,26,125,116,108,8
24,31,26,161,100,93,7
24,31,26,163,63,75,-12
24,31,27,53,117,133,-16
24,31,27,123,0,74,-74
24,31,29,189,90,106,-16
24,31,29,510,56,0,56
24,31,32,3,166,197,-31
24,31,34,3,212,207,5
24,31,34,5,71,60,11
24,31,34,7,91,83,8
24,31,34,13,179,194,-15
24,31,34,17,253,224,29
24,31,34,21,157,110,47
24,31,34,23,295,172,123
24,31,34,25,110,106,4
24,31,34,27,113,134,-21
24,31,34,29,75,0,75
24,31,34,31,93,0,93
24,31,34,35,118,124,-6
24,31,34,39,166,154,12
24,31,35,1,0,103,-103
24,31,36,1,79,0,79
24,31,36,5,230,159,71
24,31,36,27,58,0,58
24,31,36,29,98,61,37
24,31,36,47,607,446,161
24,31,36,55,132,58,74
24,31,36,59,238,193,45
24,31,36,61,698,835,-137
24,31,36,67,77,56,21
24,31,36,71,69,0,69
24,31,36,81,465,340,125
24,31,36,87,58,0,58
24,31,36,103,193,141,52
24,31,36,109,51,0,51
24,31,36,119,191,133,58
24,31,37,19,0,92,-92
24,31,37,21,0,61,-61
24,31,37,51,113,77,36
24,31,37,63,116,219,-103
24,31,37,67,0,67,-67
24,31,37,81,113,87,26
24,31,37,119,307,387,-80
24,31,37,129,0,91,-91
24,31,37,133,86,95,-9
24,31,37,135,72,103,-31
24,31,37,183,287,495,-208
24,31,39,35,103,145,-42
24,31,39,49,181,235,-54
24,31,39,61,74,110,-36
24,31,41,51,0,116,-116
24,31,41,67,0,60,-60
24,31,42,1,0,104,-104
24,31,42,3,307,345,-38
24,31,42,17,135,84,51
24,31,42,27,88,0,88
24,31,42,29,75,138,-63
24,31,42,41,75,71,4
24,31,42,43,68,100,-32
24,31,42,45,105,87,18
24,31,42,55,70,94,-24
24,31,42,71,63,75,-12
24,31,42,91,220,193,27
24,31,42,101,394,430,-36
24,31,42,133,111,136,-25
24,31,44,7,101,69,32
24,31,45,13,0,70,-70
24,31,45,19,72,146,-74
24,31,45,45,58,61,-3
24,31,45,51,0,129,-129
24,31,45,79,76,61,15
24,31,47,37,101,144,-43
24,31,47,157,76,0,76
24,31,48,29,260,400,-140
24,31,48,85,100,164,-64
24,31,48,113,262,249,13
24,31,48,121,72,80,-8
24,31,48,141,90,131,-41
24,31,48,157,0,93,-93
24,31,48,201,486,437,49
24,31,48,439,141,200,-59
24,31,48,453,247,280,-33
24,31,48,491,0,104,-104
24,31,49,35,103,114,-11
24,31,51,3,100,72,28
24,31,51,13,1671,1914,-243
24,31,51,41,111,143,-32
24,31,51,59,3652,4386,-734
24,31,51,61,0,77,-77
24,31,51,69,0,75,-75
24,31,51,87,158,158,0
24,31,51,95,0,59,-59
24,31,51,107,784,1291,-507
24,31,51,121,52,0,52
24,31,51,153,743,815,-72
24,31,51,177,59,148,-89
24,31,51,179,107,98,9
24,31,51,510,958,977,-19
24,31,51,540,63,0,63
24,31,51,550,85,99,-14
24,31,51,600,82,51,31
24,31,51,610,59,72,-13
24,31,51,683,66,77,-11
24,31,51,710,97,89,8
24,31,51,760,116,133,-17
24,31,51,810,140,174,-34
24,31,53,33,317,480,-163
24,31,53,35,0,87,-87
24,31,53,53,103,121,-18
24,31,53,61,0,69,-69
24,31,53,67,0,68,-68
24,31,54,3,79,252,-173
24,31,54,37,75,161,-86
24,31,54,61,52,51,1
24,31,55,25,118,81,37
24,31,55,79,57,0,57
24,33,4,13,153,200,-47
24,33,6,1,70,106,-36
24,33,6,37,374,477,-103
24,33,6,59,50,75,-25
24,33,6,65,75,68,7
24,33,6,71,64,76,-12
24,33,6,73,226,312,-86
24,33,6,85,0,171,-171
24,33,8,5,0,62,-62
24,33,8,31,0,60,-60
24,33,8,41,108,137,-29
24,33,9,1,59,0,59
24,33,9,3,74,65,9
24,33,9,9,61,0,61
24,33,10,1,92,133,-41
24,33,10,3,194,164,30
24,33,10,5,69,204,-135
24,33,11,1,14297,11092,3205
24,33,12,9,53,63,-10
24,33,12,11,198,286,-88
24,33,12,31,136,116,20
24,33,12,57,126,242,-116
24,33,12,71,0,67,-67
24,33,12,73,46,0,46
24,33,12,86,218,155,63
24,33,12,95,149,189,-40
24,33,12,97,0,67,-67
24,33,12,99,97,157,-60
24,33,12,103,52,102,-50
24,33,12,109,0,63,-63
24,33,12,117,50,0,50
24,33,12,127,0,53,-53
24,33,13,63,0,73,-73
24,33,13,67,96,171,-75
24,33,13,89,184,172,12
24,33,13,121,204,361,-157
24,33,13,135,171,212,-41
24,33,13,151,0,69,-69
24,33,15,3,189,143,46
24,33,17,31,233,169,64
24,33,18,97,51,104,-53
24,33,21,111,0,66,-66
24,33,24,3,4420,8756,-4336
24,33,24,5,1654,1874,-220
24,33,24,9,439,1113,-674
24,33,24,11,0,61,-61
24,33,24,13,117,230,-113
24,33,24,15,0,71,-71
24,33,24,17,3302,7127,-3825
24,33,24,19,0,56,-56
24,33,24,21,424,740,-316
24,33,24,25,248,267,-19
24,33,24,27,2476,4450,-1974
24,33,24,31,12629,12488,141
24,33,24,35,48,121,-73
24,33,24,37,345,495,-150
24,33,24,43,163,358,-195
24,33,24,45,122,118,4
24,33,24,47,0,50,-50
24,33,24,510,1462,1759,-297
24,33,25,17,87,125,-38
24,33,25,21,0,55,-55
24,33,25,25,110,80,30
24,33,26,163,95,64,31
24,33,27,53,53,83,-30
24,33,27,123,0,56,-56
24,33,29,189,46,0,46
24,33,32,3,143,181,-38
24,33,34,1,67,0,67
24,33,34,3,69,51,18
24,33,34,5,80,83,-3
24,33,34,7,66,67,-1
24,33,34,13,153,163,-10
24,33,34,17,121,150,-29
24,33,34,21,81,77,4
24,33,34,23,144,162,-18
24,33,34,25,83,106,-23
24,33,34,27,57,62,-5
24,33,34,39,119,112,7
24,33,36,5,270,124,146
24,33,36,29,61,0,61
24,33,36,47,477,309,168
24,33,36,59,223,122,101
24,33,36,61,178,193,-15
24,33,36,81,363,258,105
24,33,36,103,167,197,-30
24,33,36,119,102,80,22
24,33,37,51,137,180,-43
24,33,37,63,143,127,16
24,33,37,67,0,82,-82
24,33,37,81,125,151,-26
24,33,37,119,244,373,-129
24,33,37,133,65,91,-26
24,33,37,183,225,312,-87
24,33,39,35,80,84,-4
24,33,39,49,105,150,-45
24,33,42,3,152,158,-6
24,33,42,17,58,0,58
24,33,42,43,73,65,8
24,33,42,45,75,93,-18
24,33,42,71,50,63,-13
24,33,42,91,75,96,-21
24,33,42,101,297,295,2
24,33,42,133,82,128,-46
24,33,45,19,0,73,-73
24,33,45,51,0,129,-129
24,33,45,79,73,77,-4
24,33,47,37,71,75,-4
24,33,47,125,0,54,-54
24,33,47,157,76,75,1
24,33,48,27,78,68,10
24,33,48,29,241,262,-21
24,33,48,85,0,128,-128
24,33,48,113,143,216,-73
24,33,48,141,70,0,70
24,33,48,157,0,107,-107
24,33,48,201,299,323,-24
24,33,48,439,119,193,-74
24,33,48,453,122,102,20
24,33,51,13,1104,852,252
24,33,51,41,117,131,-14
24,33,51,59,4130,3940,190
24,33,51,61,0,68,-68
24,33,51,87,125,162,-37
24,33,51,107,383,663,-280
24,33,51,153,1281,1516,-235
24,33,51,177,138,187,-49
24,33,51,179,154,283,-129
24,33,51,510,1823,1402,421
24,33,51,550,109,101,8
24,33,51,600,59,85,-26
24,33,51,650,167,99,68
24,33,51,683,84,176,-92
24,33,51,685,67,66,1
24,33,51,700,85,75,10
24,33,51,710,152,112,40
24,33,51,760,147,133,14
24,33,51,800,64,0,64
24,33,51,810,168,152,16
24,33,53,33,96,143,-47
24,33,53,53,70,59,11
24,33,53,61,0,64,-64
24,33,54,3,53,135,-82
24,33,54,37,0,69,-69
24,35,10,1,104,120,-16
24,35,10,5,55,103,-48
24,35,24,3,1291,688,603
24,35,24,5,177,75,102
24,35,24,11,333,372,-39
24,35,24,27,120,64,56
24,35,24,29,273,351,-78
24,35,24,31,175,0,175
24,35,24,33,121,48,73
24,35,24,41,171,267,-96
24,35,24,510,69,93,-24
24,35,51,59,52,0,52
24,37,6,37,0,64,-64
24,37,6,73,292,228,64
24,37,11,1,107,95,12
24,37,12,9,0,82,-82
24,37,12,19,128,0,128
24,37,12,31,173,137,36
24,37,12,33,0,67,-67
24,37,12,95,0,75,-75
24,37,12,99,82,0,82
24,37,24,3,207,296,-89
24,37,24,5,55,100,-45
24,37,24,9,1041,1009,32
24,37,24,17,1514,982,532
24,37,24,27,0,59,-59
24,37,24,31,117,111,6
24,37,24,33,495,345,150
24,37,24,510,51,77,-26
24,37,51,13,0,52,-52
24,37,51,59,161,102,59
24,37,51,99,72,61,11
24,37,51,153,85,0,85
24,37,51,510,0,55,-55
24,37,51,550,82,86,-4
24,37,51,710,95,84,11
24,37,51,810,256,173,83
24,37,53,29,123,94,29
24,39,10,5,62,69,-7
24,39,24,45,677,636,41
24,39,24,47,133,172,-39
24,41,10,5,56,77,-21
24,41,11,1,56,0,56
24,41,24,3,260,236,24
24,41,24,5,139,62,77
24,41,24,11,345,336,9
24,41,24,19,423,350,73
24,41,24,31,74,80,-6
24,41,24,35,267,171,96
24,41,24,45,76,62,14
24,41,24,510,63,0,63
24,43,11,1,108,71,37
24,43,24,1,136,134,2
24,43,24,3,223,112,111
24,43,24,5,222,189,33
24,43,24,13,200,97,103
24,43,24,21,2282,1607,675
24,43,24,27,148,92,56
24,43,24,31,982,371,611
24,43,24,33,358,163,195
24,43,24,510,159,102,57
24,43,36,5,68,0,68
24,43,42,1,0,103,-103
24,43,42,41,0,91,-91
24,43,42,55,947,1210,-263
24,43,42,57,65,106,-41
24,43,45,51,0,72,-72
24,43,51,59,122,87,35
24,43,51,69,74,0,74
24,43,51,107,0,80,-80
24,43,51,153,56,0,56
24,43,54,3,858,1171,-313
24,43,54,37,161,161,0
24,43,54,65,124,121,3
24,45,10,1,158,94,64
24,45,10,3,0,59,-59
24,45,10,5,949,1055,-106
24,45,12,86,46,0,46
24,45,12,99,88,0,88
24,45,24,3,191,194,-3
24,45,24,5,163,201,-38
24,45,24,11,86,61,25
24,45,24,19,331,162,169
24,45,24,21,50,0,50
24,45,24,27,0,89,-89
24,45,24,31,66,95,-29
24,45,24,33,118,122,-4
24,45,24,39,636,677,-41
24,45,24,41,62,76,-14
24,45,24,47,1070,816,254
24,45,24,510,109,143,-34
24,45,42,101,0,54,-54
24,45,51,1,175,102,73
24,47,10,3,53,0,53
24,47,10,5,363,468,-105
24,47,24,3,249,156,93
24,47,24,5,360,159,201
24,47,24,13,106,0,106
24,47,24,21,59,0,59
24,47,24,25,185,63,122
24,47,24,27,79,64,15
24,47,24,31,153,77,76
24,47,24,33,50,0,50
24,47,24,39,172,133,39
24,47,24,45,816,1070,-254
24,47,24,510,111,52,59
24,47,42,133,86,0,86
24,47,51,1,178,126,52
24,47,51,59,53,0,53
24,510,4,13,104,134,-30
24,510,4,19,0,64,-64
24,510,6,1,110,133,-23
24,510,6,37,302,384,-82
24,510,6,59,54,84,-30
24,510,6,73,130,193,-63
24,510,6,75,78,139,-61
24,510,6,81,0,55,-55
24,510,6,85,77,151,-74
24,510,8,31,76,230,-154
24,510,9,1,81,79,2
24,510,9,3,95,51,44
24,510,9,9,107,79,28
24,510,10,3,200,172,28
24,510,10,5,73,172,-99
24,510,11,1,1212,844,368
24,510,12,11,121,128,-7
24,510,12,31,71,126,-55
24,510,12,57,75,99,-24
24,510,12,71,0,63,-63
24,510,12,86,140,114,26
24,510,12,95,67,93,-26
24,510,12,99,93,120,-27
24,510,12,103,53,69,-16
24,510,13,63,0,60,-60
24,510,13,67,0,83,-83
24,510,13,89,98,145,-47
24,510,13,121,149,194,-45
24,510,13,135,71,77,-6
24,510,17,31,272,335,-63
24,510,18,97,0,63,-63
24,510,22,71,50,0,50
24,510,24,3,3291,4583,-1292
24,510,24,5,18758,27448,-8690
24,510,24,9,93,96,-3
24,510,24,13,564,570,-6
24,510,24,15,98,114,-16
24,510,24,17,138,146,-8
24,510,24,19,0,52,-52
24,510,24,21,307,286,21
24,510,24,25,1290,1996,-706
24,510,24,27,2077,2717,-640
24,510,24,31,1527,1357,170
24,510,24,33,1759,1462,297
24,510,24,35,93,69,24
24,510,24,37,77,51,26
24,510,24,41,0,63,-63
24,510,24,43,102,159,-57
24,510,24,45,143,109,34
24,510,24,47,52,111,-59
24,510,25,17,194,203,-9
24,510,25,21,73,0,73
24,510,25,25,179,200,-21
24,510,26,125,59,82,-23
24,510,26,161,55,48,7
24,510,26,163,67,59,8
24,510,27,37,0,82,-82
24,510,27,53,91,84,7
24,510,29,510,0,62,-62
24,510,32,3,56,122,-66
24,510,34,3,76,49,27
24,510,34,5,45,56,-11
24,510,34,7,0,67,-67
24,510,34,13,124,119,5
24,510,34,17,91,146,-55
24,510,34,21,77,57,20
24,510,34,23,76,66,10
24,510,34,25,81,63,18
24,510,34,27,55,0,55
24,510,34,29,74,66,8
24,510,34,31,64,0,64
24,510,34,35,0,51,-51
24,510,34,39,94,71,23
24,510,36,5,201,127,74
24,510,36,29,65,0,65
24,510,36,47,447,382,65
24,510,36,55,53,62,-9
24,510,36,59,97,126,-29
24,510,36,61,388,429,-41
24,510,36,67,54,0,54
24,510,36,81,294,242,52
24,510,36,103,99,68,31
24,510,36,119,74,50,24
24,510,37,63,63,119,-56
24,510,37,81,63,91,-28
24,510,37,119,109,243,-134
24,510,37,183,138,186,-48
24,510,39,35,77,102,-25
24,510,39,49,85,100,-15
24,510,39,61,64,52,12
24,510,41,51,75,87,-12
24,510,42,3,142,183,-41
24,510,42,17,66,81,-15
24,510,42,29,90,80,10
24,510,42,41,0,69,-69
24,510,42,43,71,81,-10
24,510,42,45,82,83,-1
24,510,42,71,79,78,1
24,510,42,91,121,126,-5
24,510,42,101,433,543,-110
24,510,42,133,431,561,-130
24,510,44,7,67,59,8
24,510,45,19,49,109,-60
24,510,45,51,0,58,-58
24,510,47,37,52,127,-75
24,510,48,29,66,86,-20
24,510,48,113,93,120,-27
24,510,48,201,141,229,-88
24,510,48,453,116,136,-20
24,510,51,13,197,194,3
24,510,51,59,366,393,-27
24,510,51,87,48,59,-11
24,510,51,107,79,81,-2
24,510,51,153,90,77,13
24,510,51,510,131,136,-5
24,510,51,710,44,64,-20
24,510,51,760,95,87,8
24,510,51,810,0,87,-87
24,510,53,33,108,263,-155
24,510,54,3,0,80,-80
24,510,55,25,68,0,68
25,1,4,13,60,79,-19
25,1,6,37,104,101,3
25,1,6,73,56,84,-28
25,1,8,31,0,51,-51
25,1,9,1,210,81,129
25,1,9,3,255,109,146
25,1,9,9,136,56,80
25,1,9,11,53,0,53
25,1,11,1,62,41,21
25,1,12,9,0,54,-54
25,1,12,11,116,93,23
25,1,12,15,0,84,-84
25,1,12,21,171,293,-122
25,1,12,57,0,56,-56
25,1,12,61,0,59,-59
25,1,12,71,116,215,-99
25,1,12,81,0,95,-95
25,1,12,86,65,0,65
25,1,12,95,0,59,-59
25,1,12,99,140,182,-42
25,1,12,103,68,91,-23
25,1,12,115,68,133,-65
25,1,17,31,64,48,16
25,1,23,5,0,100,-100
25,1,23,31,51,66,-15
25,1,24,31,55,0,55
25,1,25,3,73,0,73
25,1,25,5,789,766,23
25,1,25,7,165,76,89
25,1,25,9,288,255,33
25,1,25,13,209,149,60
25,1,25,15,130,90,40
25,1,25,17,1642,1049,593
25,1,25,19,186,84,102
25,1,25,21,1243,741,502
25,1,25,23,1918,2001,-83
25,1,25,25,779,644,135
25,1,25,27,920,414,506
25,1,33,11,161,140,21
25,1,33,13,0,61,-61
25,1,33,15,84,82,2
25,1,34,3,65,0,65
25,1,36,47,96,67,29
25,1,36,61,136,107,29
25,1,36,81,96,0,96
25,1,36,103,60,0,60
25,1,36,119,103,0,103
25,1,44,5,0,59,-59
25,1,44,7,161,164,-3
25,1,45,51,0,54,-54
25,1,51,59,67,0,67
25,1,53,33,59,0,59
25,3,6,37,63,0,63
25,3,9,3,102,100,2
25,3,9,5,113,133,-20
25,3,12,99,47,63,-16
25,3,12,115,0,54,-54
25,3,25,1,0,73,-73
25,3,25,9,64,75,-11
25,3,25,11,73,84,-11
25,3,25,13,344,272,72
25,3,25,15,136,201,-65
25,3,25,17,219,214,5
25,3,25,21,78,67,11
25,3,25,25,123,103,20
25,3,25,27,136,81,55
25,3,36,1,81,73,8
25,3,36,5,53,0,53
25,3,36,21,165,141,24
25,3,36,47,125,50,75
25,3,36,61,163,89,74
25,3,36,81,51,0,51
25,3,36,83,159,114,45
25,3,36,119,59,0,59
25,3,50,3,143,157,-14
25,5,4,13,58,110,-52
25,5,6,37,106,153,-47
25,5,6,73,60,117,-57
25,5,9,1,81,0,81
25,5,9,3,94,93,1
25,5,9,9,68,97,-29
25,5,9,11,78,115,-37
25,5,9,15,0,84,-84
25,5,12,9,0,79,-79
25,5,12,11,114,89,25
25,5,12,15,0,107,-107
25,5,12,21,55,70,-15
25,5,12,31,0,68,-68
25,5,12,53,0,71,-71
25,5,12,57,79,81,-2
25,5,12,71,75,172,-97
25,5,12,81,0,69,-69
25,5,12,95,99,128,-29
25,5,12,99,97,186,-89
25,5,12,101,0,72,-72
25,5,12,103,64,102,-38
25,5,12,105,0,110,-110
25,5,12,111,0,66,-66
25,5,12,115,53,149,-96
25,5,12,127,56,67,-11
25,5,17,31,0,50,-50
25,5,23,5,47,53,-6
25,5,23,31,0,86,-86
25,5,25,1,766,789,-23
25,5,25,9,472,333,139
25,5,25,13,188,163,25
25,5,25,15,64,50,14
25,5,25,17,1394,1133,261
25,5,25,21,4970,3560,1410
25,5,25,23,6619,4888,1731
25,5,25,25,1972,1283,689
25,5,25,27,807,957,-150
25,5,32,3,0,57,-57
25,5,33,9,0,66,-66
25,5,33,11,138,189,-51
25,5,33,13,0,44,-44
25,5,33,15,64,103,-39
25,5,36,5,76,0,76
25,5,36,47,123,105,18
25,5,36,61,73,96,-23
25,5,36,81,70,0,70
25,5,37,119,0,82,-82
25,5,37,183,0,60,-60
25,5,44,1,433,476,-43
25,5,44,3,426,464,-38
25,5,44,5,784,744,40
25,5,44,7,3435,3284,151
25,5,44,9,124,163,-39
25,5,45,51,0,114,-114
25,5,48,201,0,59,-59
25,5,53,33,0,59,-59
25,7,25,1,76,165,-89
25,7,25,17,117,103,14
25,7,25,25,53,74,-21
25,9,4,13,128,219,-91
25,9,6,1,0,71,-71
25,9,6,37,226,310,-84
25,9,6,59,88,84,4
25,9,6,65,0,49,-49
25,9,6,73,164,199,-35
25,9,6,75,67,85,-18
25,9,6,85,83,131,-48
25,9,8,13,0,60,-60
25,9,8,31,0,63,-63
25,9,8,41,0,61,-61
25,9,9,1,144,144,0
25,9,9,3,166,180,-14
25,9,9,9,144,131,13
25,9,9,11,63,0,63
25,9,11,1,82,104,-22
25,9,12,9,0,73,-73
25,9,12,11,204,184,20
25,9,12,15,0,81,-81
25,9,12,21,83,252,-169
25,9,12,31,0,88,-88
25,9,12,57,100,184,-84
25,9,12,61,0,55,-55
25,9,12,69,0,78,-78
25,9,12,71,114,282,-168
25,9,12,81,0,84,-84
25,9,12,83,0,59,-59
25,9,12,85,0,52,-52
25,9,12,86,174,159,15
25,9,12,95,116,266,-150
25,9,12,97,67,115,-48
25,9,12,99,216,352,-136
25,9,12,101,50,85,-35
25,9,12,103,85,167,-82
25,9,12,105,0,115,-115
25,9,12,111,0,81,-81
25,9,12,115,75,185,-110
25,9,12,127,0,72,-72
25,9,13,67,0,65,-65
25,9,13,121,81,87,-6
25,9,13,135,0,73,-73
25,9,15,3,71,52,19
25,9,17,31,184,133,51
25,9,23,5,200,337,-137
25,9,23,11,0,77,-77
25,9,23,15,0,50,-50
25,9,23,17,0,87,-87
25,9,23,31,223,592,-369
25,9,24,31,68,100,-32
25,9,25,1,255,288,-33
25,9,25,3,75,64,11
25,9,25,5,333,472,-139
25,9,25,11,0,74,-74
25,9,25,13,195,205,-10
25,9,25,15,99,115,-16
25,9,25,17,14912,10462,4450
25,9,25,21,1357,1036,321
25,9,25,23,454,575,-121
25,9,25,25,7436,4599,2837
25,9,25,27,981,1382,-401
25,9,32,3,56,97,-41
25,9,33,1,92,169,-77
25,9,33,3,94,274,-180
25,9,33,9,70,144,-74
25,9,33,11,915,1824,-909
25,9,33,13,162,229,-67
25,9,33,15,2573,5884,-3311
25,9,33,17,238,511,-273
25,9,34,3,60,0,60
25,9,34,17,85,62,23
25,9,34,23,66,58,8
25,9,34,31,69,0,69
25,9,36,5,321,222,99
25,9,36,29,0,90,-90
25,9,36,47,248,232,16
25,9,36,55,43,0,43
25,9,36,59,86,0,86
25,9,36,61,359,311,48
25,9,36,81,139,113,26
25,9,36,103,85,47,38
25,9,36,119,94,0,94
25,9,37,119,65,132,-67
25,9,37,183,65,147,-82
25,9,39,35,0,54,-54
25,9,39,49,0,60,-60
25,9,41,51,0,75,-75
25,9,42,3,0,53,-53
25,9,42,101,91,119,-28
25,9,44,7,268,433,-165
25,9,45,13,0,57,-57
25,9,45,19,0,62,-62
25,9,45,51,0,73,-73
25,9,47,37,0,161,-161
25,9,48,29,0,50,-50
25,9,48,113,0,62,-62
25,9,48,201,89,138,-49
25,9,48,453,108,95,13
25,9,49,35,0,45,-45
25,9,50,7,88,100,-12
25,9,51,59,0,71,-71
25,9,53,33,102,137,-35
25,11,9,3,49,52,-3
25,11,25,3,84,73,11
25,11,25,9,74,0,74
25,11,25,13,384,400,-16
25,11,25,15,1260,1058,202
25,11,25,17,192,186,6
25,11,25,25,72,62,10
25,11,25,27,723,589,134
25,11,33,5,97,95,2
25,11,50,25,143,116,27
25,13,4,13,85,107,-22
25,13,6,37,87,112,-25
25,13,6,73,66,99,-33
25,13,9,1,101,93,8
25,13,9,3,1687,2384,-697
25,13,9,5,62,0,62
25,13,9,7,52,67,-15
25,13,9,9,226,214,12
25,13,9,11,82,97,-15
25,13,9,13,266,404,-138
25,13,9,15,56,61,-5
25,13,12,9,0,74,-74
25,13,12,11,72,93,-21
25,13,12,21,0,67,-67
25,13,12,57,109,172,-63
25,13,12,71,0,98,-98
25,13,12,81,0,56,-56
25,13,12,83,0,63,-63
25,13,12,95,194,198,-4
25,13,12,97,131,153,-22
25,13,12,99,101,129,-28
25,13,12,103,60,112,-52
25,13,12,105,90,105,-15
25,13,12,115,0,104,-104
25,13,12,117,57,0,57
25,13,12,127,58,88,-30
25,13,17,31,0,66,-66
25,13,23,5,0,72,-72
25,13,23,31,0,80,-80
25,13,25,1,149,209,-60
25,13,25,3,272,344,-72
25,13,25,5,163,188,-25
25,13,25,9,205,195,10
25,13,25,11,400,384,16
25,13,25,15,3439,3371,68
25,13,25,17,491,521,-30
25,13,25,21,221,183,38
25,13,25,23,109,155,-46
25,13,25,25,359,376,-17
25,13,25,27,1385,1352,33
25,13,32,3,59,59,0
25,13,33,5,0,70,-70
25,13,33,11,64,98,-34
25,13,33,15,63,51,12
25,13,36,5,154,69,85
25,13,36,47,188,109,79
25,13,36,55,63,65,-2
25,13,36,61,109,86,23
25,13,36,81,112,54,58
25,13,36,119,69,0,69
25,13,37,119,0,122,-122
25,13,39,49,0,51,-51
25,13,42,101,0,83,-83
25,13,44,7,130,123,7
25,13,44,9,0,59,-59
25,13,45,51,0,117,-117
25,13,48,201,64,0,64
25,13,50,25,0,68,-68
25,15,6,1,63,52,11
25,15,6,37,50,74,-24
25,15,6,73,50,62,-12
25,15,6,75,0,46,-46
25,15,6,85,0,76,-76
25,15,9,3,214,286,-72
25,15,9,9,73,72,1
25,15,9,13,73,69,4
25,15,11,1,0,42,-42
25,15,12,115,0,59,-59
25,15,17,31,50,61,-11
25,15,23,5,0,57,-57
25,15,25,1,90,130,-40
25,15,25,3,201,136,65
25,15,25,5,50,64,-14
25,15,25,9,115,99,16
25,15,25,11,1058,1260,-202
25,15,25,13,3371,3439,-68
25,15,25,17,476,519,-43
25,15,25,21,126,151,-25
25,15,25,23,69,66,3
25,15,25,25,222,282,-60
25,15,25,27,713,569,144
25,15,33,11,52,0,52
25,15,36,47,95,114,-19
25,15,36,61,105,137,-32
25,15,36,81,0,47,-47
25,15,41,51,0,48,-48
25,15,44,7,56,0,56
25,15,50,7,0,45,-45
25,15,50,25,47,62,-15
25,15,53,33,51,84,-33
25,17,4,13,369,510,-141
25,17,4,19,114,175,-61
25,17,6,1,595,752,-157
25,17,6,13,206,187,19
25,17,6,37,1124,1543,-419
25,17,6,41,71,91,-20
25,17,6,59,337,487,-150
25,17,6,65,79,95,-16
25,17,6,67,82,157,-75
25,17,6,71,86,80,6
25,17,6,73,660,939,-279
25,17,6,75,539,869,-330
25,17,6,81,327,416,-89
25,17,6,83,79,93,-14
25,17,6,85,689,1240,-551
25,17,6,97,0,57,-57
25,17,6,111,209,97,112
25,17,8,5,60,77,-17
25,17,8,13,125,259,-134
25,17,8,31,195,384,-189
25,17,8,35,0,71,-71
25,17,8,41,96,133,-37
25,17,8,59,73,102,-29
25,17,8,69,52,0,52
25,17,9,1,721,486,235
25,17,9,3,790,616,174
25,17,9,5,95,74,21
25,17,9,7,93,92,1
25,17,9,9,739,427,312
25,17,9,11,206,128,78
25,17,9,13,159,86,73
25,17,9,15,75,70,5
25,17,10,3,121,102,19
25,17,11,1,753,820,-67
25,17,12,1,104,56,48
25,17,12,9,123,129,-6
25,17,12,11,492,449,43
25,17,12,15,0,90,-90
25,17,12,21,120,297,-177
25,17,12,31,120,151,-31
25,17,12,57,242,355,-113
25,17,12,61,0,64,-64
25,17,12,69,0,71,-71
25,17,12,71,189,314,-125
25,17,12,73,67,0,67
25,17,12,81,73,114,-41
25,17,12,85,0,56,-56
25,17,12,86,365,427,-62
25,17,12,95,274,332,-58
25,17,12,97,58,106,-48
25,17,12,99,463,671,-208
25,17,12,101,80,109,-29
25,17,12,103,168,280,-112
25,17,12,105,65,107,-42
25,17,12,109,0,81,-81
25,17,12,111,0,76,-76
25,17,12,115,136,243,-107
25,17,12,117,65,127,-62
25,17,12,119,59,101,-42
25,17,12,127,67,129,-62
25,17,13,67,97,145,-48
25,17,13,89,149,121,28
25,17,13,121,304,344,-40
25,17,13,135,71,142,-71
25,17,15,3,160,125,35
25,17,17,19,124,52,72
25,17,17,31,1084,975,109
25,17,17,43,95,115,-20
25,17,17,97,166,86,80
25,17,18,57,109,80,29
25,17,18,97,121,62,59
25,17,18,105,66,0,66
25,17,18,157,75,0,75
25,17,20,91,74,56,18
25,17,21,111,57,73,-16
25,17,22,71,108,92,16
25,17,23,5,401,717,-316
25,17,23,9,0,48,-48
25,17,23,11,57,76,-19
25,17,23,13,0,68,-68
25,17,23,15,53,66,-13
25,17,23,17,0,79,-79
25,17,23,19,100,101,-1
25,17,23,23,0,55,-55
25,17,23,31,276,750,-474
25,17,24,3,111,93,18
25,17,24,5,125,69,56
25,17,24,27,88,93,-5
25,17,24,31,471,413,58
25,17,24,33,125,87,38
25,17,24,510,203,194,9
25,17,25,1,1049,1642,-593
25,17,25,3,214,219,-5
25,17,25,5,1133,1394,-261
25,17,25,7,103,117,-14
25,17,25,9,10462,14912,-4450
25,17,25,11,186,192,-6
25,17,25,13,521,491,30
25,17,25,15,519,476,43
25,17,25,19,0,59,-59
25,17,25,21,9315,10370,-1055
25,17,25,23,1583,2241,-658
25,17,25,25,23897,19207,4690
25,17,25,27,8129,12153,-4024
25,17,26,65,58,0,58
25,17,26,81,0,61,-61
25,17,26,99,56,0,56
25,17,26,125,165,140,25
25,17,26,161,234,181,53
25,17,26,163,104,115,-11
25,17,27,53,277,268,9
25,17,27,123,98,90,8
25,17,29,95,49,0,49
25,17,29,189,143,109,34
25,17,29,510,64,51,13
25,17,32,3,228,238,-10
25,17,33,1,127,280,-153
25,17,33,3,103,239,-136
25,17,33,5,168,220,-52
25,17,33,9,261,424,-163
25,17,33,11,2998,5790,-2792
25,17,33,13,222,448,-226
25,17,33,15,1414,2981,-1567
25,17,33,17,264,329,-65
25,17,33,19,0,66,-66
25,17,34,3,278,171,107
25,17,34,5,81,73,8
25,17,34,7,58,51,7
25,17,34,13,217,125,92
25,17,34,17,396,435,-39
25,17,34,19,67,0,67
25,17,34,21,242,153,89
25,17,34,23,392,272,120
25,17,34,25,104,99,5
25,17,34,27,187,110,77
25,17,34,29,0,53,-53
25,17,34,31,66,0,66
25,17,34,35,189,117,72
25,17,34,39,148,82,66
25,17,35,1,64,59,5
25,17,35,49,0,59,-59
25,17,36,1,170,106,64
25,17,36,5,197,97,100
25,17,36,27,118,65,53
25,17,36,29,141,98,43
25,17,36,47,889,1154,-265
25,17,36,55,267,245,22
25,17,36,59,263,132,131
25,17,36,61,1532,1927,-395
25,17,36,65,57,0,57
25,17,36,67,181,121,60
25,17,36,71,96,65,31
25,17,36,81,490,454,36
25,17,36,83,101,43,58
25,17,36,87,67,0,67
25,17,36,91,103,100,3
25,17,36,93,0,62,-62
25,17,36,103,301,142,159
25,17,36,109,137,81,56
25,17,36,119,351,309,42
25,17,37,19,0,76,-76
25,17,37,21,0,46,-46
25,17,37,51,75,0,75
25,17,37,63,211,223,-12
25,17,37,67,0,47,-47
25,17,37,81,50,79,-29
25,17,37,119,174,321,-147
25,17,37,129,0,54,-54
25,17,37,133,69,70,-1
25,17,37,135,85,121,-36
25,17,37,183,328,558,-230
25,17,39,35,130,135,-5
25,17,39,49,215,192,23
25,17,39,61,114,92,22
25,17,41,51,189,240,-51
25,17,41,67,80,112,-32
25,17,42,3,334,346,-12
25,17,42,17,110,127,-17
25,17,42,27,90,0,90
25,17,42,29,114,104,10
25,17,42,45,119,112,7
25,17,42,71,46,61,-15
25,17,42,77,61,0,61
25,17,42,91,257,191,66
25,17,42,95,57,0,57
25,17,42,101,504,518,-14
25,17,44,1,67,52,15
25,17,44,3,183,151,32
25,17,44,5,119,157,-38
25,17,44,7,900,1142,-242
25,17,44,9,159,133,26
25,17,45,13,0,98,-98
25,17,45,19,79,149,-70
25,17,45,45,65,67,-2
25,17,45,51,0,115,-115
25,17,45,79,61,0,61
25,17,47,37,164,208,-44
25,17,47,157,73,101,-28
25,17,48,29,160,196,-36
25,17,48,41,52,0,52
25,17,48,85,120,278,-158
25,17,48,113,286,306,-20
25,17,48,121,65,103,-38
25,17,48,141,68,0,68
25,17,48,157,62,0,62
25,17,48,201,474,482,-8
25,17,48,439,132,145,-13
25,17,48,453,386,495,-109
25,17,48,491,69,111,-42
25,17,49,35,149,177,-28
25,17,49,49,105,110,-5
25,17,50,7,218,247,-29
25,17,50,23,52,65,-13
25,17,50,25,53,0,53
25,17,50,27,54,74,-20
25,17,51,3,0,65,-65
25,17,51,13,218,308,-90
25,17,51,59,400,423,-23
25,17,51,107,107,132,-25
25,17,51,121,50,0,50
25,17,51,510,116,121,-5
25,17,51,540,57,0,57
25,17,51,760,45,59,-14
25,17,51,810,82,0,82
25,17,53,33,632,1236,-604
25,17,53,53,69,76,-7
25,17,53,61,79,91,-12
25,17,55,25,233,129,104
25,17,55,79,124,61,63
25,19,25,1,84,186,-102
25,19,25,17,59,0,59
25,19,25,25,61,54,7
25,21,4,13,169,224,-55
25,21,6,1,100,140,-40
25,21,6,13,0,62,-62
25,21,6,37,373,531,-158
25,21,6,59,103,170,-67
25,21,6,65,0,55,-55
25,21,6,73,192,243,-51
25,21,6,75,141,186,-45
25,21,6,81,111,96,15
25,21,6,85,92,209,-117
25,21,8,31,62,123,-61
25,21,9,1,279,178,101
25,21,9,3,368,221,147
25,21,9,9,310,201,109
25,21,9,11,98,69,29
25,21,9,13,51,0,51
25,21,11,1,194,156,38
25,21,12,9,0,56,-56
25,21,12,11,202,224,-22
25,21,12,15,0,60,-60
25,21,12,21,95,153,-58
25,21,12,31,58,0,58
25,21,12,57,144,169,-25
25,21,12,71,99,176,-77
25,21,12,81,0,54,-54
25,21,12,86,146,174,-28
25,21,12,95,122,123,-1
25,21,12,97,0,63,-63
25,21,12,99,215,335,-120
25,21,12,101,0,65,-65
25,21,12,103,90,130,-40
25,21,12,115,59,108,-49
25,21,12,127,0,48,-48
25,21,13,67,54,58,-4
25,21,13,89,0,56,-56
25,21,13,121,98,137,-39
25,21,15,3,48,61,-13
25,21,17,31,348,320,28
25,21,23,5,109,280,-171
25,21,23,31,59,170,-111
25,21,24,5,69,0,69
25,21,24,31,158,183,-25
25,21,24,33,55,0,55
25,21,24,510,0,73,-73
25,21,25,1,741,1243,-502
25,21,25,3,67,78,-11
25,21,25,5,3560,4970,-1410
25,21,25,9,1036,1357,-321
25,21,25,13,183,221,-38
25,21,25,15,151,126,25
25,21,25,17,10370,9315,1055
25,21,25,23,6485,9504,-3019
25,21,25,25,17291,10393,6898
25,21,25,27,2141,2584,-443
25,21,26,125,78,0,78
25,21,26,161,66,51,15
25,21,27,53,81,0,81
25,21,29,189,61,0,61
25,21,32,3,0,125,-125
25,21,33,1,0,85,-85
25,21,33,3,0,85,-85
25,21,33,5,0,50,-50
25,21,33,9,74,103,-29
25,21,33,11,343,402,-59
25,21,33,13,66,118,-52
25,21,33,15,271,274,-3
25,21,33,17,70,78,-8
25,21,34,3,113,86,27
25,21,34,13,91,0,91
25,21,34,17,135,135,0
25,21,34,23,177,121,56
25,21,34,27,65,0,65
25,21,34,35,55,0,55
25,21,36,5,58,60,-2
25,21,36,47,404,356,48
25,21,36,55,71,67,4
25,21,36,59,119,90,29
25,21,36,61,488,600,-112
25,21,36,67,51,0,51
25,21,36,81,263,185,78
25,21,36,103,160,0,160
25,21,36,119,160,101,59
25,21,37,63,57,0,57
25,21,37,119,82,196,-114
25,21,37,183,108,188,-80
25,21,39,35,95,57,38
25,21,39,49,51,50,1
25,21,41,51,0,87,-87
25,21,42,3,119,137,-18
25,21,42,17,0,64,-64
25,21,42,29,97,0,97
25,21,42,45,63,0,63
25,21,42,91,110,92,18
25,21,42,101,154,155,-1
25,21,44,1,59,77,-18
25,21,44,3,120,106,14
25,21,44,5,82,122,-40
25,21,44,7,1142,1632,-490
25,21,44,9,102,112,-10
25,21,45,19,0,99,-99
25,21,45,51,0,66,-66
25,21,47,37,0,113,-113
25,21,48,85,0,112,-112
25,21,48,113,96,167,-71
25,21,48,201,158,136,22
25,21,48,439,0,80,-80
25,21,48,453,94,151,-57
25,21,50,7,85,74,11
25,21,50,27,0,53,-53
25,21,51,13,75,103,-28
25,21,51,59,133,142,-9
25,21,53,33,112,314,-202
25,21,55,25,68,0,68
25,23,4,13,84,135,-51
25,23,6,37,145,155,-10
25,23,6,59,78,0,78
25,23,6,73,104,145,-41
25,23,8,31,0,50,-50
25,23,9,1,137,72,65
25,23,9,3,125,89,36
25,23,9,9,0,54,-54
25,23,9,11,0,51,-51
25,23,11,1,0,63,-63
25,23,12,9,0,70,-70
25,23,12,11,112,144,-32
25,23,12,15,0,84,-84
25,23,12,21,83,193,-110
25,23,12,57,63,122,-59
25,23,12,61,0,48,-48
25,23,12,71,100,180,-80
25,23,12,86,86,76,10
25,23,12,95,63,110,-47
25,23,12,99,122,166,-44
25,23,12,103,78,133,-55
25,23,12,105,0,62,-62
25,23,12,115,56,105,-49
25,23,12,127,0,93,-93
25,23,13,121,0,65,-65
25,23,17,31,76,63,13
25,23,23,5,62,151,-89
25,23,23,17,0,66,-66
25,23,23,31,63,88,-25
25,23,25,1,2001,1918,83
25,23,25,5,4888,6619,-1731
25,23,25,9,575,454,121
25,23,25,13,155,109,46
25,23,25,15,66,69,-3
25,23,25,17,2241,1583,658
25,23,25,21,9504,6485,3019
25,23,25,25,5242,2631,2611
25,23,25,27,583,617,-34
25,23,32,3,0,62,-62
25,23,33,3,54,0,54
25,23,33,9,0,64,-64
25,23,33,11,159,208,-49
25,23,33,13,0,45,-45
25,23,33,15,114,165,-51
25,23,36,47,106,80,26
25,23,36,61,137,136,1
25,23,36,81,81,0,81
25,23,37,119,0,71,-71
25,23,37,183,0,84,-84
25,23,44,3,55,84,-29
25,23,44,5,52,64,-12
25,23,44,7,390,580,-190
25,23,45,19,0,62,-62
25,23,45,51,0,85,-85
25,23,48,201,0,63,-63
25,23,50,7,82,0,82
25,23,51,59,68,0,68
25,23,53,33,0,56,-56
25,25,1,73,60,0,60
25,25,4,13,166,308,-142
25,25,4,19,77,69,8
25,25,6,1,214,268,-54
25,25,6,13,70,122,-52
25,25,6,37,726,1328,-602
25,25,6,59,216,309,-93
25,25,6,65,64,62,2
25,25,6,67,63,62,1
25,25,6,71,60,0,60
25,25,6,73,327,559,-232
25,25,6,75,478,761,-283
25,25,6,81,96,198,-102
25,25,6,85,248,535,-287
25,25,8,5,44,0,44
25,25,8,13,92,101,-9
25,25,8,31,157,369,-212
25,25,8,59,0,70,-70
25,25,9,1,527,348,179
25,25,9,3,540,348,192
25,25,9,5,79,52,27
25,25,9,7,77,57,20
25,25,9,9,527,313,214
25,25,9,11,154,97,57
25,25,9,13,114,58,56
25,25,9,15,70,0,70
25,25,10,3,62,0,62
25,25,11,1,556,526,30
25,25,12,1,57,0,57
25,25,12,9,0,55,-55
25,25,12,11,261,341,-80
25,25,12,21,53,95,-42
25,25,12,31,90,112,-22
25,25,12,57,162,188,-26
25,25,12,71,96,106,-10
25,25,12,73,47,0,47
25,25,12,81,0,63,-63
25,25,12,86,419,421,-2
25,25,12,95,263,275,-12
25,25,12,97,0,76,-76
25,25,12,99,237,330,-93
25,25,12,103,79,107,-28
25,25,12,115,58,98,-40
25,25,13,67,55,72,-17
25,25,13,89,116,153,-37
25,25,13,121,202,237,-35
25,25,13,135,72,145,-73
25,25,15,3,62,50,12
25,25,17,31,804,911,-107
25,25,17,43,52,61,-9
25,25,17,97,56,0,56
25,25,18,97,76,59,17
25,25,18,157,43,0,43
25,25,21,111,66,0,66
25,25,22,71,62,76,-14
25,25,23,5,223,430,-207
25,25,23,13,42,0,42
25,25,23,19,70,0,70
25,25,23,31,116,224,-108
25,25,24,5,92,77,15
25,25,24,31,230,260,-30
25,25,24,33,80,110,-30
25,25,24,510,200,179,21
25,25,25,1,644,779,-135
25,25,25,3,103,123,-20
25,25,25,5,1283,1972,-689
25,25,25,7,74,53,21
25,25,25,9,4599,7436,-2837
25,25,25,11,62,72,-10
25,25,25,13,376,359,17
25,25,25,15,282,222,60
25,25,25,17,19207,23897,-4690
25,25,25,19,54,61,-7
25,25,25,21,10393,17291,-6898
25,25,25,23,2631,5242,-2611
25,25,25,27,1664,1947,-283
25,25,26,125,106,96,10
25,25,26,161,114,145,-31
25,25,26,163,96,63,33
25,25,27,37,0,84,-84
25,25,27,53,119,220,-101
25,25,27,123,46,45,1
25,25,29,189,74,0,74
25,25,29,510,61,59,2
25,25,32,3,91,142,-51
25,25,33,1,67,0,67
25,25,33,3,58,51,7
25,25,33,5,59,0,59
25,25,33,9,188,109,79
25,25,33,11,533,592,-59
25,25,33,13,146,116,30
25,25,33,15,478,655,-177
25,25,33,17,107,103,4
25,25,34,3,143,150,-7
25,25,34,7,50,0,50
25,25,34,13,119,115,4
25,25,34,17,254,364,-110
25,25,34,21,97,63,34
25,25,34,23,125,134,-9
25,25,34,25,90,96,-6
25,25,34,27,114,90,24
25,25,34,31,57,0,57
25,25,34,35,67,62,5
25,25,34,39,91,73,18
25,25,35,1,51,0,51
25,25,36,1,74,79,-5
25,25,36,5,217,112,105
25,25,36,27,59,0,59
25,25,36,29,111,87,24
25,25,36,47,669,978,-309
25,25,36,55,153,132,21
25,25,36,59,202,136,66
25,25,36,61,1841,2036,-195
25,25,36,67,94,75,19
25,25,36,71,51,0,51
25,25,36,81,392,403,-11
25,25,36,83,51,0,51
25,25,36,87,49,0,49
25,25,36,91,70,0,70
25,25,36,93,50,0,50
25,25,36,103,227,169,58
25,25,36,109,77,0,77
25,25,36,117,49,0,49
25,25,36,119,202,193,9
25,25,37,63,120,149,-29
25,25,37,119,157,275,-118
25,25,37,135,84,67,17
25,25,37,183,149,195,-46
25,25,39,35,138,115,23
25,25,39,49,113,168,-55
25,25,39,61,87,107,-20
25,25,41,51,119,176,-57
25,25,42,3,199,194,5
25,25,42,17,63,55,8
25,25,42,29,84,55,29
25,25,42,45,60,64,-4
25,25,42,91,129,88,41
25,25,42,101,444,520,-76
25,25,44,1,52,53,-1
25,25,44,3,100,101,-1
25,25,44,5,98,112,-14
25,25,44,7,906,1286,-380
25,25,44,9,107,106,1
25,25,45,19,49,104,-55
25,25,47,37,99,173,-74
25,25,47,157,0,63,-63
25,25,48,29,105,89,16
25,25,48,85,0,95,-95
25,25,48,113,219,231,-12
25,25,48,201,357,284,73
25,25,48,439,68,114,-46
25,25,48,453,221,315,-94
25,25,49,35,89,95,-6
25,25,50,7,158,140,18
25,25,50,27,0,54,-54
25,25,51,13,172,170,2
25,25,51,59,171,206,-35
25,25,51,510,64,90,-26
25,25,51,710,49,0,49
25,25,51,760,47,44,3
25,25,53,33,412,664,-252
25,25,55,25,109,48,61
25,25,55,79,59,60,-1
25,27,4,13,146,313,-167
25,27,4,19,0,53,-53
25,27,6,1,83,96,-13
25,27,6,37,159,271,-112
25,27,6,59,94,96,-2
25,27,6,65,0,49,-49
25,27,6,73,186,229,-43
25,27,6,75,0,47,-47
25,27,6,85,89,146,-57
25,27,8,31,59,54,5
25,27,9,1,144,120,24
25,27,9,3,409,464,-55
25,27,9,7,72,64,8
25,27,9,9,253,165,88
25,27,9,11,134,134,0
25,27,9,13,131,195,-64
25,27,9,15,475,1226,-751
25,27,11,1,0,88,-88
25,27,12,9,89,182,-93
25,27,12,11,146,208,-62
25,27,12,15,53,86,-33
25,27,12,21,53,110,-57
25,27,12,31,61,96,-35
25,27,12,53,0,67,-67
25,27,12,57,117,233,-116
25,27,12,69,0,70,-70
25,27,12,71,84,224,-140
25,27,12,81,55,98,-43
25,27,12,83,0,75,-75
25,27,12,86,108,120,-12
25,27,12,95,150,278,-128
25,27,12,97,0,122,-122
25,27,12,99,153,228,-75
25,27,12,101,61,109,-48
25,27,12,103,110,170,-60
25,27,12,105,77,186,-109
25,27,12,111,0,79,-79
25,27,12,115,79,137,-58
25,27,12,117,0,80,-80
25,27,12,127,115,119,-4
25,27,13,121,52,84,-32
25,27,13,135,0,93,-93
25,27,15,3,0,58,-58
25,27,17,31,144,150,-6
25,27,23,5,99,214,-115
25,27,23,19,53,53,0
25,27,23,31,94,226,-132
25,27,24,31,101,78,23
25,27,25,1,414,920,-506
25,27,25,3,81,136,-55
25,27,25,5,957,807,150
25,27,25,9,1382,981,401
25,27,25,11,589,723,-134
25,27,25,13,1352,1385,-33
25,27,25,15,569,713,-144
25,27,25,17,12153,8129,4024
25,27,25,21,2584,2141,443
25,27,25,23,617,583,34
25,27,25,25,1947,1664,283
25,27,27,53,0,75,-75
25,27,32,3,90,93,-3
25,27,33,1,0,83,-83
25,27,33,3,0,92,-92
25,27,33,5,205,334,-129
25,27,33,9,58,100,-42
25,27,33,11,642,742,-100
25,27,33,13,57,169,-112
25,27,33,15,188,348,-160
25,27,33,17,60,108,-48
25,27,33,19,0,59,-59
25,27,34,3,65,0,65
25,27,34,13,79,0,79
25,27,34,17,68,72,-4
25,27,34,23,141,118,23
25,27,36,5,227,77,150
25,27,36,29,0,78,-78
25,27,36,47,215,143,72
25,27,36,55,62,64,-2
25,27,36,59,88,0,88
25,27,36,61,173,177,-4
25,27,36,67,72,0,72
25,27,36,81,169,85,84
25,27,36,103,88,51,37
25,27,36,119,72,53,19
25,27,37,51,0,58,-58
25,27,37,63,0,54,-54
25,27,37,119,78,166,-88
25,27,37,133,0,63,-63
25,27,37,183,74,168,-94
25,27,39,49,0,134,-134
25,27,42,3,70,87,-17
25,27,42,43,0,72,-72
25,27,42,91,0,72,-72
25,27,42,101,91,80,11
25,27,44,3,118,202,-84
25,27,44,5,0,101,-101
25,27,44,7,1292,1452,-160
25,27,44,9,68,98,-30
25,27,45,19,0,63,-63
25,27,45,51,0,167,-167
25,27,47,37,0,60,-60
25,27,48,29,0,76,-76
25,27,48,85,0,108,-108
25,27,48,113,0,92,-92
25,27,48,121,0,93,-93
25,27,48,201,112,150,-38
25,27,48,439,63,84,-21
25,27,48,453,69,131,-62
25,27,50,7,69,82,-13
25,27,50,25,0,77,-77
25,27,51,13,0,50,-50
25,27,51,59,64,117,-53
25,27,53,33,110,157,-47
26,1,26,7,147,87,60
26,1,26,49,62,0,62
26,1,26,69,214,153,61
26,1,26,125,85,49,36
26,1,26,163,65,0,65
26,3,26,103,131,101,30
26,5,17,31,177,75,102
26,5,26,15,592,586,6
26,5,26,21,119,96,23
26,5,26,25,83,88,-5
26,5,26,45,47,0,47
26,5,26,65,60,0,60
26,5,26,67,67,0,67
26,5,26,77,1052,1161,-109
26,5,26,81,2017,1654,363
26,5,26,121,110,138,-28
26,5,26,123,0,62,-62
26,5,26,125,81,44,37
26,5,26,139,2834,2613,221
26,5,26,159,626,680,-54
26,5,26,163,0,54,-54
26,7,26,1,87,147,-60
26,7,26,49,72,0,72
26,7,26,81,0,48,-48
26,7,26,119,87,84,3
26,7,26,125,74,0,74
26,7,26,141,124,163,-39
26,9,26,29,283,244,39
26,9,26,55,271,364,-93
26,9,26,79,239,253,-14
26,9,26,81,0,53,-53
26,9,26,125,99,96,3
26,9,26,137,128,136,-8
26,9,26,163,63,0,63
26,11,26,17,266,277,-11
26,11,26,49,67,0,67
26,11,26,69,133,88,45
26,11,26,111,0,55,-55
26,11,26,129,97,155,-58
26,11,26,145,100,73,27
26,13,26,61,74,87,-13
26,13,26,103,57,65,-8
26,15,26,5,586,592,-6
26,15,26,25,411,389,22
26,15,26,45,259,239,20
26,15,26,65,83,73,10
26,15,26,67,280,205,75
26,15,26,77,503,496,7
26,15,26,81,1467,1021,446
26,15,26,125,51,0,51
26,15,26,139,171,162,9
26,15,26,159,0,62,-62
26,17,26,11,277,266,11
26,17,26,35,0,50,-50
26,17,26,49,227,162,65
26,17,26,51,129,140,-11
26,17,26,63,99,55,44
26,17,26,65,71,51,20
26,17,26,69,61,90,-29
26,17,26,73,0,59,-59
26,17,26,81,82,127,-45
26,17,26,99,70,85,-15
26,17,26,111,839,899,-60
26,17,26,125,110,168,-58
26,17,26,129,65,69,-4
26,17,26,145,1217,1249,-32
26,17,26,157,279,199,80
26,17,26,163,90,83,7
26,19,26,55,588,508,80
26,19,26,89,108,79,29
26,19,26,101,143,191,-48
26,21,4,13,60,84,-24
26,21,12,57,0,94,-94
26,21,12,71,0,68,-68
26,21,17,31,605,272,333
26,21,17,43,144,72,72
26,21,18,39,185,185,0
26,21,18,89,63,0,63
26,21,18,91,272,274,-2
26,21,18,97,84,166,-82
26,21,18,127,75,72,3
26,21,18,141,1004,1011,-7
26,21,26,5,96,119,-23
26,21,26,25,52,0,52
26,21,26,27,1005,989,16
26,21,26,49,56,0,56
26,21,26,65,62,75,-13
26,21,26,77,326,420,-94
26,21,26,81,274,339,-65
26,21,26,99,59,0,59
26,21,26,125,100,103,-3
26,21,26,139,81,115,-34
26,21,26,159,755,645,110
26,21,26,161,63,80,-17
26,21,26,163,64,94,-30
26,23,18,3,57,86,-29
26,23,18,151,120,195,-75
26,23,26,25,451,414,37
26,23,26,59,341,317,24
26,23,26,75,61,71,-10
26,23,26,77,136,82,54
26,23,26,149,285,323,-38
26,23,26,163,85,82,3
26,25,4,13,0,68,-68
26,25,17,31,54,100,-46
26,25,26,5,88,83,5
26,25,26,15,389,411,-22
26,25,26,21,0,52,-52
26,25,26,23,414,451,-37
26,25,26,45,380,397,-17
26,25,26,59,153,160,-7
26,25,26,65,201,198,3
26,25,26,75,663,539,124
26,25,26,77,1277,1336,-59
26,25,26,81,178,286,-108
26,25,26,125,135,167,-32
26,25,26,139,0,85,-85
26,25,26,149,101,109,-8
26,25,26,159,78,89,-11
26,25,26,161,71,76,-5
26,25,26,163,171,164,7
26,27,17,31,99,0,99
26,27,18,39,734,487,247
26,27,18,141,709,534,175
26,27,26,21,989,1005,-16
26,27,26,77,145,154,-9
26,27,26,81,0,42,-42
26,27,26,149,405,334,71
26,27,26,159,366,260,106
26,29,26,9,244,283,-39
26,29,26,31,0,52,-52
26,29,26,47,393,447,-54
26,29,26,55,74,86,-12
26,29,26,81,81,45,36
26,29,26,125,99,57,42
26,29,26,137,77,115,-38
26,29,26,163,72,0,72
26,31,26,29,52,0,52
26,31,26,47,387,328,59
26,31,26,49,69,0,69
26,31,26,97,0,61,-61
26,31,26,99,59,0,59
26,31,26,125,76,79,-3
26,31,26,137,101,77,24
26,31,26,141,143,95,48
26,31,26,163,55,53,2
26,33,26,81,0,59,-59
26,33,26,97,153,126,27
26,35,26,17,50,0,50
26,35,26,49,86,0,86
26,35,26,51,174,212,-38
26,35,26,57,107,0,107
26,35,26,65,75,0,75
26,35,26,73,485,426,59
26,35,26,81,72,0,72
26,35,26,99,110,64,46
26,35,26,111,154,180,-26
26,35,26,125,94,53,41
26,35,26,133,57,84,-27
26,35,26,145,62,0,62
26,35,26,163,125,0,125
26,37,26,45,832,741,91
26,37,26,49,91,83,8
26,37,26,57,240,238,2
26,37,26,65,2767,2220,547
26,37,26,67,238,278,-40
26,37,26,73,55,0,55
26,37,26,75,78,61,17
26,37,26,81,187,223,-36
26,37,26,93,90,0,90
26,37,26,99,60,0,60
26,37,26,111,53,0,53
26,37,26,117,0,70,-70
26,37,26,125,188,157,31
26,37,26,145,75,60,15
26,37,26,155,530,468,62
26,37,26,163,99,104,-5
26,39,26,125,67,0,67
26,39,26,137,98,127,-29
26,39,26,143,228,224,4
26,41,26,43,64,59,5
26,41,26,103,112,143,-31
26,41,26,109,113,166,-53
26,41,26,153,93,0,93
26,41,55,9,64,81,-17
26,43,26,41,59,64,-5
26,43,26,71,71,74,-3
26,43,26,103,96,66,30
26,43,26,109,66,78,-12
26,43,55,9,0,73,-73
26,43,55,37,122,126,-4
26,43,55,75,119,135,-16
26,45,4,13,0,62,-62
26,45,17,31,0,45,-45
26,45,26,5,0,47,-47
26,45,26,15,239,259,-20
26,45,26,25,397,380,17
26,45,26,37,741,832,-91
26,45,26,49,139,97,42
26,45,26,65,5003,4432,571
26,45,26,67,313,318,-5
26,45,26,75,194,204,-10
26,45,26,77,96,120,-24
26,45,26,81,239,296,-57
26,45,26,93,151,102,49
26,45,26,99,84,46,38
26,45,26,117,60,56,4
26,45,26,125,163,181,-18
26,45,26,139,91,110,-19
26,45,26,145,70,0,70
26,45,26,155,124,146,-22
26,45,26,161,55,68,-13
26,45,26,163,140,156,-16
26,47,26,29,447,393,54
26,47,26,31,328,387,-59
26,47,26,55,90,79,11
26,47,26,81,103,89,14
26,47,26,125,163,88,75
26,47,26,137,53,71,-18
26,47,26,163,98,68,30
26,49,4,13,131,305,-174
26,49,6,37,68,80,-12
26,49,6,73,0,50,-50
26,49,12,57,63,79,-16
26,49,12,71,79,135,-56
26,49,12,81,0,58,-58
26,49,12,101,0,89,-89
26,49,12,103,76,88,-12
26,49,12,105,0,66,-66
26,49,12,115,0,63,-63
26,49,12,127,0,55,-55
26,49,17,31,102,114,-12
26,49,18,97,0,62,-62
26,49,26,1,0,62,-62
26,49,26,7,0,72,-72
26,49,26,11,0,67,-67
26,49,26,17,162,227,-65
26,49,26,21,0,56,-56
26,49,26,31,0,69,-69
26,49,26,35,0,86,-86
26,49,26,37,83,91,-8
26,49,26,45,97,139,-42
26,49,26,51,66,86,-20
26,49,26,55,86,126,-40
26,49,26,63,50,0,50
26,49,26,65,342,374,-32
26,49,26,69,88,169,-81
26,49,26,73,71,113,-42
26,49,26,75,69,83,-14
26,49,26,77,99,113,-14
26,49,26,81,264,376,-112
26,49,26,87,1417,1144,273
26,49,26,93,1559,1319,240
26,49,26,99,789,511,278
26,49,26,111,102,155,-53
26,49,26,125,4171,3115,1056
26,49,26,129,59,103,-44
26,49,26,139,69,145,-76
26,49,26,143,57,119,-62
26,49,26,145,958,986,-28
26,49,26,147,183,130,53
26,49,26,151,0,60,-60
26,49,26,155,921,904,17
26,49,26,157,485,525,-40
26,49,26,161,306,356,-50
26,49,26,163,803,805,-2
26,49,32,3,84,145,-61
26,49,39,49,59,63,-4
26,49,39,95,0,91,-91
26,49,47,37,0,60,-60
26,49,48,113,77,59,18
26,49,48,201,107,89,18
26,49,48,439,100,172,-72
26,51,26,17,140,129,11
26,51,26,35,212,174,38
26,51,26,49,86,66,20
26,51,26,73,68,81,-13
26,51,26,99,129,58,71
26,51,26,111,313,348,-35
26,51,26,125,123,79,44
26,51,26,129,0,71,-71
26,51,26,145,101,79,22
26,51,26,163,83,0,83
26,53,55,51,73,142,-69
26,55,4,13,59,0,59
26,55,17,31,111,63,48
26,55,26,9,364,271,93
26,55,26,19,508,588,-80
26,55,26,29,86,74,12
26,55,26,47,79,90,-11
26,55,26,49,126,86,40
26,55,26,65,171,66,105
26,55,26,73,55,0,55
26,55,26,77,69,73,-4
26,55,26,79,416,552,-136
26,55,26,81,291,256,35
26,55,26,89,916,740,176
26,55,26,93,71,0,71
26,55,26,99,107,77,30
26,55,26,101,118,121,-3
26,55,26,111,66,0,66
26,55,26,125,378,199,179
26,55,26,137,59,0,59
26,55,26,139,61,100,-39
26,55,26,143,0,59,-59
26,55,26,145,76,0,76
26,55,26,161,109,107,2
26,55,26,163,179,130,49
26,55,26,165,351,508,-157
26,57,26,35,0,107,-107
26,57,26,37,238,240,-2
26,57,26,65,112,114,-2
26,57,26,73,364,459,-95
26,57,26,81,49,75,-26
26,57,26,111,174,170,4
26,57,26,117,305,244,61
26,57,26,145,98,151,-53
26,59,18,151,92,0,92
26,59,26,23,317,341,-24
26,59,26,25,160,153,7
26,59,26,75,447,473,-26
26,59,26,77,0,44,-44
26,59,26,91,412,343,69
26,59,26,161,0,70,-70
26,59,26,163,117,88,29
26,59,39,95,69,0,69
26,59,39,171,72,118,-46
26,61,26,13,87,74,13
26,61,26,83,75,117,-42
26,61,26,103,111,112,-1
26,61,26,125,0,98,-98
26,61,26,161,0,47,-47
26,61,26,163,0,54,-54
26,61,27,53,0,46,-46
26,63,26,17,55,99,-44
26,63,26,49,0,50,-50
26,63,26,99,139,76,63
26,63,26,125,108,76,32
26,63,26,145,0,52,-52
26,63,26,151,122,180,-58
26,63,26,157,245,274,-29
26,63,26,163,72,0,72
26,65,4,13,120,154,-34
26,65,4,19,0,51,-51
26,65,6,37,84,132,-48
26,65,6,73,74,93,-19
26,65,6,85,0,86,-86
26,65,8,31,0,73,-73
26,65,12,57,0,63,-63
26,65,12,71,0,60,-60
26,65,12,86,53,0,53
26,65,12,103,0,61,-61
26,65,13,121,0,53,-53
26,65,17,31,248,311,-63
26,65,18,97,57,64,-7
26,65,25,17,0,58,-58
26,65,26,5,0,60,-60
26,65,26,15,73,83,-10
26,65,26,17,51,71,-20
26,65,26,21,75,62,13
26,65,26,25,198,201,-3
26,65,26,35,0,75,-75
26,65,26,37,2220,2767,-547
26,65,26,45,4432,5003,-571
26,65,26,49,374,342,32
26,65,26,55,66,171,-105
26,65,26,57,114,112,2
26,65,26,67,261,224,37
26,65,26,73,149,109,40
26,65,26,75,770,767,3
26,65,26,77,214,272,-58
26,65,26,81,624,747,-123
26,65,26,87,48,0,48
26,65,26,91,62,54,8
26,65,26,93,874,664,210
26,65,26,99,229,228,1
26,65,26,103,55,0,55
26,65,26,107,56,63,-7
26,65,26,111,65,70,-5
26,65,26,117,73,97,-24
26,65,26,121,89,83,6
26,65,26,125,777,926,-149
26,65,26,139,135,215,-80
26,65,26,145,189,99,90
26,65,26,147,64,0,64
26,65,26,155,602,696,-94
26,65,26,161,405,492,-87
26,65,26,163,773,883,-110
26,65,32,3,0,66,-66
26,65,39,35,0,51,-51
26,65,39,49,116,154,-38
26,65,39,61,0,74,-74
26,65,48,113,0,104,-104
26,65,48,201,55,102,-47
26,65,48,439,0,59,-59
26,65,48,453,0,91,-91
26,65,53,33,0,111,-111
26,65,55,79,0,52,-52
26,67,26,5,0,67,-67
26,67,26,15,205,280,-75
26,67,26,37,278,238,40
26,67,26,45,318,313,5
26,67,26,65,224,261,-37
26,67,26,81,1421,1135,286
26,67,26,117,663,677,-14
26,67,26,139,101,74,27
26,69,26,1,153,214,-61
26,69,26,11,88,133,-45
26,69,26,17,90,61,29
26,69,26,49,169,88,81
26,69,26,99,94,75,19
26,69,26,125,166,78,88
26,69,26,129,131,129,2
26,69,26,145,94,0,94
26,69,26,163,102,67,35
26,71,26,43,74,71,3
26,73,26,17,59,0,59
26,73,26,35,426,485,-59
26,73,26,37,0,55,-55
26,73,26,49,113,71,42
26,73,26,51,81,68,13
26,73,26,55,0,55,-55
26,73,26,57,459,364,95
26,73,26,65,109,149,-40
26,73,26,77,0,57,-57
26,73,26,81,140,244,-104
26,73,26,99,96,115,-19
26,73,26,107,272,238,34
26,73,26,111,349,402,-53
26,73,26,117,211,184,27
26,73,26,125,120,211,-91
26,73,26,145,99,128,-29
26,73,26,161,0,64,-64
26,73,26,163,121,207,-86
26,75,4,13,0,63,-63
26,75,17,31,56,48,8
26,75,26,23,71,61,10
26,75,26,25,539,663,-124
26,75,26,37,61,78,-17
26,75,26,45,204,194,10
26,75,26,49,83,69,14
26,75,26,59,473,447,26
26,75,26,65,767,770,-3
26,75,26,77,161,159,2
26,75,26,81,96,158,-62
26,75,26,91,546,502,44
26,75,26,93,165,158,7
26,75,26,99,88,67,21
26,75,26,115,68,83,-15
26,75,26,125,218,178,40
26,75,26,139,0,73,-73
26,75,26,161,860,618,242
26,75,26,163,643,448,195
26,75,39,95,71,0,71
26,77,4,13,100,157,-57
26,77,6,37,86,75,11
26,77,6,59,0,60,-60
26,77,6,73,57,55,2
26,77,12,71,0,52,-52
26,77,12,103,0,50,-50
26,77,13,121,0,53,-53
26,77,17,31,351,408,-57
26,77,17,43,0,58,-58
26,77,17,95,74,0,74
26,77,17,161,91,0,91
26,77,18,3,63,0,63
26,77,18,39,63,74,-11
26,77,18,97,79,93,-14
26,77,18,141,140,104,36
26,77,26,5,1161,1052,109
26,77,26,15,496,503,-7
26,77,26,21,420,326,94
26,77,26,23,82,136,-54
26,77,26,25,1336,1277,59
26,77,26,27,154,145,9
26,77,26,45,120,96,24
26,77,26,49,113,99,14
26,77,26,55,73,69,4
26,77,26,59,44,0,44
26,77,26,65,272,214,58
26,77,26,73,57,0,57
26,77,26,75,159,161,-2
26,77,26,81,872,1180,-308
26,77,26,91,53,48,5
26,77,26,93,56,62,-6
26,77,26,99,150,170,-20
26,77,26,111,55,0,55
26,77,26,121,113,124,-11
26,77,26,125,331,454,-123
26,77,26,139,250,251,-1
26,77,26,145,68,43,25
26,77,26,149,736,599,137
26,77,26,159,1630,1700,-70
26,77,26,161,208,219,-11
26,77,26,163,369,442,-73
26,77,32,3,57,65,-8
26,77,37,119,0,79,-79
26,77,39,49,0,73,-73
26,77,48,85,0,80,-80
26,77,48,113,0,51,-51
26,77,48,201,59,0,59
26,77,48,439,0,62,-62
26,77,53,33,69,49,20
26,79,26,9,253,239,14
26,79,26,55,552,416,136
26,79,26,99,58,0,58
26,81,4,13,327,417,-90
26,81,4,19,0,85,-85
26,81,6,1,0,63,-63
26,81,6,37,247,225,22
26,81,6,59,90,89,1
26,81,6,71,69,0,69
26,81,6,73,172,135,37
26,81,6,75,0,47,-47
26,81,6,85,0,52,-52
26,81,8,5,85,54,31
26,81,8,31,107,145,-38
26,81,8,41,61,83,-22
26,81,8,59,48,0,48
26,81,11,1,0,45,-45
26,81,12,11,58,75,-17
26,81,12,21,0,81,-81
26,81,12,31,0,78,-78
26,81,12,57,118,107,11
26,81,12,71,107,135,-28
26,81,12,81,73,78,-5
26,81,12,86,106,79,27
26,81,12,95,97,103,-6
26,81,12,99,94,82,12
26,81,12,101,0,74,-74
26,81,12,103,76,156,-80
26,81,12,105,0,105,-105
26,81,12,115,51,80,-29
26,81,13,67,0,110,-110
26,81,13,121,0,65,-65
26,81,15,3,0,60,-60
26,81,17,31,1036,698,338
26,81,17,43,170,127,43
26,81,17,97,79,0,79
26,81,18,3,0,78,-78
26,81,18,57,0,65,-65
26,81,18,89,67,0,67
26,81,18,97,120,149,-29
26,81,18,141,102,73,29
26,81,24,31,0,61,-61
26,81,25,17,61,0,61
26,81,26,5,1654,2017,-363
26,81,26,7,48,0,48
26,81,26,9,53,0,53
26,81,26,15,1021,1467,-446
26,81,26,17,127,82,45
26,81,26,21,339,274,65
26,81,26,25,286,178,108
26,81,26,27,42,0,42
26,81,26,29,45,81,-36
26,81,26,33,59,0,59
26,81,26,35,0,72,-72
26,81,26,37,223,187,36
26,81,26,45,296,239,57
26,81,26,47,89,103,-14
26,81,26,49,376,264,112
26,81,26,55,256,291,-35
26,81,26,57,75,49,26
26,81,26,65,747,624,123
26,81,26,67,1135,1421,-286
26,81,26,73,244,140,104
26,81,26,75,158,96,62
26,81,26,77,1180,872,308
26,81,26,85,110,125,-15
26,81,26,87,85,0,85
26,81,26,89,61,107,-46
26,81,26,91,0,61,-61
26,81,26,93,194,109,85
26,81,26,99,373,261,112
26,81,26,101,74,73,1
26,81,26,103,87,55,32
26,81,26,105,211,152,59
26,81,26,107,489,492,-3
26,81,26,111,149,79,70
26,81,26,115,55,0,55
26,81,26,117,1470,1816,-346
26,81,26,121,1235,1523,-288
26,81,26,123,902,1264,-362
26,81,26,125,931,824,107
26,81,26,127,183,162,21
26,81,26,133,100,107,-7
26,81,26,137,62,0,62
26,81,26,139,6198,7332,-1134
26,81,26,145,404,210,194
26,81,26,147,87,53,34
26,81,26,149,56,0,56
26,81,26,155,60,0,60
26,81,26,159,165,126,39
26,81,26,161,456,335,121
26,81,26,163,763,697,66
26,81,26,165,130,120,10
26,81,27,53,117,121,-4
26,81,29,189,74,0,74
26,81,32,3,114,173,-59
26,81,36,47,60,67,-7
26,81,36,61,61,60,1
26,81,36,81,70,0,70
26,81,37,119,86,112,-26
26,81,37,183,0,85,-85
26,81,39,35,75,94,-19
26,81,39,49,146,153,-7
26,81,39,61,65,84,-19
26,81,39,95,63,0,63
26,81,41,51,74,91,-17
26,81,42,3,80,54,26
26,81,45,45,0,50,-50
26,81,47,37,72,120,-48
26,81,48,29,83,67,16
26,81,48,113,91,118,-27
26,81,48,201,137,144,-7
26,81,48,439,94,94,0
26,81,48,453,86,105,-19
26,81,49,35,0,54,-54
26,81,53,33,114,158,-44
26,81,55,25,0,67,-67
26,81,55,79,83,72,11
26,83,26,61,117,75,42
26,85,26,81,125,110,15
26,85,26,105,60,114,-54
26,85,26,107,94,67,27
26,85,26,133,170,161,9
26,85,26,165,0,57,-57
26,87,26,49,1144,1417,-273
26,87,26,65,0,48,-48
26,87,26,81,0,85,-85
26,87,26,99,1257,746,511
26,87,26,125,1371,1046,325
26,87,26,145,66,58,8
26,87,26,147,378,315,63
26,87,26,151,178,252,-74
26,87,26,157,246,350,-104
26,87,26,163,138,119,19
26,89,26,19,79,108,-29
26,89,26,55,740,916,-176
26,89,26,81,107,61,46
26,89,26,125,127,62,65
26,91,26,59,343,412,-69
26,91,26,65,54,62,-8
26,91,26,75,502,546,-44
26,91,26,77,48,53,-5
26,91,26,81,61,0,61
26,91,26,93,91,80,11
26,91,26,115,428,441,-13
26,91,26,125,140,105,35
26,91,26,161,800,610,190
26,91,26,163,588,380,208
26,91,39,51,113,150,-37
26,91,39,95,251,295,-44
26,91,39,173,50,0,50
26,93,4,13,79,106,-27
26,93,12,71,0,74,-74
26,93,12,115,0,65,-65
26,93,17,31,92,70,22
26,93,26,37,0,90,-90
26,93,26,45,102,151,-49
26,93,26,49,1319,1559,-240
26,93,26,55,0,71,-71
26,93,26,65,664,874,-210
26,93,26,75,158,165,-7
26,93,26,77,62,56,6
26,93,26,81,109,194,-85
26,93,26,91,80,91,-11
26,93,26,99,362,257,105
26,93,26,115,90,72,18
26,93,26,125,3445,2596,849
26,93,26,139,0,92,-92
26,93,26,143,0,63,-63
26,93,26,145,70,55,15
26,93,26,155,211,405,-194
26,93,26,161,1870,1429,441
26,93,26,163,2317,1275,1042
26,93,39,95,0,54,-54
26,97,26,31,61,0,61
26,97,26,33,126,153,-27
26,99,4,13,295,568,-273
26,99,4,19,71,76,-5
26,99,6,37,159,176,-17
26,99,6,59,70,87,-17
26,99,6,73,364,250,114
26,99,6,85,0,77,-77
26,99,8,31,0,49,-49
26,99,8,41,0,55,-55
26,99,12,9,0,57,-57
26,99,12,11,88,93,-5
26,99,12,15,0,94,-94
26,99,12,21,81,108,-27
26,99,12,31,53,91,-38
26,99,12,57,75,112,-37
26,99,12,71,125,298,-173
26,99,12,81,0,88,-88
26,99,12,95,61,72,-11
26,99,12,99,56,99,-43
26,99,12,101,49,140,-91
26,99,12,103,81,172,-91
26,99,12,105,0,101,-101
26,99,12,115,0,73,-73
26,99,12,119,0,64,-64
26,99,12,127,0,60,-60
26,99,13,121,0,74,-74
26,99,13,135,0,74,-74
26,99,15,3,72,65,7
26,99,17,31,388,299,89
26,99,17,43,71,69,2
26,99,18,97,49,64,-15
26,99,21,111,0,71,-71
26,99,25,17,0,56,-56
26,99,26,17,85,70,15
26,99,26,21,0,59,-59
26,99,26,31,0,59,-59
26,99,26,35,64,110,-46
26,99,26,37,0,60,-60
26,99,26,45,46,84,-38
26,99,26,49,511,789,-278
26,99,26,51,58,129,-71
26,99,26,55,77,107,-30
26,99,26,63,76,139,-63
26,99,26,65,228,229,-1
26,99,26,69,75,94,-19
26,99,26,73,115,96,19
26,99,26,75,67,88,-21
26,99,26,77,170,150,20
26,99,26,79,0,58,-58
26,99,26,81,261,373,-112
26,99,26,87,746,1257,-511
26,99,26,93,257,362,-105
26,99,26,107,0,62,-62
26,99,26,111,68,81,-13
26,99,26,115,112,193,-81
26,99,26,119,0,63,-63
26,99,26,121,49,0,49
26,99,26,125,15536,14579,957
26,99,26,129,0,80,-80
26,99,26,137,0,56,-56
26,99,26,139,78,123,-45
26,99,26,143,102,142,-40
26,99,26,145,204,144,60
26,99,26,147,2656,3656,-1000
26,99,26,151,203,333,-130
26,99,26,157,0,115,-115
26,99,26,161,468,457,11
26,99,26,163,15739,12169,3570
26,99,27,53,0,67,-67
26,99,32,3,174,222,-48
26,99,36,47,0,53,-53
26,99,36,61,0,66,-66
26,99,36,81,136,0,136
26,99,37,119,0,71,-71
26,99,37,133,0,67,-67
26,99,39,35,93,83,10
26,99,39,49,90,103,-13
26,99,39,95,132,154,-22
26,99,47,37,0,70,-70
26,99,47,93,0,65,-65
26,99,48,29,62,0,62
26,99,48,85,0,97,-97
26,99,48,113,54,79,-25
26,99,48,121,0,72,-72
26,99,48,201,128,175,-47
26,99,48,439,93,105,-12
26,99,48,453,81,107,-26
26,99,51,59,0,54,-54
26,99,53,33,79,75,4
26,101,26,19,191,143,48
26,101,26,55,121,118,3
26,101,26,81,73,74,-1
26,101,26,105,170,150,20
26,101,26,163,57,0,57
26,101,26,165,97,64,33
26,103,4,13,0,66,-66
26,103,26,3,101,131,-30
26,103,26,13,65,57,8
26,103,26,41,143,112,31
26,103,26,43,66,96,-30
26,103,26,61,112,111,1
26,103,26,65,0,55,-55
26,103,26,81,55,87,-32
26,103,26,125,84,83,1
26,103,26,163,74,56,18
26,103,55,9,0,49,-49
26,105,26,81,152,211,-59
26,105,26,85,114,60,54
26,105,26,101,150,170,-20
26,105,26,121,93,119,-26
26,105,26,127,150,145,5
26,105,26,139,71,95,-24
26,107,26,65,63,56,7
26,107,26,73,238,272,-34
26,107,26,81,492,489,3
26,107,26,85,67,94,-27
26,107,26,99,62,0,62
26,107,26,117,330,223,107
26,107,26,121,64,48,16
26,107,26,123,226,214,12
26,107,26,125,104,83,21
26,107,26,133,355,300,55
26,107,26,139,89,97,-8
26,107,26,163,88,78,10
26,109,26,41,166,113,53
26,109,26,43,78,66,12
26,109,55,9,91,92,-1
26,109,55,75,376,479,-103
26,111,4,13,0,59,-59
26,111,17,31,56,0,56
26,111,26,11,55,0,55
26,111,26,17,899,839,60
26,111,26,35,180,154,26
26,111,26,37,0,53,-53
26,111,26,49,155,102,53
26,111,26,51,348,313,35
26,111,26,55,0,66,-66
26,111,26,57,170,174,-4
26,111,26,65,70,65,5
26,111,26,73,402,349,53
26,111,26,77,0,55,-55
26,111,26,81,79,149,-70
26,111,26,99,81,68,13
26,111,26,125,181,152,29
26,111,26,139,0,68,-68
26,111,26,145,786,648,138
26,111,26,161,63,70,-7
26,111,26,163,103,108,-5
26,113,26,133,111,90,21
26,113,26,165,351,450,-99
26,115,26,75,83,68,15
26,115,26,81,0,55,-55
26,115,26,91,441,428,13
26,115,26,93,72,90,-18
26,115,26,99,193,112,81
26,115,26,125,255,290,-35
26,115,26,161,816,654,162
26,115,26,163,3270,2158,1112
26,115,39,95,1992,1839,153
26,115,39,173,130,194,-64
26,117,26,37,70,0,70
26,117,26,45,56,60,-4
26,117,26,57,244,305,-61
26,117,26,65,97,73,24
26,117,26,67,677,663,14
26,117,26,73,184,211,-27
26,117,26,81,1816,1470,346
26,117,26,107,223,330,-107
26,117,26,123,237,228,9
26,117,26,125,62,0,62
26,117,26,139,131,96,35
26,119,26,7,84,87,-3
26,119,26,99,63,0,63
26,119,26,125,73,0,73
26,119,26,135,81,56,25
26,119,26,137,94,149,-55
26,119,26,163,57,0,57
26,121,4,13,70,0,70
26,121,17,31,129,83,46
26,121,26,5,138,110,28
26,121,26,65,83,89,-6
26,121,26,77,124,113,11
26,121,26,81,1523,1235,288
26,121,26,99,0,49,-49
26,121,26,105,119,93,26
26,121,26,107,48,64,-16
26,121,26,123,571,554,17
26,121,26,125,102,76,26
26,121,26,127,527,606,-79
26,121,26,139,2541,2038,503
26,121,26,163,78,81,-3
26,123,26,5,62,0,62
26,123,26,81,1264,902,362
26,123,26,107,214,226,-12
26,123,26,117,228,237,-9
26,123,26,121,554,571,-17
26,123,26,127,218,280,-62
26,123,26,139,257,220,37
26,125,1,73,0,92,-92
26,125,1,89,61,0,61
26,125,4,13,565,902,-337
26,125,4,19,92,204,-112
26,125,4,21,62,94,-32
26,125,6,1,135,192,-57
26,125,6,13,84,82,2
26,125,6,37,627,756,-129
26,125,6,59,256,304,-48
26,125,6,65,108,116,-8
26,125,6,67,57,84,-27
26,125,6,71,83,51,32
26,125,6,73,369,388,-19
26,125,6,75,114,146,-32
26,125,6,81,56,64,-8
26,125,6,85,254,448,-194
26,125,6,111,69,0,69
26,125,8,1,0,49,-49
26,125,8,5,70,52,18
26,125,8,13,0,77,-77
26,125,8,31,151,151,0
26,125,8,35,0,66,-66
26,125,8,41,136,104,32
26,125,8,59,55,104,-49
26,125,9,1,77,66,11
26,125,9,3,84,0,84
26,125,9,9,58,0,58
26,125,11,1,99,149,-50
26,125,12,9,71,116,-45
26,125,12,11,229,278,-49
26,125,12,15,58,118,-60
26,125,12,21,130,293,-163
26,125,12,31,67,149,-82
26,125,12,57,172,271,-99
26,125,12,69,53,94,-41
26,125,12,71,194,380,-186
26,125,12,81,80,163,-83
26,125,12,83,0,62,-62
26,125,12,86,90,150,-60
26,125,12,95,189,333,-144
26,125,12,99,227,301,-74
26,125,12,101,101,130,-29
26,125,12,103,150,232,-82
26,125,12,105,77,136,-59
26,125,12,115,106,244,-138
26,125,12,117,0,91,-91
26,125,12,119,54,92,-38
26,125,12,127,72,64,8
26,125,13,67,125,115,10
26,125,13,89,118,113,5
26,125,13,113,91,0,91
26,125,13,121,183,283,-100
26,125,13,135,67,123,-56
26,125,15,3,58,62,-4
26,125,17,31,1455,1240,215
26,125,17,43,228,226,2
26,125,17,89,78,65,13
26,125,17,97,145,108,37
26,125,17,143,184,0,184
26,125,17,197,90,0,90
26,125,17,201,62,0,62
26,125,18,3,74,126,-52
26,125,18,5,76,69,7
26,125,18,57,129,150,-21
26,125,18,97,170,115,55
26,125,18,141,60,77,-17
26,125,18,157,56,0,56
26,125,20,91,0,63,-63
26,125,21,67,0,59,-59
26,125,21,111,119,173,-54
26,125,22,71,0,63,-63
26,125,24,31,108,116,-8
26,125,24,510,82,59,23
26,125,25,17,140,165,-25
26,125,25,21,0,78,-78
26,125,25,25,96,106,-10
26,125,26,1,49,85,-36
26,125,26,5,44,81,-37
26,125,26,7,0,74,-74
26,125,26,9,96,99,-3
26,125,26,15,0,51,-51
26,125,26,17,168,110,58
26,125,26,21,103,100,3
26,125,26,25,167,135,32
26,125,26,29,57,99,-42
26,125,26,31,79,76,3
26,125,26,35,53,94,-41
26,125,26,37,157,188,-31
26,125,26,39,0,67,-67
26,125,26,45,181,163,18
26,125,26,47,88,163,-75
26,125,26,49,3115,4171,-1056
26,125,26,51,79,123,-44
26,125,26,55,199,378,-179
26,125,26,61,98,0,98
26,125,26,63,76,108,-32
26,125,26,65,926,777,149
26,125,26,69,78,166,-88
26,125,26,73,211,120,91
26,125,26,75,178,218,-40
26,125,26,77,454,331,123
26,125,26,81,824,931,-107
26,125,26,87,1046,1371,-325
26,125,26,89,62,127,-65
26,125,26,91,105,140,-35
26,125,26,93,2596,3445,-849
26,125,26,99,14579,15536,-957
26,125,26,103,83,84,-1
26,125,26,107,83,104,-21
26,125,26,111,152,181,-29
26,125,26,115,290,255,35
26,125,26,117,0,62,-62
26,125,26,119,0,73,-73
26,125,26,121,76,102,-26
26,125,26,129,0,98,-98
26,125,26,137,96,88,8
26,125,26,139,234,290,-56
26,125,26,143,74,165,-91
26,125,26,145,450,320,130
26,125,26,147,569,572,-3
26,125,26,151,130,116,14
26,125,26,155,142,166,-24
26,125,26,157,133,140,-7
26,125,26,161,2491,2456,35
26,125,26,163,23357,19945,3412
26,125,26,165,0,76,-76
26,125,27,53,123,181,-58
26,125,29,95,0,80,-80
26,125,29,189,129,106,23
26,125,32,3,236,265,-29
26,125,34,3,101,0,101
26,125,34,17,76,75,1
26,125,34,23,126,96,30
26,125,36,5,64,0,64
26,125,36,29,85,66,19
26,125,36,47,214,169,45
26,125,36,55,60,54,6
26,125,36,59,63,0,63
26,125,36,61,272,334,-62
26,125,36,81,146,90,56
26,125,37,63,0,57,-57
26,125,37,81,59,76,-17
26,125,37,97,0,65,-65
26,125,37,119,181,341,-160
26,125,37,133,0,54,-54
26,125,37,183,128,193,-65
26,125,39,17,66,62,4
26,125,39,35,266,213,53
26,125,39,49,360,368,-8
26,125,39,61,126,108,18
26,125,39,95,263,224,39
26,125,39,113,100,93,7
26,125,39,153,103,99,4
26,125,39,165,0,101,-101
26,125,39,173,103,73,30
26,125,41,5,0,58,-58
26,125,41,51,68,125,-57
26,125,41,67,64,76,-12
26,125,42,3,174,131,43
26,125,42,91,59,67,-8
26,125,42,101,96,66,30
26,125,45,19,56,91,-35
26,125,45,45,117,141,-24
26,125,45,51,0,80,-80
26,125,45,91,0,63,-63
26,125,47,37,121,212,-91
26,125,47,65,0,57,-57
26,125,47,93,0,66,-66
26,125,47,157,71,91,-20
26,125,47,187,0,118,-118
26,125,48,29,144,169,-25
26,125,48,85,174,345,-171
26,125,48,113,248,242,6
26,125,48,121,118,159,-41
26,125,48,141,110,0,110
26,125,48,157,64,69,-5
26,125,48,201,356,314,42
26,125,48,439,220,241,-21
26,125,48,453,163,197,-34
26,125,49,35,89,81,8
26,125,51,13,69,56,13
26,125,51,59,132,137,-5
26,125,51,810,0,75,-75
26,125,53,33,261,418,-157
26,125,53,53,62,0,62
26,125,55,25,90,75,15
26,125,55,79,117,104,13
26,125,55,133,72,0,72
26,127,26,81,162,183,-21
26,127,26,105,145,150,-5
26,127,26,121,606,527,79
26,127,26,123,280,218,62
26,127,26,139,95,107,-12
26,129,26,11,155,97,58
26,129,26,17,69,65,4
26,129,26,49,103,59,44
26,129,26,51,71,0,71
26,129,26,69,129,131,-2
26,129,26,99,80,0,80
26,129,26,125,98,0,98
26,129,26,143,80,94,-14
26,129,26,145,72,0,72
26,129,26,163,109,0,109
26,133,26,35,84,57,27
26,133,26,81,107,100,7
26,133,26,85,161,170,-9
26,133,26,107,300,355,-55
26,133,26,113,90,111,-21
26,133,26,165,210,266,-56
26,135,26,119,56,81,-25
26,137,26,9,136,128,8
26,137,26,29,115,77,38
26,137,26,31,77,101,-24
26,137,26,39,127,98,29
26,137,26,47,71,53,18
26,137,26,55,0,59,-59
26,137,26,81,0,62,-62
26,137,26,99,56,0,56
26,137,26,119,149,94,55
26,137,26,125,88,96,-8
26,137,26,163,110,0,110
26,139,4,13,113,132,-19
26,139,6,37,69,90,-21
26,139,6,73,63,0,63
26,139,12,71,0,104,-104
26,139,17,31,321,185,136
26,139,17,43,105,0,105
26,139,26,5,2613,2834,-221
26,139,26,15,162,171,-9
26,139,26,21,115,81,34
26,139,26,25,85,0,85
26,139,26,45,110,91,19
26,139,26,49,145,69,76
26,139,26,55,100,61,39
26,139,26,65,215,135,80
26,139,26,67,74,101,-27
26,139,26,75,73,0,73
26,139,26,77,251,250,1
26,139,26,81,7332,6198,1134
26,139,26,93,92,0,92
26,139,26,99,123,78,45
26,139,26,105,95,71,24
26,139,26,107,97,89,8
26,139,26,111,68,0,68
26,139,26,117,96,131,-35
26,139,26,121,2038,2541,-503
26,139,26,123,220,257,-37
26,139,26,125,290,234,56
26,139,26,127,107,95,12
26,139,26,145,71,0,71
26,139,26,159,151,170,-19
26,139,26,161,123,51,72
26,139,26,163,259,260,-1
26,139,48,201,65,0,65
26,141,26,7,163,124,39
26,141,26,31,95,143,-48
26,143,26,39,224,228,-4
26,143,26,49,119,57,62
26,143,26,55,59,0,59
26,143,26,93,63,0,63
26,143,26,99,142,102,40
26,143,26,125,165,74,91
26,143,26,129,94,80,14
26,143,26,145,77,0,77
26,143,26,163,148,80,68
26,145,4,13,0,93,-93
26,145,17,31,57,62,-5
26,145,26,11,73,100,-27
26,145,26,17,1249,1217,32
26,145,26,35,0,62,-62
26,145,26,37,60,75,-15
26,145,26,45,0,70,-70
26,145,26,49,986,958,28
26,145,26,51,79,101,-22
26,145,26,55,0,76,-76
26,145,26,57,151,98,53
26,145,26,63,52,0,52
26,145,26,65,99,189,-90
26,145,26,69,0,94,-94
26,145,26,73,128,99,29
26,145,26,77,43,68,-25
26,145,26,81,210,404,-194
26,145,26,87,58,66,-8
26,145,26,93,55,70,-15
26,145,26,99,144,204,-60
26,145,26,111,648,786,-138
26,145,26,125,320,450,-130
26,145,26,129,0,72,-72
26,145,26,139,0,71,-71
26,145,26,143,0,77,-77
26,145,26,155,254,281,-27
26,145,26,157,495,374,121
26,145,26,161,73,81,-8
26,145,26,163,251,271,-20
26,145,39,49,0,66,-66
26,147,4,13,60,71,-11
26,147,12,71,59,85,-26
26,147,17,31,0,41,-41
26,147,26,49,130,183,-53
26,147,26,65,0,64,-64
26,147,26,81,53,87,-34
26,147,26,87,315,378,-63
26,147,26,99,3656,2656,1000
26,147,26,125,572,569,3
26,147,26,151,582,689,-107
26,147,26,161,58,68,-10
26,147,26,163,451,409,42
26,149,17,31,81,52,29
26,149,18,39,409,329,80
26,149,18,87,241,210,31
26,149,18,141,105,64,41
26,149,26,23,323,285,38
26,149,26,25,109,101,8
26,149,26,27,334,405,-71
26,149,26,77,599,736,-137
26,149,26,81,0,56,-56
26,149,26,159,80,64,16
26,151,26,49,60,0,60
26,151,26,63,180,122,58
26,151,26,87,252,178,74
26,151,26,99,333,203,130
26,151,26,125,116,130,-14
26,151,26,147,689,582,107
26,151,26,157,218,245,-27
26,151,26,163,103,76,27
26,153,26,41,0,93,-93
26,155,26,37,468,530,-62
26,155,26,45,146,124,22
26,155,26,49,904,921,-17
26,155,26,65,696,602,94
26,155,26,81,0,60,-60
26,155,26,93,405,211,194
26,155,26,125,166,142,24
26,155,26,145,281,254,27
26,155,26,163,81,80,1
26,157,26,17,199,279,-80
26,157,26,49,525,485,40
26,157,26,63,274,245,29
26,157,26,87,350,246,104
26,157,26,99,115,0,115
26,157,26,125,140,133,7
26,157,26,145,374,495,-121
26,157,26,151,245,218,27
26,157,26,163,67,0,67
26,159,12,57,106,0,106
26,159,17,31,140,122,18
26,159,18,141,71,86,-15
26,159,26,5,680,626,54
26,159,26,15,62,0,62
26,159,26,21,645,755,-110
26,159,26,25,89,78,11
26,159,26,27,260,366,-106
26,159,26,77,1700,1630,70
26,159,26,81,126,165,-39
26,159,26,139,170,151,19
26,159,26,149,64,80,-16
26,159,26,163,72,0,72
26,161,4,13,165,260,-95
26,161,4,19,50,72,-22
26,161,6,1,133,178,-45
26,161,6,13,52,0,52
26,161,6,37,306,357,-51
26,161,6,59,87,117,-30
26,161,6,67,0,59,-59
26,161,6,73,166,184,-18
26,161,6,75,115,221,-106
26,161,6,81,61,124,-63
26,161,6,85,152,412,-260
26,161,8,13,0,60,-60
26,161,8,31,67,151,-84
26,161,8,41,0,56,-56
26,161,9,9,55,60,-5
26,161,11,1,205,140,65
26,161,12,11,73,60,13
26,161,12,57,0,58,-58
26,161,12,71,0,99,-99
26,161,12,86,73,84,-11
26,161,12,95,53,82,-29
26,161,12,99,69,0,69
26,161,12,103,0,66,-66
26,161,13,89,61,65,-4
26,161,13,121,93,102,-9
26,161,17,31,800,749,51
26,161,17,43,90,72,18
26,161,18,97,63,73,-10
26,161,18,157,59,0,59
26,161,21,111,52,0,52
26,161,22,71,55,0,55
26,161,24,31,93,100,-7
26,161,24,510,48,55,-7
26,161,25,17,181,234,-53
26,161,25,21,51,66,-15
26,161,25,25,145,114,31
26,161,26,21,80,63,17
26,161,26,25,76,71,5
26,161,26,45,68,55,13
26,161,26,49,356,306,50
26,161,26,55,107,109,-2
26,161,26,59,70,0,70
26,161,26,61,47,0,47
26,161,26,65,492,405,87
26,161,26,73,64,0,64
26,161,26,75,618,860,-242
26,161,26,77,219,208,11
26,161,26,81,335,456,-121
26,161,26,91,610,800,-190
26,161,26,93,1429,1870,-441
26,161,26,99,457,468,-11
26,161,26,111,70,63,7
26,161,26,115,654,816,-162
26,161,26,125,2456,2491,-35
26,161,26,139,51,123,-72
26,161,26,145,81,73,8
26,161,26,147,68,58,10
26,161,26,163,6339,7133,-794
26,161,27,53,104,127,-23
26,161,29,189,90,0,90
26,161,29,510,0,43,-43
26,161,32,3,81,122,-41
26,161,34,17,63,55,8
26,161,34,23,53,0,53
26,161,36,29,49,0,49
26,161,36,47,126,140,-14
26,161,36,61,225,309,-84
26,161,36,81,68,74,-6
26,161,37,63,48,0,48
26,161,37,119,59,56,3
26,161,37,183,72,105,-33
26,161,39,35,150,158,-8
26,161,39,49,194,218,-24
26,161,39,61,80,108,-28
26,161,39,95,277,238,39
26,161,39,173,71,0,71
26,161,41,51,74,137,-63
26,161,41,67,0,53,-53
26,161,42,3,111,126,-15
26,161,42,101,108,107,1
26,161,47,37,69,62,7
26,161,48,85,73,98,-25
26,161,48,113,87,95,-8
26,161,48,201,97,147,-50
26,161,48,439,60,69,-9
26,161,48,453,120,146,-26
26,161,49,35,0,55,-55
26,161,51,13,0,56,-56
26,161,51,59,67,86,-19
26,161,53,33,191,474,-283
26,161,55,25,137,122,15
26,161,55,79,76,73,3
26,163,1,73,75,108,-33
26,163,1,89,0,68,-68
26,163,4,13,690,918,-228
26,163,4,19,114,107,7
26,163,4,21,0,88,-88
26,163,6,1,119,157,-38
26,163,6,13,63,67,-4
26,163,6,37,469,463,6
26,163,6,59,193,231,-38
26,163,6,65,139,155,-16
26,163,6,67,0,64,-64
26,163,6,71,71,105,-34
26,163,6,73,368,325,43
26,163,6,75,124,88,36
26,163,6,85,99,202,-103
26,163,8,5,0,78,-78
26,163,8,31,73,123,-50
26,163,8,41,115,96,19
26,163,8,59,0,55,-55
26,163,9,3,58,0,58
26,163,11,1,135,125,10
26,163,12,9,101,86,15
26,163,12,11,188,226,-38
26,163,12,15,0,82,-82
26,163,12,21,99,119,-20
26,163,12,31,152,133,19
26,163,12,53,0,62,-62
26,163,12,57,167,298,-131
26,163,12,69,0,114,-114
26,163,12,71,134,271,-137
26,163,12,81,64,107,-43
26,163,12,83,0,97,-97
26,163,12,86,166,92,74
26,163,12,95,139,200,-61
26,163,12,97,0,72,-72
26,163,12,99,117,214,-97
26,163,12,101,68,169,-101
26,163,12,103,190,250,-60
26,163,12,105,100,138,-38
26,163,12,111,0,56,-56
26,163,12,115,55,160,-105
26,163,12,117,0,63,-63
26,163,12,119,0,69,-69
26,163,12,127,59,133,-74
26,163,13,63,95,116,-21
26,163,13,67,142,214,-72
26,163,13,89,184,218,-34
26,163,13,121,190,336,-146
26,163,13,135,149,175,-26
26,163,13,151,0,68,-68
26,163,15,3,78,67,11
26,163,17,31,973,919,54
26,163,17,43,160,117,43
26,163,17,97,103,63,40
26,163,17,197,88,66,22
26,163,18,3,101,110,-9
26,163,18,57,0,67,-67
26,163,18,89,71,61,10
26,163,18,97,161,159,2
26,163,18,141,68,0,68
26,163,21,67,82,78,4
26,163,21,111,210,199,11
26,163,24,5,67,0,67
26,163,24,31,75,63,12
26,163,24,33,64,95,-31
26,163,24,510,59,67,-8
26,163,25,17,115,104,11
26,163,25,25,63,96,-33
26,163,26,1,0,65,-65
26,163,26,5,54,0,54
26,163,26,9,0,63,-63
26,163,26,17,83,90,-7
26,163,26,21,94,64,30
26,163,26,23,82,85,-3
26,163,26,25,164,171,-7
26,163,26,29,0,72,-72
26,163,26,31,53,55,-2
26,163,26,35,0,125,-125
26,163,26,37,104,99,5
26,163,26,45,156,140,16
26,163,26,47,68,98,-30
26,163,26,49,805,803,2
26,163,26,51,0,83,-83
26,163,26,55,130,179,-49
26,163,26,59,88,117,-29
26,163,26,61,54,0,54
26,163,26,63,0,72,-72
26,163,26,65,883,773,110
26,163,26,69,67,102,-35
26,163,26,73,207,121,86
26,163,26,75,448,643,-195
26,163,26,77,442,369,73
26,163,26,81,697,763,-66
26,163,26,87,119,138,-19
26,163,26,91,380,588,-208
26,163,26,93,1275,2317,-1042
26,163,26,99,12169,15739,-3570
26,163,26,101,0,57,-57
26,163,26,103,56,74,-18
26,163,26,107,78,88,-10
26,163,26,111,108,103,5
26,163,26,115,2158,3270,-1112
26,163,26,119,0,57,-57
26,163,26,121,81,78,3
26,163,26,125,19945,23357,-3412
26,163,26,129,0,109,-109
26,163,26,137,0,110,-110
26,163,26,139,260,259,1
26,163,26,143,80,148,-68
26,163,26,145,271,251,20
26,163,26,147,409,451,-42
26,163,26,151,76,103,-27
26,163,26,155,80,81,-1
26,163,26,157,0,67,-67
26,163,26,159,0,72,-72
26,163,26,161,7133,6339,794
26,163,27,37,0,76,-76
26,163,27,53,150,113,37
26,163,29,95,51,63,-12
26,163,29,189,75,91,-16
26,163,29,510,0,57,-57
26,163,32,3,365,517,-152
26,163,34,17,67,0,67
26,163,34,23,76,0,76
26,163,35,1,0,56,-56
26,163,36,5,225,78,147
26,163,36,29,107,88,19
26,163,36,47,457,177,280
26,163,36,61,459,181,278
26,163,36,81,325,125,200
26,163,37,51,0,90,-90
26,163,37,119,128,176,-48
26,163,37,133,102,68,34
26,163,37,183,83,135,-52
26,163,39,35,276,284,-8
26,163,39,43,0,61,-61
26,163,39,49,323,328,-5
26,163,39,57,70,64,6
26,163,39,61,144,142,2
26,163,39,63,0,58,-58
26,163,39,95,592,759,-167
26,163,39,113,146,145,1
26,163,39,153,101,78,23
26,163,39,173,124,99,25
26,163,41,51,70,67,3
26,163,41,67,0,57,-57
26,163,42,3,162,126,36
26,163,42,101,111,60,51
26,163,45,19,0,71,-71
26,163,45,45,83,106,-23
26,163,45,51,0,58,-58
26,163,47,37,154,181,-27
26,163,47,65,0,62,-62
26,163,47,93,59,54,5
26,163,47,125,0,66,-66
26,163,47,149,0,85,-85
26,163,47,157,132,142,-10
26,163,47,187,0,70,-70
26,163,48,27,0,82,-82
26,163,48,29,188,160,28
26,163,48,85,107,186,-79
26,163,48,113,196,282,-86
26,163,48,121,66,134,-68
26,163,48,141,0,48,-48
26,163,48,201,368,387,-19
26,163,48,439,215,250,-35
26,163,48,453,400,220,180
26,163,48,491,0,57,-57
26,163,49,35,0,77,-77
26,163,51,59,141,109,32
26,163,51,710,0,77,-77
26,163,51,810,0,48,-48
26,163,53,33,193,275,-82
26,163,55,25,44,84,-40
26,163,55,79,158,110,48
26,165,26,55,508,351,157
26,165,26,81,120,130,-10
26,165,26,85,57,0,57
26,165,26,101,64,97,-33
26,165,26,113,450,351,99
26,165,26,125,76,0,76
26,165,26,133,266,210,56
27,1,27,3,82,54,28
27,1,27,35,196,229,-33
27,1,27,37,51,0,51
27,1,27,53,124,81,43
27,1,27,61,100,70,30
27,1,27,95,88,0,88
27,1,27,123,55,0,55
27,1,27,137,0,55,-55
27,3,4,13,218,265,-47
27,3,6,37,111,47,64
27,3,6,73,85,79,6
27,3,12,71,0,95,-95
27,3,17,31,134,134,0
27,3,19,153,87,0,87
27,3,27,1,54,82,-28
27,3,27,7,49,0,49
27,3,27,9,126,99,27
27,3,27,13,117,72,45
27,3,27,19,133,139,-6
27,3,27,21,0,99,-99
27,3,27,25,605,853,-248
27,3,27,27,55,0,55
27,3,27,35,105,215,-110
27,3,27,37,982,922,60
27,3,27,41,0,54,-54
27,3,27,49,0,68,-68
27,3,27,53,12152,9325,2827
27,3,27,59,818,1298,-480
27,3,27,61,77,90,-13
27,3,27,65,55,144,-89
27,3,27,85,0,64,-64
27,3,27,95,142,245,-103
27,3,27,97,0,73,-73
27,3,27,109,107,102,5
27,3,27,111,0,64,-64
27,3,27,115,103,228,-125
27,3,27,123,6308,4421,1887
27,3,27,131,0,67,-67
27,3,27,137,266,230,36
27,3,27,139,236,239,-3
27,3,27,141,1144,1679,-535
27,3,27,145,258,298,-40
27,3,27,163,1596,1646,-50
27,3,27,171,614,830,-216
27,3,32,3,59,96,-37
27,3,38,15,61,0,61
27,3,38,17,147,81,66
27,3,38,35,51,0,51
27,3,48,201,0,67,-67
27,3,53,33,0,58,-58
27,3,55,13,0,62,-62
27,3,55,25,62,65,-3
27,3,55,93,0,53,-53
27,3,55,95,72,111,-39
27,3,55,109,121,174,-53
27,5,4,13,0,59,-59
27,5,27,27,298,216,82
27,5,27,53,81,55,26
27,5,27,57,132,117,15
27,5,27,87,125,83,42
27,5,27,111,315,418,-103
27,5,38,17,372,287,85
27,7,27,3,0,49,-49
27,7,27,21,249,214,35
27,7,27,29,210,172,38
27,7,27,35,54,74,-20
27,7,27,53,128,143,-15
27,7,27,57,256,334,-78
27,7,27,61,61,79,-18
27,7,27,119,92,60,32
27,7,27,123,0,71,-71
27,7,27,137,88,104,-16
27,7,38,17,0,72,-72
27,7,38,35,66,50,16
27,9,27,3,99,126,-27
27,9,27,35,63,89,-26
27,9,27,53,192,291,-99
27,9,27,95,203,233,-30
27,9,27,97,232,336,-104
27,9,27,123,78,63,15
27,9,27,141,415,458,-43
27,9,27,145,2361,2220,141
27,9,27,171,137,130,7
27,13,4,13,0,62,-62
27,13,27,3,72,117,-45
27,13,27,15,163,121,42
27,13,27,19,50,69,-19
27,13,27,37,125,227,-102
27,13,27,43,159,92,67
27,13,27,53,296,580,-284
27,13,27,79,291,284,7
27,13,27,91,138,59,79
27,13,27,103,1243,1312,-69
27,13,27,109,89,115,-26
27,13,27,123,139,254,-115
27,13,27,131,77,0,77
27,13,27,137,0,66,-66
27,13,27,139,122,134,-12
27,13,27,147,87,78,9
27,13,27,161,239,225,14
27,13,27,163,0,78,-78
27,13,27,165,124,80,44
27,15,27,13,121,163,-42
27,15,27,53,0,84,-84
27,15,27,103,183,173,10
27,15,27,127,99,75,24
27,15,27,165,63,0,63
27,17,27,37,48,0,48
27,17,27,53,62,75,-13
27,17,27,115,139,180,-41
27,17,27,137,1094,797,297
27,17,55,31,134,123,11
27,19,4,13,76,106,-30
27,19,17,31,84,0,84
27,19,27,3,139,133,6
27,19,27,13,69,50,19
27,19,27,37,416,399,17
27,19,27,53,4589,3029,1560
27,19,27,79,0,69,-69
27,19,27,85,255,305,-50
27,19,27,123,293,214,79
27,19,27,137,74,0,74
27,19,27,139,911,805,106
27,19,27,141,0,76,-76
27,19,27,143,74,109,-35
27,19,27,145,77,60,17
27,19,27,163,88,91,-3
27,19,27,171,332,385,-53
27,21,27,3,99,0,99
27,21,27,7,214,249,-35
27,21,27,35,759,634,125
27,21,27,37,79,0,79
27,21,27,53,212,130,82
27,21,27,57,125,175,-50
27,21,27,61,104,75,29
27,21,27,97,74,0,74
27,21,27,123,65,53,12
27,21,27,137,0,73,-73
27,21,27,145,68,0,68
27,21,27,171,68,0,68
27,23,27,67,140,131,9
27,23,27,73,0,62,-62
27,23,27,151,76,0,76
27,23,27,173,151,132,19
27,25,27,3,853,605,248
27,25,27,37,165,129,36
27,25,27,53,359,288,71
27,25,27,59,517,432,85
27,25,27,65,53,0,53
27,25,27,115,174,246,-72
27,25,27,123,826,468,358
27,25,27,137,60,58,2
27,25,27,141,0,54,-54
27,25,27,163,1129,818,311
27,25,55,13,0,65,-65
27,25,55,95,153,234,-81
27,27,27,3,0,55,-55
27,27,27,5,216,298,-82
27,27,27,37,0,74,-74
27,27,27,41,0,52,-52
27,27,27,53,116,204,-88
27,27,27,107,85,62,23
27,27,27,111,198,315,-117
27,27,27,119,97,0,97
27,27,27,167,57,0,57
27,27,38,15,53,0,53
27,27,38,17,2699,2326,373
27,27,38,35,61,0,61
27,29,27,7,172,210,-38
27,29,27,119,70,66,4
27,31,27,53,62,0,62
27,31,27,137,47,75,-28
27,33,27,63,94,109,-15
27,33,27,105,81,0,81
27,33,27,165,69,61,8
27,35,4,13,0,80,-80
27,35,27,1,229,196,33
27,35,27,3,215,105,110
27,35,27,7,74,54,20
27,35,27,9,89,63,26
27,35,27,21,634,759,-125
27,35,27,37,128,81,47
27,35,27,53,580,318,262
27,35,27,95,67,72,-5
27,35,27,97,221,222,-1
27,35,27,123,157,126,31
27,35,27,137,119,108,11
27,35,27,141,118,70,48
27,35,27,145,196,178,18
27,35,27,153,51,85,-34
27,35,27,159,81,0,81
27,35,27,163,62,56,6
27,35,27,171,104,73,31
27,35,38,17,69,0,69
27,37,2,20,109,0,109
27,37,4,13,342,504,-162
27,37,4,19,58,56,2
27,37,4,21,0,70,-70
27,37,6,1,65,0,65
27,37,6,37,189,143,46
27,37,6,59,70,74,-4
27,37,6,65,61,0,61
27,37,6,73,162,114,48
27,37,6,85,57,0,57
27,37,8,5,0,67,-67
27,37,8,31,76,80,-4
27,37,8,41,68,0,68
27,37,8,59,0,54,-54
27,37,12,21,0,58,-58
27,37,12,31,70,0,70
27,37,12,57,55,0,55
27,37,12,71,77,138,-61
27,37,12,95,0,73,-73
27,37,12,103,0,62,-62
27,37,17,31,280,160,120
27,37,19,153,100,98,2
27,37,24,510,82,0,82
27,37,25,25,84,0,84
27,37,26,163,76,0,76
27,37,27,1,0,51,-51
27,37,27,3,922,982,-60
27,37,27,13,227,125,102
27,37,27,17,0,48,-48
27,37,27,19,399,416,-17
27,37,27,21,0,79,-79
27,37,27,25,129,165,-36
27,37,27,27,74,0,74
27,37,27,35,81,128,-47
27,37,27,47,49,0,49
27,37,27,49,444,485,-41
27,37,27,53,10524,8210,2314
27,37,27,59,66,90,-24
27,37,27,61,61,68,-7
27,37,27,67,76,0,76
27,37,27,79,105,223,-118
27,37,27,83,72,0,72
27,37,27,85,57,76,-19
27,37,27,99,54,0,54
27,37,27,103,88,95,-7
27,37,27,109,505,281,224
27,37,27,111,60,57,3
27,37,27,115,55,81,-26
27,37,27,123,6784,4721,2063
27,37,27,131,831,994,-163
27,37,27,137,267,227,40
27,37,27,139,3023,3503,-480
27,37,27,141,120,156,-36
27,37,27,145,228,154,74
27,37,27,147,143,92,51
27,37,27,163,2461,2818,-357
27,37,27,169,64,54,10
27,37,27,171,220,277,-57
27,37,29,189,64,0,64
27,37,31,55,81,0,81
27,37,32,3,124,150,-26
27,37,36,47,73,0,73
27,37,36,81,74,0,74
27,37,37,119,58,0,58
27,37,38,17,165,116,49
27,37,38,35,100,0,100
27,37,39,49,94,0,94
27,37,46,99,58,92,-34
27,37,47,157,67,0,67
27,37,48,29,0,78,-78
27,37,48,113,80,78,2
27,37,48,121,0,86,-86
27,37,48,201,79,0,79
27,37,48,439,105,81,24
27,37,48,453,133,0,133
27,37,49,35,0,51,-51
27,37,51,59,62,0,62
27,37,53,33,159,144,15
27,37,55,9,83,0,83
27,37,55,13,0,61,-61
27,37,55,25,95,74,21
27,37,55,35,92,0,92
27,37,55,63,62,0,62
27,37,55,79,112,81,31
27,37,55,93,239,331,-92
27,37,55,95,0,102,-102
27,37,55,109,232,408,-176
27,37,55,133,0,68,-68
27,39,27,49,73,75,-2
27,39,27,99,111,89,22
27,39,27,109,773,626,147
27,39,27,147,106,80,26
27,41,27,3,54,0,54
27,41,27,27,52,0,52
27,41,27,51,122,128,-6
27,41,27,53,200,109,91
27,41,27,111,177,169,8
27,41,27,121,195,239,-44
27,41,27,123,0,46,-46
27,41,27,145,196,180,16
27,41,27,153,182,177,5
27,41,27,171,69,0,69
27,41,38,17,85,75,10
27,43,27,13,92,159,-67
27,43,27,47,86,69,17
27,43,27,91,99,119,-20
27,45,27,55,72,86,-14
27,45,27,99,90,71,19
27,45,27,109,418,398,20
27,45,27,169,110,144,-34
27,47,27,37,0,49,-49
27,47,27,43,69,86,-17
27,47,27,53,108,84,24
27,47,27,99,199,222,-23
27,47,27,109,0,101,-101
27,47,27,123,0,59,-59
27,47,27,147,148,96,52
27,47,27,161,73,67,6
27,49,27,3,68,0,68
27,49,27,37,485,444,41
27,49,27,39,75,73,2
27,49,27,53,210,228,-18
27,49,27,109,451,359,92
27,49,27,123,170,169,1
27,49,27,131,208,155,53
27,49,27,157,276,304,-28
27,49,27,163,80,90,-10
27,49,55,93,143,200,-57
27,51,27,41,128,122,6
27,51,27,111,78,98,-20
27,53,2,20,67,0,67
27,53,4,13,970,1383,-413
27,53,4,19,200,224,-24
27,53,4,21,64,146,-82
27,53,5,7,94,80,14
27,53,6,1,337,297,40
27,53,6,13,115,155,-40
27,53,6,19,110,76,34
27,53,6,37,923,979,-56
27,53,6,59,322,432,-110
27,53,6,65,104,184,-80
27,53,6,67,102,180,-78
27,53,6,71,101,75,26
27,53,6,73,567,566,1
27,53,6,75,249,248,1
27,53,6,81,78,124,-46
27,53,6,85,229,433,-204
27,53,6,97,61,0,61
27,53,6,111,84,0,84
27,53,8,1,82,86,-4
27,53,8,5,197,184,13
27,53,8,13,113,125,-12
27,53,8,31,298,549,-251
27,53,8,35,86,68,18
27,53,8,41,142,159,-17
27,53,8,59,114,191,-77
27,53,8,69,80,114,-34
27,53,8,123,78,0,78
27,53,9,1,77,91,-14
27,53,9,3,117,113,4
27,53,9,9,63,52,11
27,53,11,1,291,197,94
27,53,12,9,0,80,-80
27,53,12,11,177,137,40
27,53,12,21,115,271,-156
27,53,12,31,107,79,28
27,53,12,57,164,262,-98
27,53,12,71,214,329,-115
27,53,12,81,60,90,-30
27,53,12,86,214,155,59
27,53,12,95,149,126,23
27,53,12,99,95,147,-52
27,53,12,103,139,179,-40
27,53,12,105,0,55,-55
27,53,12,115,60,113,-53
27,53,12,117,0,68,-68
27,53,13,67,103,99,4
27,53,13,89,153,103,50
27,53,13,121,185,304,-119
27,53,13,135,100,121,-21
27,53,15,3,76,98,-22
27,53,16,1,70,80,-10
27,53,17,19,67,0,67
27,53,17,31,2057,1676,381
27,53,17,43,280,235,45
27,53,17,89,59,55,4
27,53,17,97,182,138,44
27,53,17,143,87,0,87
27,53,17,197,125,0,125
27,53,17,201,0,55,-55
27,53,18,57,83,0,83
27,53,18,89,111,74,37
27,53,18,97,148,101,47
27,53,18,105,49,0,49
27,53,18,157,56,0,56
27,53,19,13,120,64,56
27,53,19,33,49,0,49
27,53,19,49,76,67,9
27,53,19,103,210,92,118
27,53,19,113,145,88,57
27,53,19,153,428,288,140
27,53,19,163,54,0,54
27,53,19,169,112,60,52
27,53,19,193,62,0,62
27,53,20,91,143,129,14
27,53,20,173,76,0,76
27,53,21,111,126,50,76
27,53,22,71,71,44,27
27,53,23,5,96,0,96
27,53,24,3,0,67,-67
27,53,24,5,86,0,86
27,53,24,31,133,117,16
27,53,24,33,83,53,30
27,53,24,510,84,91,-7
27,53,25,17,268,277,-9
27,53,25,21,0,81,-81
27,53,25,25,220,119,101
27,53,25,27,75,0,75
27,53,26,61,46,0,46
27,53,26,81,121,117,4
27,53,26,99,67,0,67
27,53,26,125,181,123,58
27,53,26,161,127,104,23
27,53,26,163,113,150,-37
27,53,27,1,81,124,-43
27,53,27,3,9325,12152,-2827
27,53,27,5,55,81,-26
27,53,27,7,143,128,15
27,53,27,9,291,192,99
27,53,27,13,580,296,284
27,53,27,15,84,0,84
27,53,27,17,75,62,13
27,53,27,19,3029,4589,-1560
27,53,27,21,130,212,-82
27,53,27,25,288,359,-71
27,53,27,27,204,116,88
27,53,27,31,0,62,-62
27,53,27,35,318,580,-262
27,53,27,37,8210,10524,-2314
27,53,27,41,109,200,-91
27,53,27,47,84,108,-24
27,53,27,49,228,210,18
27,53,27,57,61,139,-78
27,53,27,59,278,380,-102
27,53,27,61,122,118,4
27,53,27,65,63,75,-12
27,53,27,67,323,171,152
27,53,27,75,0,48,-48
27,53,27,79,134,151,-17
27,53,27,83,121,70,51
27,53,27,85,286,281,5
27,53,27,93,89,87,2
27,53,27,95,165,171,-6
27,53,27,97,89,115,-26
27,53,27,99,119,71,48
27,53,27,103,237,139,98
27,53,27,105,54,0,54
27,53,27,109,918,500,418
27,53,27,111,191,179,12
27,53,27,115,110,139,-29
27,53,27,119,110,72,38
27,53,27,123,14716,16373,-1657
27,53,27,131,509,417,92
27,53,27,137,976,789,187
27,53,27,139,2902,3946,-1044
27,53,27,141,1265,1837,-572
27,53,27,143,50,79,-29
27,53,27,145,1273,863,410
27,53,27,147,156,118,38
27,53,27,149,44,0,44
27,53,27,153,55,78,-23
27,53,27,157,56,0,56
27,53,27,161,54,0,54
27,53,27,163,2292,2901,-609
27,53,27,169,213,122,91
27,53,27,171,2468,4435,-1967
27,53,29,19,56,0,56
27,53,29,95,207,123,84
27,53,29,189,205,163,42
27,53,29,510,99,95,4
27,53,30,31,63,57,6
27,53,30,63,0,59,-59
27,53,31,55,251,177,74
27,53,31,109,73,59,14
27,53,32,3,329,377,-48
27,53,32,31,58,57,1
27,53,34,3,0,61,-61
27,53,34,13,0,55,-55
27,53,34,17,126,100,26
27,53,34,21,63,0,63
27,53,34,23,111,96,15
27,53,35,1,88,0,88
27,53,35,49,0,48,-48
27,53,36,5,73,0,73
27,53,36,29,76,0,76
27,53,36,47,335,318,17
27,53,36,55,59,59,0
27,53,36,61,411,441,-30
27,53,36,81,177,116,61
27,53,36,119,90,0,90
27,53,37,63,54,63,-9
27,53,37,119,190,370,-180
27,53,37,183,107,172,-65
27,53,38,15,144,78,66
27,53,38,17,623,423,200
27,53,38,35,333,121,212
27,53,38,101,73,0,73
27,53,39,35,129,115,14
27,53,39,49,321,218,103
27,53,39,61,121,153,-32
27,53,40,109,78,53,25
27,53,40,143,55,0,55
27,53,41,39,0,46,-46
27,53,41,51,259,315,-56
27,53,41,67,113,149,-36
27,53,42,3,150,136,14
27,53,42,91,0,63,-63
27,53,42,101,189,151,38
27,53,44,7,72,0,72
27,53,46,11,52,0,52
27,53,46,13,52,0,52
27,53,46,83,92,73,19
27,53,46,99,286,208,78
27,53,46,103,60,0,60
27,53,47,37,205,206,-1
27,53,47,157,133,75,58
27,53,48,29,224,150,74
27,53,48,85,178,330,-152
27,53,48,113,330,453,-123
27,53,48,121,127,145,-18
27,53,48,157,75,73,2
27,53,48,201,412,458,-46
27,53,48,339,0,69,-69
27,53,48,439,235,236,-1
27,53,48,453,297,438,-141
27,53,48,491,68,128,-60
27,53,49,35,159,173,-14
27,53,49,49,73,0,73
27,53,51,13,88,69,19
27,53,51,59,184,166,18
27,53,51,107,59,0,59
27,53,53,11,0,68,-68
27,53,53,33,729,886,-157
27,53,53,53,72,82,-10
27,53,53,61,80,91,-11
27,53,53,63,0,56,-56
27,53,55,5,138,116,22
27,53,55,9,301,132,169
27,53,55,13,0,75,-75
27,53,55,17,77,63,14
27,53,55,25,697,415,282
27,53,55,31,115,57,58
27,53,55,33,121,86,35
27,53,55,35,250,193,57
27,53,55,63,214,127,87
27,53,55,73,111,65,46
27,53,55,79,534,399,135
27,53,55,87,109,67,42
27,53,55,89,44,0,44
27,53,55,93,181,137,44
27,53,55,95,133,196,-63
27,53,55,101,44,0,44
27,53,55,105,58,0,58
27,53,55,109,347,378,-31
27,53,55,113,0,50,-50
27,53,55,129,0,56,-56
27,53,55,133,221,180,41
27,53,55,139,115,0,115
27,53,55,141,71,0,71
27,55,27,45,86,72,14
27,55,27,169,132,114,18
27,55,55,63,412,343,69
27,57,27,5,117,132,-15
27,57,27,7,334,256,78
27,57,27,21,175,125,50
27,57,27,53,139,61,78
27,57,27,159,99,77,22
27,57,38,17,0,50,-50
27,59,27,3,1298,818,480
27,59,27,25,432,517,-85
27,59,27,37,90,66,24
27,59,27,53,380,278,102
27,59,27,65,168,197,-29
27,59,27,95,149,225,-76
27,59,27,115,121,149,-28
27,59,27,123,335,146,189
27,59,27,141,280,162,118
27,59,27,145,0,59,-59
27,59,27,163,128,128,0
27,59,27,171,86,67,19
27,61,27,1,70,100,-30
27,61,27,3,90,77,13
27,61,27,7,79,61,18
27,61,27,21,75,104,-29
27,61,27,37,68,61,7
27,61,27,53,118,122,-4
27,61,27,123,68,78,-10
27,61,27,137,435,376,59
27,63,27,33,109,94,15
27,63,27,105,55,64,-9
27,65,27,3,144,55,89
27,65,27,25,0,53,-53
27,65,27,53,75,63,12
27,65,27,59,197,168,29
27,65,27,95,141,91,50
27,65,27,115,195,204,-9
27,67,27,23,131,140,-9
27,67,27,37,0,76,-76
27,67,27,53,171,323,-152
27,67,27,85,0,48,-48
27,67,27,93,131,97,34
27,67,27,123,72,103,-31
27,67,27,129,129,144,-15
27,67,27,139,0,61,-61
27,67,27,145,259,291,-32
27,67,27,151,96,152,-56
27,67,27,171,62,0,62
27,71,27,137,72,77,-5
27,73,27,23,62,0,62
27,75,27,53,48,0,48
27,75,27,137,313,322,-9
27,77,27,135,0,58,-58
27,79,27,13,284,291,-7
27,79,27,19,69,0,69
27,79,27,37,223,105,118
27,79,27,53,151,134,17
27,79,27,103,273,238,35
27,79,27,123,0,49,-49
27,79,27,131,288,179,109
27,79,27,139,500,522,-22
27,79,27,143,77,103,-26
27,79,27,161,104,112,-8
27,81,27,83,65,70,-5
27,83,27,37,0,72,-72
27,83,27,53,70,121,-51
27,83,27,81,70,65,5
27,83,27,101,57,63,-6
27,83,27,123,0,61,-61
27,83,27,127,127,136,-9
27,83,27,145,0,72,-72
27,83,27,173,91,93,-2
27,83,46,99,0,73,-73
27,85,27,3,64,0,64
27,85,27,19,305,255,50
27,85,27,37,76,57,19
27,85,27,53,281,286,-5
27,85,27,67,48,0,48
27,85,27,93,208,249,-41
27,85,27,123,56,0,56
27,85,27,129,76,88,-12
27,85,27,139,79,62,17
27,85,27,143,165,98,67
27,85,27,145,71,81,-10
27,85,27,171,213,245,-32
27,87,27,5,83,125,-42
27,89,27,113,139,104,35
27,89,27,119,0,56,-56
27,89,38,35,64,74,-10
27,91,27,13,59,138,-79
27,91,27,43,119,99,20
27,91,27,165,0,49,-49
27,93,27,53,87,89,-2
27,93,27,67,97,131,-34
27,93,27,85,249,208,41
27,93,27,145,280,194,86
27,93,27,171,321,247,74
27,95,27,1,0,88,-88
27,95,27,3,245,142,103
27,95,27,9,233,203,30
27,95,27,35,72,67,5
27,95,27,53,171,165,6
27,95,27,59,225,149,76
27,95,27,65,91,141,-50
27,95,27,97,0,73,-73
27,95,27,123,63,58,5
27,95,27,141,596,540,56
27,95,27,145,113,126,-13
27,95,27,171,100,80,20
27,97,27,3,73,0,73
27,97,27,9,336,232,104
27,97,27,21,0,74,-74
27,97,27,35,222,221,1
27,97,27,53,115,89,26
27,97,27,95,73,0,73
27,97,27,141,81,66,15
27,97,27,145,397,350,47
27,97,27,153,189,203,-14
27,97,27,171,64,0,64
27,99,27,37,0,54,-54
27,99,27,39,89,111,-22
27,99,27,45,71,90,-19
27,99,27,47,222,199,23
27,99,27,53,71,119,-48
27,99,27,109,370,438,-68
27,99,27,123,107,87,20
27,99,27,147,85,108,-23
27,101,27,83,63,57,6
27,101,27,105,92,96,-4
27,103,27,13,1312,1243,69
27,103,27,15,173,183,-10
27,103,27,37,95,88,7
27,103,27,53,139,237,-98
27,103,27,79,238,273,-35
27,103,27,123,0,89,-89
27,103,27,139,0,114,-114
27,103,27,143,74,58,16
27,105,27,33,0,81,-81
27,105,27,53,0,54,-54
27,105,27,63,64,55,9
27,105,27,101,96,92,4
27,105,27,133,0,90,-90
27,105,46,99,106,158,-52
27,107,27,27,62,85,-23
27,107,27,119,58,0,58
27,107,38,17,73,123,-50
27,109,4,13,137,252,-115
27,109,6,37,63,0,63
27,109,6,73,85,0,85
27,109,8,31,0,56,-56
27,109,12,31,0,79,-79
27,109,17,31,142,125,17
27,109,27,3,102,107,-5
27,109,27,13,115,89,26
27,109,27,37,281,505,-224
27,109,27,39,626,773,-147
27,109,27,45,398,418,-20
27,109,27,47,101,0,101
27,109,27,49,359,451,-92
27,109,27,53,500,918,-418
27,109,27,99,438,370,68
27,109,27,123,244,396,-152
27,109,27,131,61,94,-33
27,109,27,137,109,102,7
27,109,27,139,46,97,-51
27,109,27,145,65,75,-10
27,109,27,147,124,110,14
27,109,27,157,366,412,-46
27,109,27,163,80,114,-34
27,109,27,169,384,349,35
27,109,27,171,0,63,-63
27,109,38,17,125,0,125
27,109,48,201,59,0,59
27,109,53,33,0,78,-78
27,109,55,25,88,118,-30
27,109,55,35,61,71,-10
27,109,55,63,144,94,50
27,109,55,79,72,0,72
27,111,27,3,64,0,64
27,111,27,5,418,315,103
27,111,27,27,315,198,117
27,111,27,37,57,60,-3
27,111,27,41,169,177,-8
27,111,27,51,98,78,20
27,111,27,53,179,191,-12
27,111,27,123,47,0,47
27,111,27,145,0,62,-62
27,111,27,153,103,0,103
27,111,27,159,234,238,-4
27,111,27,167,82,60,22
27,111,38,17,409,310,99
27,113,27,89,104,139,-35
27,113,27,119,93,107,-14
27,113,27,125,88,96,-8
27,113,27,135,55,0,55
27,113,38,17,0,57,-57
27,113,38,35,74,46,28
27,115,27,3,228,103,125
27,115,27,17,180,139,41
27,115,27,25,246,174,72
27,115,27,37,81,55,26
27,115,27,53,139,110,29
27,115,27,59,149,121,28
27,115,27,65,204,195,9
27,115,27,123,126,103,23
27,115,27,137,53,88,-35
27,115,27,163,86,53,33
27,117,46,99,90,101,-11
27,119,27,7,60,92,-32
27,119,27,27,0,97,-97
27,119,27,29,66,70,-4
27,119,27,53,72,110,-38
27,119,27,89,56,0,56
27,119,27,107,0,58,-58
27,119,27,113,107,93,14
27,119,38,17,98,106,-8
27,119,38,35,659,577,82
27,121,27,41,239,195,44
27,121,27,145,82,61,21
27,121,27,149,0,56,-56
27,123,2,20,98,0,98
27,123,4,13,317,486,-169
27,123,4,19,49,81,-32
27,123,4,21,0,52,-52
27,123,6,1,90,89,1
27,123,6,19,98,0,98
27,123,6,37,247,262,-15
27,123,6,59,125,101,24
27,123,6,67,110,100,10
27,123,6,73,194,147,47
27,123,6,75,0,54,-54
27,123,6,85,72,98,-26
27,123,8,5,71,68,3
27,123,8,31,65,104,-39
27,123,8,41,56,0,56
27,123,8,59,46,55,-9
27,123,8,69,53,0,53
27,123,11,1,93,62,31
27,123,12,21,0,64,-64
27,123,12,57,0,76,-76
27,123,12,71,0,89,-89
27,123,12,99,47,0,47
27,123,12,103,0,65,-65
27,123,13,89,107,61,46
27,123,13,121,64,61,3
27,123,15,3,57,0,57
27,123,17,31,662,491,171
27,123,17,43,63,89,-26
27,123,19,103,62,0,62
27,123,19,153,155,98,57
27,123,19,169,55,0,55
27,123,24,31,74,0,74
27,123,24,33,56,0,56
27,123,25,17,90,98,-8
27,123,25,25,45,46,-1
27,123,27,1,0,55,-55
27,123,27,3,4421,6308,-1887
27,123,27,7,71,0,71
27,123,27,9,63,78,-15
27,123,27,13,254,139,115
27,123,27,19,214,293,-79
27,123,27,21,53,65,-12
27,123,27,25,468,826,-358
27,123,27,35,126,157,-31
27,123,27,37,4721,6784,-2063
27,123,27,41,46,0,46
27,123,27,47,59,0,59
27,123,27,49,169,170,-1
27,123,27,53,16373,14716,1657
27,123,27,59,146,335,-189
27,123,27,61,78,68,10
27,123,27,67,103,72,31
27,123,27,79,49,0,49
27,123,27,83,61,0,61
27,123,27,85,0,56,-56
27,123,27,95,58,63,-5
27,123,27,99,87,107,-20
27,123,27,103,89,0,89
27,123,27,109,396,244,152
27,123,27,111,0,47,-47
27,123,27,115,103,126,-23
27,123,27,131,245,110,135
27,123,27,137,517,379,138
27,123,27,139,474,452,22
27,123,27,141,205,333,-128
27,123,27,145,454,300,154
27,123,27,147,66,51,15
27,123,27,163,6076,9193,-3117
27,123,27,169,83,72,11
27,123,27,171,289,342,-53
27,123,29,95,0,48,-48
27,123,31,55,103,91,12
27,123,32,3,110,182,-72
27,123,36,47,87,71,16
27,123,36,61,69,70,-1
27,123,36,81,75,0,75
27,123,37,119,0,48,-48
27,123,37,183,0,65,-65
27,123,38,17,244,106,138
27,123,38,35,89,70,19
27,123,39,49,129,71,58
27,123,41,51,65,88,-23
27,123,42,101,69,0,69
27,123,46,13,69,0,69
27,123,46,99,106,0,106
27,123,47,37,88,0,88
27,123,48,29,0,76,-76
27,123,48,113,102,104,-2
27,123,48,201,145,136,9
27,123,48,439,74,92,-18
27,123,48,453,79,114,-35
27,123,49,35,0,69,-69
27,123,51,59,0,50,-50
27,123,53,33,217,223,-6
27,123,55,5,80,0,80
27,123,55,9,139,67,72
27,123,55,13,0,76,-76
27,123,55,25,324,108,216
27,123,55,33,95,0,95
27,123,55,35,156,105,51
27,123,55,63,132,61,71
27,123,55,73,111,0,111
27,123,55,79,208,190,18
27,123,55,87,47,0,47
27,123,55,93,201,213,-12
27,123,55,95,114,175,-61
27,123,55,109,479,773,-294
27,123,55,133,76,0,76
27,125,27,113,96,88,8
27,127,27,15,75,99,-24
27,127,27,83,136,127,9
27,127,27,129,119,124,-5
27,129,27,67,144,129,15
27,129,27,85,88,76,12
27,129,27,127,124,119,5
27,129,27,143,52,0,52
27,131,27,3,67,0,67
27,131,27,13,0,77,-77
27,131,27,37,994,831,163
27,131,27,49,155,208,-53
27,131,27,53,417,509,-92
27,131,27,79,179,288,-109
27,131,27,109,94,61,33
27,131,27,123,110,245,-135
27,131,27,139,394,343,51
27,131,27,147,291,343,-52
27,131,27,161,61,103,-42
27,131,27,163,55,77,-22
27,133,27,105,90,0,90
27,133,46,99,136,170,-34
27,135,27,77,58,0,58
27,135,27,113,0,55,-55
27,135,38,17,0,60,-60
27,135,38,35,0,69,-69
27,137,4,13,94,147,-53
27,137,17,31,78,0,78
27,137,27,1,55,0,55
27,137,27,3,230,266,-36
27,137,27,7,104,88,16
27,137,27,13,66,0,66
27,137,27,17,797,1094,-297
27,137,27,19,0,74,-74
27,137,27,21,73,0,73
27,137,27,25,58,60,-2
27,137,27,31,75,47,28
27,137,27,35,108,119,-11
27,137,27,37,227,267,-40
27,137,27,53,789,976,-187
27,137,27,61,376,435,-59
27,137,27,71,77,72,5
27,137,27,75,322,313,9
27,137,27,109,102,109,-7
27,137,27,115,88,53,35
27,137,27,123,379,517,-138
27,137,27,139,68,82,-14
27,137,27,141,84,85,-1
27,137,27,145,91,90,1
27,137,27,163,150,198,-48
27,137,27,171,122,90,32
27,137,38,17,121,0,121
27,137,38,35,55,0,55
27,137,55,7,51,58,-7
27,137,55,25,50,0,50
27,137,55,31,893,996,-103
27,139,4,13,96,166,-70
27,139,6,37,0,52,-52
27,139,6,73,68,70,-2
27,139,12,71,0,65,-65
27,139,17,31,63,0,63
27,139,27,3,239,236,3
27,139,27,13,134,122,12
27,139,27,19,805,911,-106
27,139,27,37,3503,3023,480
27,139,27,53,3946,2902,1044
27,139,27,67,61,0,61
27,139,27,79,522,500,22
27,139,27,85,62,79,-17
27,139,27,103,114,0,114
27,139,27,109,97,46,51
27,139,27,123,452,474,-22
27,139,27,131,343,394,-51
27,139,27,137,82,68,14
27,139,27,141,0,84,-84
27,139,27,143,78,128,-50
27,139,27,145,84,86,-2
27,139,27,163,212,207,5
27,139,27,171,93,139,-46
27,139,38,17,91,0,91
27,141,4,13,69,70,-1
27,141,27,3,1679,1144,535
27,141,27,9,458,415,43
27,141,27,19,76,0,76
27,141,27,25,54,0,54
27,141,27,35,70,118,-48
27,141,27,37,156,120,36
27,141,27,53,1837,1265,572
27,141,27,59,162,280,-118
27,141,27,95,540,596,-56
27,141,27,97,66,81,-15
27,141,27,123,333,205,128
27,141,27,137,85,84,1
27,141,27,139,84,0,84
27,141,27,145,1072,1111,-39
27,141,27,163,135,91,44
27,141,27,171,1586,1552,34
27,143,27,19,109,74,35
27,143,27,53,79,50,29
27,143,27,79,103,77,26
27,143,27,85,98,165,-67
27,143,27,103,58,74,-16
27,143,27,129,0,52,-52
27,143,27,139,128,78,50
27,145,4,13,0,117,-117
27,145,17,31,0,50,-50
27,145,27,3,298,258,40
27,145,27,9,2220,2361,-141
27,145,27,19,60,77,-17
27,145,27,21,0,68,-68
27,145,27,35,178,196,-18
27,145,27,37,154,228,-74
27,145,27,41,180,196,-16
27,145,27,53,863,1273,-410
27,145,27,59,59,0,59
27,145,27,67,291,259,32
27,145,27,83,72,0,72
27,145,27,85,81,71,10
27,145,27,93,194,280,-86
27,145,27,95,126,113,13
27,145,27,97,350,397,-47
27,145,27,109,75,65,10
27,145,27,111,62,0,62
27,145,27,121,61,82,-21
27,145,27,123,300,454,-154
27,145,27,137,90,91,-1
27,145,27,139,86,84,2
27,145,27,141,1111,1072,39
27,145,27,153,279,314,-35
27,145,27,163,85,133,-48
27,145,27,171,644,730,-86
27,145,38,17,130,102,28
27,145,38,35,53,0,53
27,145,53,33,0,63,-63
27,147,27,13,78,87,-9
27,147,27,37,92,143,-51
27,147,27,39,80,106,-26
27,147,27,47,96,148,-52
27,147,27,53,118,156,-38
27,147,27,99,108,85,23
27,147,27,109,110,124,-14
27,147,27,123,51,66,-15
27,147,27,131,343,291,52
27,147,27,161,133,206,-73
27,149,27,53,0,44,-44
27,149,27,121,56,0,56
27,151,27,23,0,76,-76
27,151,27,67,152,96,56
27,153,27,35,85,51,34
27,153,27,41,177,182,-5
27,153,27,53,78,55,23
27,153,27,97,203,189,14
27,153,27,111,0,103,-103
27,153,27,145,314,279,35
27,153,27,159,195,234,-39
27,157,27,49,304,276,28
27,157,27,53,0,56,-56
27,157,27,109,412,366,46
27,157,27,169,85,95,-10
27,159,27,35,0,81,-81
27,159,27,57,77,99,-22
27,159,27,111,238,234,4
27,159,27,153,234,195,39
27,161,27,13,225,239,-14
27,161,27,47,67,73,-6
27,161,27,53,0,54,-54
27,161,27,79,112,104,8
27,161,27,131,103,61,42
27,161,27,147,206,133,73
27,163,4,13,119,291,-172
27,163,4,19,0,81,-81
27,163,6,37,101,66,35
27,163,6,73,97,62,35
27,163,12,21,0,70,-70
27,163,12,71,0,98,-98
27,163,17,31,128,93,35
27,163,19,153,65,0,65
27,163,27,3,1646,1596,50
27,163,27,13,78,0,78
27,163,27,19,91,88,3
27,163,27,25,818,1129,-311
27,163,27,35,56,62,-6
27,163,27,37,2818,2461,357
27,163,27,49,90,80,10
27,163,27,53,2901,2292,609
27,163,27,59,128,128,0
27,163,27,109,114,80,34
27,163,27,115,53,86,-33
27,163,27,123,9193,6076,3117
27,163,27,131,77,55,22
27,163,27,137,198,150,48
27,163,27,139,207,212,-5
27,163,27,141,91,135,-44
27,163,27,145,133,85,48
27,163,27,171,94,115,-21
27,163,32,3,61,0,61
27,163,38,17,74,0,74
27,163,48,201,0,65,-65
27,163,53,33,0,56,-56
27,163,55,13,0,67,-67
27,163,55,25,100,48,52
27,163,55,33,0,56,-56
27,163,55,35,69,0,69
27,163,55,63,58,0,58
27,163,55,93,206,363,-157
27,163,55,95,153,257,-104
27,163,55,109,820,1429,-609
27,165,27,13,80,124,-44
27,165,27,15,0,63,-63
27,165,27,33,61,69,-8
27,165,27,91,49,0,49
27,167,27,27,0,57,-57
27,167,27,111,60,82,-22
27,167,38,17,0,72,-72
27,167,38,77,174,139,35
27,169,27,37,54,64,-10
27,169,27,45,144,110,34
27,169,27,53,122,213,-91
27,169,27,55,114,132,-18
27,169,27,109,349,384,-35
27,169,27,123,72,83,-11
27,169,27,157,95,85,10
27,169,55,11,80,95,-15
27,169,55,63,177,193,-16
27,169,55,121,54,95,-41
27,171,4,13,80,127,-47
27,171,27,3,830,614,216
27,171,27,9,130,137,-7
27,171,27,19,385,332,53
27,171,27,21,0,68,-68
27,171,27,35,73,104,-31
27,171,27,37,277,220,57
27,171,27,41,0,69,-69
27,171,27,53,4435,2468,1967
27,171,27,59,67,86,-19
27,171,27,67,0,62,-62
27,171,27,85,245,213,32
27,171,27,93,247,321,-74
27,171,27,95,80,100,-20
27,171,27,97,0,64,-64
27,171,27,109,63,0,63
27,171,27,123,342,289,53
27,171,27,137,90,122,-32
27,171,27,139,139,93,46
27,171,27,141,1552,1586,-34
27,171,27,145,730,644,86
27,171,27,163,115,94,21
27,171,38,17,54,69,-15
27,173,27,23,132,151,-19
27,173,27,83,93,91,2
28,1,22,29,305,308,-3
28,1,22,33,0,77,-77
28,1,28,37,96,0,96
28,1,28,49,0,64,-64
28,1,28,63,108,103,5
28,1,48,113,0,57,-57
28,1,48,201,0,58,-58
28,3,28,81,98,103,-5
28,3,28,117,242,260,-18
28,3,28,139,176,140,36
28,3,28,141,231,148,83
28,3,47,109,152,182,-30
28,3,47,157,65,0,65
28,5,28,113,181,249,-68
28,7,28,51,104,70,34
28,7,28,79,84,111,-27
28,9,28,33,90,78,12
28,9,28,93,187,175,12
28,9,28,139,94,115,-21
28,9,28,145,86,100,-14
28,9,47,157,84,92,-8
28,11,28,27,73,63,10
28,11,28,33,80,183,-103
28,11,28,49,0,55,-55
28,11,28,89,0,63,-63
28,11,28,133,230,253,-23
28,11,28,151,142,147,-5
28,11,47,157,125,224,-99
28,13,28,17,92,141,-49
28,13,28,115,0,80,-80
28,15,28,43,104,103,1
28,15,28,83,224,221,3
28,15,28,97,75,117,-42
28,17,28,13,141,92,49
28,17,28,25,91,86,5
28,17,28,81,216,247,-31
28,17,28,95,110,150,-40
28,17,28,115,136,158,-22
28,19,28,105,81,72,9
28,19,28,155,90,82,8
28,19,28,159,83,70,13
28,21,28,49,0,79,-79
28,21,28,149,113,119,-6
28,23,28,61,0,92,-92
28,23,28,67,57,79,-22
28,23,28,75,232,320,-88
28,23,28,153,89,112,-23
28,25,28,17,86,91,-5
28,25,28,81,0,140,-140
28,25,28,87,184,198,-14
28,25,28,95,74,96,-22
28,25,28,105,185,197,-12
28,27,28,11,63,73,-10
28,27,28,33,100,319,-219
28,27,28,143,95,138,-43
28,27,47,157,76,143,-67
28,29,28,49,400,452,-52
28,29,28,85,255,285,-30
28,29,28,121,203,162,41
28,31,28,35,188,192,-4
28,31,28,65,0,71,-71
28,31,28,67,93,162,-69
28,31,28,73,163,214,-51
28,31,28,127,86,121,-35
28,31,28,129,113,118,-5
28,33,5,31,58,0,58
28,33,5,35,129,97,32
28,33,5,119,0,61,-61
28,33,6,37,0,61,-61
28,33,17,31,133,0,133
28,33,28,9,78,90,-12
28,33,28,11,183,80,103
28,33,28,27,319,100,219
28,33,28,43,81,0,81
28,33,28,47,0,71,-71
28,33,28,49,112,94,18
28,33,28,71,286,159,127
28,33,28,81,113,80,33
28,33,28,83,127,0,127
28,33,28,87,73,0,73
28,33,28,89,94,71,23
28,33,28,93,864,1011,-147
28,33,28,105,96,0,96
28,33,28,107,396,294,102
28,33,28,121,92,90,2
28,33,28,133,139,0,139
28,33,28,135,81,0,81
28,33,28,137,819,876,-57
28,33,28,143,454,239,215
28,33,28,145,85,72,13
28,33,28,151,202,0,202
28,33,28,161,0,60,-60
28,33,47,37,63,96,-33
28,33,47,47,101,132,-31
28,33,47,113,0,74,-74
28,33,47,157,6689,4929,1760
28,33,47,167,109,140,-31
28,33,48,113,96,70,26
28,33,48,201,68,70,-2
28,33,48,439,0,88,-88
28,35,1,97,75,77,-2
28,35,28,31,192,188,4
28,35,28,47,296,438,-142
28,35,28,49,129,134,-5
28,35,28,59,91,168,-77
28,35,28,61,78,0,78
28,35,28,65,81,93,-12
28,35,28,67,456,481,-25
28,35,28,73,2111,2587,-476
28,35,28,75,60,57,3
28,35,28,89,66,58,8
28,35,28,91,150,136,14
28,35,28,109,104,115,-11
28,35,28,111,334,291,43
28,35,28,121,79,146,-67
28,35,28,131,97,79,18
28,35,28,153,83,66,17
28,35,48,113,0,52,-52
28,35,48,201,0,82,-82
28,35,48,439,0,64,-64
28,37,28,1,0,96,-96
28,37,28,85,81,77,4
28,39,1,97,346,198,148
28,39,28,41,126,156,-30
28,39,28,47,0,64,-64
28,39,28,59,423,358,65
28,41,1,97,0,59,-59
28,41,28,39,156,126,30
28,41,28,111,75,65,10
28,41,28,153,140,103,37
28,43,28,15,103,104,-1
28,43,28,33,0,81,-81
28,43,28,71,0,58,-58
28,43,28,83,72,0,72
28,43,28,97,173,143,30
28,43,28,135,120,104,16
28,43,28,161,119,119,0
28,43,47,157,0,75,-75
28,45,22,51,213,96,117
28,45,22,71,136,76,60
28,45,22,103,404,372,32
28,45,28,47,937,919,18
28,45,28,59,87,116,-29
28,45,28,109,365,349,16
28,47,1,3,106,104,2
28,47,1,73,73,0,73
28,47,1,89,0,78,-78
28,47,1,97,273,312,-39
28,47,2,20,0,54,-54
28,47,4,13,88,119,-31
28,47,4,19,0,80,-80
28,47,6,37,0,63,-63
28,47,6,73,240,186,54
28,47,6,95,0,65,-65
28,47,6,111,0,54,-54
28,47,8,41,98,142,-44
28,47,12,5,123,87,36
28,47,12,31,79,122,-43
28,47,12,33,146,166,-20
28,47,12,57,0,88,-88
28,47,12,91,124,182,-58
28,47,12,113,72,98,-26
28,47,13,89,66,0,66
28,47,13,135,65,68,-3
28,47,13,153,0,72,-72
28,47,15,3,91,90,1
28,47,17,163,0,88,-88
28,47,22,33,105,74,31
28,47,22,51,240,130,110
28,47,22,63,68,0,68
28,47,22,71,180,167,13
28,47,22,103,269,279,-10
28,47,22,105,63,0,63
28,47,28,33,71,0,71
28,47,28,35,438,296,142
28,47,28,39,64,0,64
28,47,28,45,919,937,-18
28,47,28,49,229,162,67
28,47,28,59,3002,3133,-131
28,47,28,67,121,129,-8
28,47,28,73,201,154,47
28,47,28,75,119,102,17
28,47,28,89,104,0,104
28,47,28,91,101,0,101
28,47,28,109,263,272,-9
28,47,28,113,69,0,69
28,47,28,121,183,147,36
28,47,28,131,440,547,-107
28,47,32,3,129,112,17
28,47,47,157,103,104,-1
28,47,48,29,180,289,-109
28,47,48,113,0,77,-77
28,47,48,201,166,244,-78
28,47,48,439,68,92,-24
28,47,48,453,0,72,-72
28,47,51,710,72,94,-22
28,47,51,810,146,142,4
28,49,1,73,70,77,-7
28,49,4,13,0,55,-55
28,49,6,37,87,74,13
28,49,13,67,0,100,-100
28,49,13,89,0,91,-91
28,49,13,121,68,138,-70
28,49,13,135,0,103,-103
28,49,17,31,94,89,5
28,49,22,33,68,72,-4
28,49,22,51,0,93,-93
28,49,22,71,57,120,-63
28,49,28,1,64,0,64
28,49,28,11,55,0,55
28,49,28,21,79,0,79
28,49,28,29,452,400,52
28,49,28,33,94,112,-18
28,49,28,35,134,129,5
28,49,28,47,162,229,-67
28,49,28,51,134,118,16
28,49,28,59,65,143,-78
28,49,28,67,0,60,-60
28,49,28,71,62,109,-47
28,49,28,73,73,113,-40
28,49,28,75,81,101,-20
28,49,28,79,55,0,55
28,49,28,81,0,56,-56
28,49,28,83,105,66,39
28,49,28,85,101,0,101
28,49,28,87,0,64,-64
28,49,28,89,2442,3686,-1244
28,49,28,105,107,113,-6
28,49,28,113,63,71,-8
28,49,28,121,2221,3306,-1085
28,49,28,123,102,75,27
28,49,28,127,115,109,6
28,49,28,149,423,335,88
28,49,28,151,107,65,42
28,49,28,163,234,187,47
28,49,32,3,0,65,-65
28,49,47,37,81,125,-44
28,49,47,157,158,316,-158
28,49,48,29,0,69,-69
28,49,48,85,0,127,-127
28,49,48,113,126,366,-240
28,49,48,121,0,150,-150
28,49,48,201,100,306,-206
28,49,48,439,110,387,-277
28,49,48,453,67,61,6
28,51,28,7,70,104,-34
28,51,28,49,118,134,-16
28,51,28,89,99,155,-56
28,53,28,133,69,0,69
28,57,1,59,89,91,-2
28,57,28,81,713,578,135
28,57,28,95,167,173,-6
28,57,28,115,0,92,-92
28,57,28,117,0,83,-83
28,57,28,141,89,173,-84
28,59,1,3,115,127,-12
28,59,1,97,743,637,106
28,59,6,73,144,96,48
28,59,12,5,82,0,82
28,59,12,33,60,81,-21
28,59,12,113,0,67,-67
28,59,22,33,62,0,62
28,59,22,51,146,72,74
28,59,22,71,59,0,59
28,59,22,103,0,96,-96
28,59,28,35,168,91,77
28,59,28,39,358,423,-65
28,59,28,45,116,87,29
28,59,28,47,3133,3002,131
28,59,28,49,143,65,78
28,59,28,73,118,61,57
28,59,28,105,56,0,56
28,59,28,109,84,0,84
28,59,28,121,118,107,11
28,59,28,131,100,98,2
28,59,48,29,79,0,79
28,59,48,201,135,175,-40
28,61,28,23,92,0,92
28,61,28,35,0,78,-78
28,61,28,67,381,489,-108
28,61,28,129,117,96,21
28,63,28,1,103,108,-5
28,65,28,31,71,0,71
28,65,28,35,93,81,12
28,65,28,73,147,89,58
28,65,28,77,70,70,0
28,65,28,91,0,73,-73
28,65,28,127,69,0,69
28,67,28,23,79,57,22
28,67,28,31,162,93,69
28,67,28,35,481,456,25
28,67,28,47,129,121,8
28,67,28,49,60,0,60
28,67,28,61,489,381,108
28,67,28,73,208,275,-67
28,67,28,75,80,0,80
28,67,28,121,0,86,-86
28,67,28,129,156,106,50
28,67,28,153,243,138,105
28,69,28,75,111,162,-51
28,69,28,99,83,110,-27
28,71,28,33,159,286,-127
28,71,28,43,58,0,58
28,71,28,49,109,62,47
28,71,28,81,137,145,-8
28,71,28,89,86,92,-6
28,71,28,93,0,70,-70
28,71,28,107,233,220,13
28,71,28,115,117,91,26
28,71,28,121,57,75,-18
28,71,28,137,66,0,66
28,71,28,145,100,0,100
28,71,28,161,218,212,6
28,71,47,157,220,194,26
28,73,1,97,0,54,-54
28,73,22,103,0,68,-68
28,73,28,31,214,163,51
28,73,28,35,2587,2111,476
28,73,28,47,154,201,-47
28,73,28,49,113,73,40
28,73,28,59,61,118,-57
28,73,28,65,89,147,-58
28,73,28,67,275,208,67
28,73,28,89,69,81,-12
28,73,28,91,289,209,80
28,73,28,109,154,112,42
28,73,28,111,103,72,31
28,73,28,121,126,117,9
28,73,28,127,103,0,103
28,75,1,3,0,57,-57
28,75,1,23,87,0,87
28,75,1,73,0,56,-56
28,75,1,97,0,59,-59
28,75,1,119,86,0,86
28,75,1,125,0,54,-54
28,75,6,73,0,48,-48
28,75,28,23,320,232,88
28,75,28,35,57,60,-3
28,75,28,47,102,119,-17
28,75,28,49,101,81,20
28,75,28,67,0,80,-80
28,75,28,69,162,111,51
28,75,28,89,0,79,-79
28,75,28,99,168,90,78
28,75,28,101,219,227,-8
28,75,28,105,0,61,-61
28,75,28,121,68,139,-71
28,75,48,201,0,63,-63
28,75,48,355,69,0,69
28,75,51,810,0,70,-70
28,77,28,65,70,70,0
28,77,28,85,88,172,-84
28,77,28,127,0,69,-69
28,79,28,7,111,84,27
28,79,28,49,0,55,-55
28,79,28,89,101,132,-31
28,79,28,99,171,235,-64
28,79,28,101,61,0,61
28,79,28,121,169,161,8
28,79,28,123,178,189,-11
28,81,28,3,103,98,5
28,81,28,17,247,216,31
28,81,28,25,140,0,140
28,81,28,33,80,113,-33
28,81,28,49,56,0,56
28,81,28,57,578,713,-135
28,81,28,71,145,137,8
28,81,28,87,125,93,32
28,81,28,95,542,468,74
28,81,28,105,117,66,51
28,81,28,115,676,658,18
28,81,28,117,358,359,-1
28,81,28,121,82,0,82
28,81,28,139,61,62,-1
28,81,28,141,0,59,-59
28,81,28,145,394,332,62
28,81,47,37,0,68,-68
28,81,47,157,159,173,-14
28,83,28,15,221,224,-3
28,83,28,33,0,127,-127
28,83,28,43,0,72,-72
28,83,28,49,66,105,-39
28,83,28,133,101,91,10
28,83,47,157,113,191,-78
28,85,28,29,285,255,30
28,85,28,37,77,81,-4
28,85,28,49,0,101,-101
28,85,28,77,172,88,84
28,85,28,113,240,208,32
28,85,28,121,64,77,-13
28,87,1,75,95,101,-6
28,87,1,107,96,84,12
28,87,1,125,76,72,4
28,87,8,41,61,0,61
28,87,12,91,0,60,-60
28,87,28,25,198,184,14
28,87,28,33,0,73,-73
28,87,28,49,64,0,64
28,87,28,81,93,125,-32
28,87,28,95,232,268,-36
28,87,28,103,145,96,49
28,87,28,105,378,292,86
28,87,47,157,0,71,-71
28,89,1,73,0,105,-105
28,89,13,121,0,66,-66
28,89,17,31,56,0,56
28,89,22,71,0,50,-50
28,89,22,103,0,84,-84
28,89,28,11,63,0,63
28,89,28,33,71,94,-23
28,89,28,35,58,66,-8
28,89,28,47,0,104,-104
28,89,28,49,3686,2442,1244
28,89,28,51,155,99,56
28,89,28,71,92,86,6
28,89,28,73,81,69,12
28,89,28,75,79,0,79
28,89,28,79,132,101,31
28,89,28,105,88,75,13
28,89,28,121,1481,1446,35
28,89,28,149,106,66,40
28,89,28,163,227,160,67
28,89,47,37,0,74,-74
28,89,47,157,104,112,-8
28,89,48,113,0,113,-113
28,89,48,121,0,86,-86
28,89,48,201,76,116,-40
28,89,48,439,0,81,-81
28,91,28,35,136,150,-14
28,91,28,47,0,101,-101
28,91,28,65,73,0,73
28,91,28,73,209,289,-80
28,91,28,147,139,148,-9
28,93,28,9,175,187,-12
28,93,28,33,1011,864,147
28,93,28,71,70,0,70
28,93,28,137,99,77,22
28,93,28,145,0,116,-116
28,93,47,47,61,0,61
28,93,47,157,729,631,98
28,95,28,17,150,110,40
28,95,28,25,96,74,22
28,95,28,57,173,167,6
28,95,28,81,468,542,-74
28,95,28,87,268,232,36
28,97,28,15,117,75,42
28,97,28,43,143,173,-30
28,99,28,69,110,83,27
28,99,28,75,90,168,-78
28,99,28,79,235,171,64
28,99,28,101,255,225,30
28,99,28,121,0,64,-64
28,99,28,123,77,78,-1
28,99,28,159,112,97,15
28,101,28,75,227,219,8
28,101,28,79,0,61,-61
28,101,28,99,225,255,-30
28,101,28,121,0,55,-55
28,101,28,123,200,200,0
28,103,28,87,96,145,-49
28,103,28,105,0,66,-66
28,105,1,73,0,53,-53
28,105,28,19,72,81,-9
28,105,28,25,197,185,12
28,105,28,33,0,96,-96
28,105,28,49,113,107,6
28,105,28,59,0,56,-56
28,105,28,75,61,0,61
28,105,28,81,66,117,-51
28,105,28,87,292,378,-86
28,105,28,89,75,88,-13
28,105,28,103,66,0,66
28,105,28,121,75,115,-40
28,105,28,155,196,150,46
28,105,28,159,94,108,-14
28,105,47,157,0,118,-118
28,107,28,33,294,396,-102
28,107,28,71,220,233,-13
28,107,28,119,97,0,97
28,107,28,135,0,68,-68
28,107,28,137,322,286,36
28,107,28,161,83,83,0
28,107,47,157,110,138,-28
28,109,22,51,223,157,66
28,109,22,71,103,68,35
28,109,22,87,0,62,-62
28,109,22,103,776,596,180
28,109,22,117,102,0,102
28,109,28,35,115,104,11
28,109,28,45,349,365,-16
28,109,28,47,272,263,9
28,109,28,59,0,84,-84
28,109,28,73,112,154,-42
28,109,28,131,0,97,-97
28,111,28,35,291,334,-43
28,111,28,41,65,75,-10
28,111,28,73,72,103,-31
28,113,22,63,0,65,-65
28,113,22,71,0,69,-69
28,113,22,105,168,112,56
28,113,28,5,249,181,68
28,113,28,47,0,69,-69
28,113,28,49,71,63,8
28,113,28,85,208,240,-32
28,113,28,121,0,64,-64
28,113,28,147,277,143,134
28,115,28,13,80,0,80
28,115,28,17,158,136,22
28,115,28,57,92,0,92
28,115,28,71,91,117,-26
28,115,28,81,658,676,-18
28,115,28,145,366,383,-17
28,117,28,3,260,242,18
28,117,28,57,83,0,83
28,117,28,81,359,358,1
28,117,28,139,0,66,-66
28,117,28,141,67,90,-23
28,117,28,145,0,79,-79
28,119,28,107,0,97,-97
28,119,28,143,0,70,-70
28,121,1,73,0,78,-78
28,121,28,29,162,203,-41
28,121,28,33,90,92,-2
28,121,28,35,146,79,67
28,121,28,47,147,183,-36
28,121,28,49,3306,2221,1085
28,121,28,59,107,118,-11
28,121,28,67,86,0,86
28,121,28,71,75,57,18
28,121,28,73,117,126,-9
28,121,28,75,139,68,71
28,121,28,79,161,169,-8
28,121,28,81,0,82,-82
28,121,28,85,77,64,13
28,121,28,89,1446,1481,-35
28,121,28,99,64,0,64
28,121,28,101,55,0,55
28,121,28,105,115,75,40
28,121,28,113,64,0,64
28,121,28,123,366,244,122
28,121,28,127,450,486,-36
28,121,28,129,126,73,53
28,121,28,149,106,59,47
28,121,28,163,68,74,-6
28,121,47,37,0,56,-56
28,121,47,157,90,106,-16
28,121,48,113,0,56,-56
28,121,48,201,69,56,13
28,121,48,439,0,58,-58
28,123,28,49,75,102,-27
28,123,28,79,189,178,11
28,123,28,99,78,77,1
28,123,28,101,200,200,0
28,123,28,121,244,366,-122
28,123,28,129,74,103,-29
28,125,28,151,0,78,-78
28,127,28,31,121,86,35
28,127,28,49,109,115,-6
28,127,28,65,0,69,-69
28,127,28,73,0,103,-103
28,127,28,77,69,0,69
28,127,28,121,486,450,36
28,127,28,129,126,143,-17
28,129,28,31,118,113,5
28,129,28,61,96,117,-21
28,129,28,67,106,156,-50
28,129,28,121,73,126,-53
28,129,28,123,103,74,29
28,129,28,127,143,126,17
28,131,28,35,79,97,-18
28,131,28,47,547,440,107
28,131,28,59,98,100,-2
28,131,28,109,97,0,97
28,133,28,11,253,230,23
28,133,28,33,0,139,-139
28,133,28,53,0,69,-69
28,133,28,83,91,101,-10
28,133,28,135,77,0,77
28,133,28,151,75,154,-79
28,133,47,157,100,128,-28
28,135,28,33,0,81,-81
28,135,28,43,104,120,-16
28,135,28,107,68,0,68
28,135,28,133,0,77,-77
28,137,28,33,876,819,57
28,137,28,71,0,66,-66
28,137,28,93,77,99,-22
28,137,28,107,286,322,-36
28,137,47,157,222,218,4
28,139,28,3,140,176,-36
28,139,28,9,115,94,21
28,139,28,81,62,61,1
28,139,28,117,66,0,66
28,139,28,145,171,178,-7
28,141,1,59,98,82,16
28,141,28,3,148,231,-83
28,141,28,57,173,89,84
28,141,28,81,59,0,59
28,141,28,117,90,67,23
28,143,28,27,138,95,43
28,143,28,33,239,454,-215
28,143,28,119,70,0,70
28,143,47,157,97,140,-43
28,145,28,9,100,86,14
28,145,28,33,72,85,-13
28,145,28,71,0,100,-100
28,145,28,81,332,394,-62
28,145,28,93,116,0,116
28,145,28,115,383,366,17
28,145,28,117,79,0,79
28,145,28,139,178,171,7
28,147,22,117,0,72,-72
28,147,28,91,148,139,9
28,147,28,113,143,277,-134
28,149,22,65,111,87,24
28,149,28,21,119,113,6
28,149,28,49,335,423,-88
28,149,28,89,66,106,-40
28,149,28,121,59,106,-47
28,149,48,113,0,95,-95
28,149,48,439,0,103,-103
28,151,28,11,147,142,5
28,151,28,33,0,202,-202
28,151,28,49,65,107,-42
28,151,28,125,78,0,78
28,151,28,133,154,75,79
28,151,47,157,143,329,-186
28,151,48,113,86,111,-25
28,151,48,439,0,89,-89
28,153,28,23,112,89,23
28,153,28,35,66,83,-17
28,153,28,41,103,140,-37
28,153,28,67,138,243,-105
28,155,28,19,82,90,-8
28,155,28,105,150,196,-46
28,157,22,33,75,87,-12
28,159,28,19,70,83,-13
28,159,28,99,97,112,-15
28,159,28,105,108,94,14
28,161,28,33,60,0,60
28,161,28,43,119,119,0
28,161,28,71,212,218,-6
28,161,28,107,83,83,0
28,163,28,49,187,234,-47
28,163,28,89,160,227,-67
28,163,28,121,74,68,6
29,1,29,19,68,80,-12
29,1,29,95,0,68,-68
29,1,29,121,147,141,6
29,1,29,197,92,123,-31
29,1,29,211,92,0,92
29,3,29,21,1068,746,322
29,3,29,47,0,58,-58
29,3,29,95,0,66,-66
29,3,29,165,0,69,-69
29,7,29,19,297,300,-3
29,7,29,27,243,199,44
29,7,29,51,0,68,-68
29,7,29,139,67,59,8
29,7,29,163,80,85,-5
29,7,29,173,59,0,59
29,9,5,7,261,189,72
29,9,5,15,77,0,77
29,9,5,143,63,47,16
29,9,29,43,72,0,72
29,9,29,77,169,240,-71
29,9,29,97,119,82,37
29,9,29,109,732,894,-162
29,9,29,119,111,0,111
29,9,29,145,151,163,-12
29,9,29,209,181,117,64
29,11,20,37,0,68,-68
29,11,29,97,150,174,-24
29,11,29,217,67,88,-21
29,13,29,37,284,279,5
29,13,29,95,170,124,46
29,13,29,217,76,92,-16
29,15,20,91,68,0,68
29,15,29,37,94,0,94
29,15,29,47,61,0,61
29,15,29,83,112,145,-33
29,15,29,95,238,95,143
29,15,29,101,76,0,76
29,15,29,159,253,234,19
29,17,29,31,300,313,-13
29,17,29,201,0,84,-84
29,17,29,207,84,60,24
29,17,29,223,76,0,76
29,19,4,13,123,134,-11
29,19,6,37,80,56,24
29,19,6,73,0,48,-48
29,19,8,5,0,64,-64
29,19,8,13,0,48,-48
29,19,8,31,0,85,-85
29,19,8,41,0,63,-63
29,19,17,31,214,292,-78
29,19,17,43,63,75,-12
29,19,17,97,71,48,23
29,19,17,113,54,0,54
29,19,17,119,0,49,-49
29,19,17,163,0,58,-58
29,19,19,153,0,55,-55
29,19,20,91,110,221,-111
29,19,27,53,0,56,-56
29,19,29,1,80,68,12
29,19,29,7,300,297,3
29,19,29,27,693,693,0
29,19,29,29,94,107,-13
29,19,29,31,70,0,70
29,19,29,43,0,65,-65
29,19,29,47,121,172,-51
29,19,29,51,613,499,114
29,19,29,53,324,242,82
29,19,29,71,59,64,-5
29,19,29,77,185,185,0
29,19,29,89,201,210,-9
29,19,29,95,331,681,-350
29,19,29,99,50,58,-8
29,19,29,101,71,0,71
29,19,29,121,115,0,115
29,19,29,127,72,0,72
29,19,29,131,68,0,68
29,19,29,135,72,66,6
29,19,29,137,114,0,114
29,19,29,141,0,72,-72
29,19,29,159,123,73,50
29,19,29,161,127,63,64
29,19,29,165,54,95,-41
29,19,29,175,412,367,45
29,19,29,183,229,331,-102
29,19,29,189,544,622,-78
29,19,29,195,82,58,24
29,19,29,510,188,240,-52
29,19,32,3,0,99,-99
29,19,47,157,72,0,72
29,19,48,113,0,94,-94
29,19,48,121,55,0,55
29,19,48,201,74,75,-1
29,19,48,439,0,63,-63
29,19,48,453,0,57,-57
29,19,53,33,0,55,-55
29,21,4,13,55,0,55
29,21,12,86,44,0,44
29,21,19,179,0,139,-139
29,21,20,5,81,105,-24
29,21,20,43,192,182,10
29,21,20,91,62,149,-87
29,21,20,209,65,82,-17
29,21,29,3,746,1068,-322
29,21,29,47,247,442,-195
29,21,29,49,159,200,-41
29,21,29,63,154,174,-20
29,21,29,77,71,0,71
29,21,29,87,61,0,61
29,21,29,95,289,444,-155
29,21,29,147,118,109,9
29,21,29,165,284,379,-95
29,23,29,31,73,134,-61
29,23,29,35,138,125,13
29,23,29,69,150,89,61
29,23,29,77,0,57,-57
29,23,29,181,316,213,103
29,23,29,189,0,56,-56
29,23,29,201,57,64,-7
29,23,29,207,237,245,-8
29,23,29,223,214,153,61
29,23,29,510,49,0,49
29,25,29,47,91,109,-18
29,25,29,49,135,85,50
29,25,29,61,0,81,-81
29,25,29,63,0,61,-61
29,25,29,117,59,0,59
29,27,29,7,199,243,-44
29,27,29,19,693,693,0
29,27,29,51,839,863,-24
29,27,29,95,0,56,-56
29,27,29,139,76,64,12
29,27,29,189,78,84,-6
29,29,12,71,0,55,-55
29,29,20,91,103,82,21
29,29,29,19,107,94,13
29,29,29,47,116,85,31
29,29,29,51,119,120,-1
29,29,29,77,142,161,-19
29,29,29,95,175,145,30
29,29,29,99,72,0,72
29,29,29,105,199,226,-27
29,29,29,131,492,717,-225
29,29,29,141,256,240,16
29,29,29,169,114,87,27
29,29,29,183,132,108,24
29,29,29,189,141,103,38
29,31,17,3,175,116,59
29,31,17,181,54,0,54
29,31,29,17,313,300,13
29,31,29,19,0,70,-70
29,31,29,23,134,73,61
29,31,29,77,0,67,-67
29,31,29,99,95,139,-44
29,31,29,133,62,59,3
29,31,29,143,90,61,29
29,31,29,157,234,184,50
29,31,29,183,90,136,-46
29,31,29,187,75,102,-27
29,31,29,189,172,309,-137
29,31,29,201,828,709,119
29,31,29,207,171,123,48
29,31,29,510,76,106,-30
29,33,29,117,63,67,-4
29,35,29,23,125,138,-13
29,37,4,13,71,0,71
29,37,20,45,49,0,49
29,37,20,91,1069,761,308
29,37,20,121,104,127,-23
29,37,20,209,143,89,54
29,37,29,13,279,284,-5
29,37,29,15,0,94,-94
29,37,29,47,243,312,-69
29,37,29,77,93,70,23
29,37,29,83,154,200,-46
29,37,29,95,4342,3241,1101
29,37,29,101,261,290,-29
29,37,29,165,123,110,13
29,39,29,77,69,74,-5
29,39,29,167,143,89,54
29,39,29,217,197,196,1
29,41,29,115,78,75,3
29,41,29,175,87,57,30
29,43,20,91,0,61,-61
29,43,29,9,0,72,-72
29,43,29,19,65,0,65
29,43,29,59,0,64,-64
29,43,29,67,90,79,11
29,43,29,77,4452,3526,926
29,43,29,91,86,0,86
29,43,29,95,89,96,-7
29,43,29,97,78,92,-14
29,43,29,105,72,0,72
29,43,29,109,150,209,-59
29,43,29,167,78,109,-31
29,43,29,189,0,66,-66
29,43,29,209,413,544,-131
29,43,29,213,597,341,256
29,43,29,225,315,267,48
29,45,19,111,67,110,-43
29,45,29,111,0,187,-187
29,45,29,199,95,0,95
29,47,4,13,157,191,-34
29,47,6,37,69,51,18
29,47,6,73,67,0,67
29,47,8,41,79,114,-35
29,47,12,103,0,56,-56
29,47,17,31,95,98,-3
29,47,19,153,67,89,-22
29,47,20,45,120,54,66
29,47,20,91,1454,1444,10
29,47,20,103,187,151,36
29,47,20,173,148,113,35
29,47,20,177,113,70,43
29,47,20,209,816,602,214
29,47,29,3,58,0,58
29,47,29,15,0,61,-61
29,47,29,19,172,121,51
29,47,29,21,442,247,195
29,47,29,25,109,91,18
29,47,29,29,85,116,-31
29,47,29,37,312,243,69
29,47,29,49,578,653,-75
29,47,29,61,73,0,73
29,47,29,77,145,161,-16
29,47,29,83,62,0,62
29,47,29,95,6761,5195,1566
29,47,29,97,0,70,-70
29,47,29,101,110,82,28
29,47,29,107,84,84,0
29,47,29,117,61,53,8
29,47,29,147,109,0,109
29,47,29,159,0,61,-61
29,47,29,165,4703,4547,156
29,47,29,177,762,916,-154
29,47,29,183,99,53,46
29,47,29,189,146,104,42
29,47,31,55,103,89,14
29,47,32,3,56,0,56
29,47,40,109,81,0,81
29,47,48,113,0,74,-74
29,47,48,201,103,78,25
29,47,48,439,103,113,-10
29,49,29,21,200,159,41
29,49,29,25,85,135,-50
29,49,29,47,653,578,75
29,49,29,63,270,261,9
29,49,29,95,161,140,21
29,49,29,165,140,72,68
29,49,29,177,76,93,-17
29,51,17,31,65,71,-6
29,51,29,7,68,0,68
29,51,29,19,499,613,-114
29,51,29,27,863,839,24
29,51,29,29,120,119,1
29,51,29,77,99,115,-16
29,51,29,95,141,107,34
29,51,29,131,220,167,53
29,51,29,135,219,298,-79
29,51,29,151,193,249,-56
29,51,29,161,72,0,72
29,51,29,169,62,0,62
29,51,29,183,67,85,-18
29,51,29,189,171,254,-83
29,51,29,510,100,112,-12
29,53,29,19,242,324,-82
29,53,29,89,132,146,-14
29,53,29,135,72,77,-5
29,53,29,159,68,93,-25
29,55,29,71,557,565,-8
29,55,29,73,0,64,-64
29,55,29,99,0,46,-46
29,55,29,161,173,209,-36
29,55,29,189,101,92,9
29,57,29,77,137,167,-30
29,57,29,109,85,64,21
29,59,29,43,64,0,64
29,59,29,77,397,313,84
29,59,29,85,96,124,-28
29,59,29,105,152,95,57
29,59,29,167,139,148,-9
29,59,29,225,54,108,-54
29,61,29,25,81,0,81
29,61,29,47,0,73,-73
29,61,29,63,0,61,-61
29,61,29,79,0,76,-76
29,63,29,21,174,154,20
29,63,29,25,61,0,61
29,63,29,49,261,270,-9
29,63,29,61,61,0,61
29,65,29,161,138,219,-81
29,67,29,43,79,90,-11
29,67,29,77,114,116,-2
29,67,29,225,0,81,-81
29,67,29,229,136,141,-5
29,69,5,21,0,115,-115
29,69,5,31,0,80,-80
29,69,5,55,79,196,-117
29,69,5,93,97,70,27
29,69,29,23,89,150,-61
29,69,29,143,120,147,-27
29,69,29,155,182,109,73
29,69,29,207,155,173,-18
29,71,17,119,48,61,-13
29,71,17,163,57,0,57
29,71,29,19,64,59,5
29,71,29,55,565,557,8
29,71,29,73,317,339,-22
29,71,29,77,46,57,-11
29,71,29,99,805,656,149
29,71,29,113,82,0,82
29,71,29,161,80,103,-23
29,71,29,183,424,327,97
29,71,29,187,65,0,65
29,71,29,189,1298,1224,74
29,71,29,219,255,276,-21
29,71,29,221,136,118,18
29,71,29,510,197,190,7
29,73,29,55,64,0,64
29,73,29,71,339,317,22
29,73,29,125,53,82,-29
29,73,29,139,82,0,82
29,73,29,151,81,0,81
29,75,29,81,73,0,73
29,75,29,147,72,0,72
29,77,4,13,101,211,-110
29,77,5,7,144,175,-31
29,77,5,9,65,0,65
29,77,5,119,0,54,-54
29,77,5,143,85,169,-84
29,77,6,37,138,90,48
29,77,6,59,70,0,70
29,77,6,65,67,0,67
29,77,6,73,126,90,36
29,77,8,31,0,57,-57
29,77,8,41,83,74,9
29,77,8,59,0,69,-69
29,77,12,57,0,65,-65
29,77,12,95,0,65,-65
29,77,12,103,0,72,-72
29,77,17,31,67,80,-13
29,77,20,91,169,259,-90
29,77,20,173,71,87,-16
29,77,29,9,240,169,71
29,77,29,19,185,185,0
29,77,29,21,0,71,-71
29,77,29,23,57,0,57
29,77,29,29,161,142,19
29,77,29,31,67,0,67
29,77,29,37,70,93,-23
29,77,29,39,74,69,5
29,77,29,43,3526,4452,-926
29,77,29,47,161,145,16
29,77,29,51,115,99,16
29,77,29,57,167,137,30
29,77,29,59,313,397,-84
29,77,29,67,116,114,2
29,77,29,71,57,46,11
29,77,29,85,85,0,85
29,77,29,91,255,128,127
29,77,29,95,377,562,-185
29,77,29,97,403,336,67
29,77,29,99,68,73,-5
29,77,29,101,48,0,48
29,77,29,105,296,193,103
29,77,29,109,752,658,94
29,77,29,131,70,0,70
29,77,29,145,178,138,40
29,77,29,159,77,0,77
29,77,29,161,117,66,51
29,77,29,165,54,86,-32
29,77,29,167,726,785,-59
29,77,29,169,189,109,80
29,77,29,183,141,207,-66
29,77,29,189,329,393,-64
29,77,29,209,459,390,69
29,77,29,213,624,469,155
29,77,29,215,124,71,53
29,77,29,217,62,0,62
29,77,29,225,1226,1415,-189
29,77,29,229,176,147,29
29,77,29,510,114,143,-29
29,77,31,33,80,0,80
29,77,32,3,93,76,17
29,77,40,109,88,0,88
29,77,40,143,104,140,-36
29,77,47,157,63,0,63
29,77,48,29,0,60,-60
29,77,48,85,0,54,-54
29,77,48,113,70,76,-6
29,77,48,121,58,0,58
29,77,48,201,112,105,7
29,77,48,439,92,77,15
29,77,48,453,0,66,-66
29,77,53,33,0,69,-69
29,79,29,61,76,0,76
29,79,29,117,0,95,-95
29,81,29,75,0,73,-73
29,83,29,15,145,112,33
29,83,29,37,200,154,46
29,83,29,47,0,62,-62
29,83,29,95,214,164,50
29,83,29,101,218,143,75
29,83,29,159,96,129,-33
29,83,29,185,89,73,16
29,85,29,59,124,96,28
29,85,29,77,0,85,-85
29,85,29,95,59,0,59
29,85,29,167,130,152,-22
29,87,29,21,0,61,-61
29,89,29,19,210,201,9
29,89,29,53,146,132,14
29,89,29,175,0,64,-64
29,91,29,43,0,86,-86
29,91,29,77,128,255,-127
29,91,29,149,218,151,67
29,91,29,153,144,84,60
29,91,29,203,188,113,75
29,91,29,215,211,183,28
29,91,29,229,93,0,93
29,93,29,123,86,62,24
29,93,29,187,217,226,-9
29,95,4,13,380,587,-207
29,95,4,19,55,73,-18
29,95,5,7,98,122,-24
29,95,5,119,58,62,-4
29,95,5,143,66,75,-9
29,95,6,37,417,406,11
29,95,6,59,106,125,-19
29,95,6,65,112,89,23
29,95,6,67,79,0,79
29,95,6,71,77,0,77
29,95,6,73,287,245,42
29,95,6,75,0,56,-56
29,95,6,85,84,74,10
29,95,8,1,84,51,33
29,95,8,5,145,122,23
29,95,8,31,176,288,-112
29,95,8,35,0,62,-62
29,95,8,41,130,157,-27
29,95,8,59,102,60,42
29,95,8,69,56,68,-12
29,95,11,1,62,92,-30
29,95,12,9,0,81,-81
29,95,12,11,77,84,-7
29,95,12,31,75,80,-5
29,95,12,57,94,150,-56
29,95,12,71,56,70,-14
29,95,12,86,142,118,24
29,95,12,95,59,116,-57
29,95,12,99,0,58,-58
29,95,12,103,65,133,-68
29,95,13,67,66,56,10
29,95,13,89,0,56,-56
29,95,13,121,58,95,-37
29,95,15,3,83,0,83
29,95,17,31,410,429,-19
29,95,17,43,54,65,-11
29,95,17,97,57,0,57
29,95,18,97,0,71,-71
29,95,19,113,65,0,65
29,95,19,153,154,136,18
29,95,20,5,59,0,59
29,95,20,37,66,0,66
29,95,20,45,591,378,213
29,95,20,59,67,64,3
29,95,20,61,62,0,62
29,95,20,91,8596,8991,-395
29,95,20,103,293,268,25
29,95,20,111,78,0,78
29,95,20,121,106,132,-26
29,95,20,155,63,0,63
29,95,20,161,209,61,148
29,95,20,169,64,0,64
29,95,20,173,480,261,219
29,95,20,177,369,244,125
29,95,20,209,3003,2885,118
29,95,21,111,0,65,-65
29,95,25,17,0,49,-49
29,95,26,125,80,0,80
29,95,26,163,63,51,12
29,95,27,53,123,207,-84
29,95,27,123,48,0,48
29,95,29,1,68,0,68
29,95,29,3,66,0,66
29,95,29,13,124,170,-46
29,95,29,15,95,238,-143
29,95,29,19,681,331,350
29,95,29,21,444,289,155
29,95,29,27,56,0,56
29,95,29,29,145,175,-30
29,95,29,37,3241,4342,-1101
29,95,29,43,96,89,7
29,95,29,47,5195,6761,-1566
29,95,29,49,140,161,-21
29,95,29,51,107,141,-34
29,95,29,77,562,377,185
29,95,29,83,164,214,-50
29,95,29,85,0,59,-59
29,95,29,97,190,122,68
29,95,29,99,60,61,-1
29,95,29,101,919,979,-60
29,95,29,107,856,1076,-220
29,95,29,141,54,101,-47
29,95,29,145,71,0,71
29,95,29,147,80,70,10
29,95,29,159,265,128,137
29,95,29,161,59,0,59
29,95,29,165,1627,1947,-320
29,95,29,167,0,60,-60
29,95,29,177,231,260,-29
29,95,29,183,239,223,16
29,95,29,185,0,64,-64
29,95,29,189,492,455,37
29,95,29,195,114,72,42
29,95,29,209,0,77,-77
29,95,29,213,58,56,2
29,95,29,217,0,56,-56
29,95,29,510,231,233,-2
29,95,31,55,283,207,76
29,95,31,109,109,95,14
29,95,31,153,81,0,81
29,95,32,3,197,273,-76
29,95,34,17,52,0,52
29,95,35,1,0,90,-90
29,95,36,47,96,99,-3
29,95,36,61,65,96,-31
29,95,37,119,61,49,12
29,95,39,49,0,70,-70
29,95,39,61,0,46,-46
29,95,40,109,126,142,-16
29,95,40,143,212,188,24
29,95,41,51,54,94,-40
29,95,42,3,0,47,-47
29,95,42,101,0,53,-53
29,95,47,37,65,81,-16
29,95,47,157,104,76,28
29,95,48,29,124,176,-52
29,95,48,85,84,195,-111
29,95,48,113,261,365,-104
29,95,48,121,100,137,-37
29,95,48,201,355,355,0
29,95,48,439,207,292,-85
29,95,48,453,156,182,-26
29,95,49,35,74,73,1
29,95,51,59,63,63,0
29,95,53,33,121,242,-121
29,95,53,53,73,71,2
29,95,55,79,0,73,-73
29,97,5,7,124,227,-103
29,97,5,143,82,123,-41
29,97,6,37,67,0,67
29,97,20,21,409,376,33
29,97,20,37,270,186,84
29,97,20,91,72,118,-46
29,97,20,99,110,0,110
29,97,20,173,70,66,4
29,97,29,9,82,119,-37
29,97,29,11,174,150,24
29,97,29,43,92,78,14
29,97,29,47,70,0,70
29,97,29,77,336,403,-67
29,97,29,95,122,190,-68
29,97,29,109,230,198,32
29,97,29,119,124,106,18
29,97,29,145,2226,2414,-188
29,97,29,189,0,62,-62
29,97,29,213,0,55,-55
29,97,29,217,84,80,4
29,97,40,41,101,137,-36
29,97,40,115,196,207,-11
29,97,40,143,128,134,-6
29,99,17,119,243,177,66
29,99,17,133,127,108,19
29,99,17,163,301,254,47
29,99,29,19,58,50,8
29,99,29,29,0,72,-72
29,99,29,31,139,95,44
29,99,29,55,46,0,46
29,99,29,71,656,805,-149
29,99,29,77,73,68,5
29,99,29,95,61,60,1
29,99,29,113,63,63,0
29,99,29,161,90,0,90
29,99,29,183,679,870,-191
29,99,29,186,257,220,37
29,99,29,187,551,803,-252
29,99,29,189,6681,5360,1321
29,99,29,219,68,61,7
29,99,29,221,294,268,26
29,99,29,510,1537,902,635
29,101,20,91,104,120,-16
29,101,29,15,0,76,-76
29,101,29,19,0,71,-71
29,101,29,37,290,261,29
29,101,29,47,82,110,-28
29,101,29,77,0,48,-48
29,101,29,83,143,218,-75
29,101,29,95,979,919,60
29,101,29,107,232,194,38
29,101,29,159,336,262,74
29,101,29,165,0,58,-58
29,101,29,189,0,76,-76
29,101,32,3,0,73,-73
29,101,48,29,0,68,-68
29,103,29,199,131,0,131
29,105,29,29,226,199,27
29,105,29,43,0,72,-72
29,105,29,59,95,152,-57
29,105,29,77,193,296,-103
29,105,29,169,243,183,60
29,105,29,225,135,131,4
29,105,29,229,102,70,32
29,107,29,47,84,84,0
29,107,29,95,1076,856,220
29,107,29,101,194,232,-38
29,107,29,159,52,0,52
29,107,29,177,114,79,35
29,107,29,195,143,103,40
29,109,29,9,894,732,162
29,109,29,43,209,150,59
29,109,29,57,64,85,-21
29,109,29,77,658,752,-94
29,109,29,97,198,230,-32
29,109,29,145,158,185,-27
29,109,29,209,124,106,18
29,109,29,213,56,0,56
29,111,17,1,139,117,22
29,111,29,45,187,0,187
29,111,29,127,56,105,-49
29,113,17,119,65,0,65
29,113,29,71,0,82,-82
29,113,29,99,63,63,0
29,113,29,163,209,187,22
29,113,29,183,2698,1538,1160
29,113,29,189,662,315,347
29,113,29,219,352,384,-32
29,113,29,510,64,63,1
29,115,29,41,75,78,-3
29,115,29,117,82,54,28
29,117,29,25,0,59,-59
29,117,29,33,67,63,4
29,117,29,47,53,61,-8
29,117,29,79,95,0,95
29,117,29,115,54,82,-28
29,119,5,7,522,331,191
29,119,5,143,89,69,20
29,119,29,9,0,111,-111
29,119,29,97,106,124,-18
29,119,29,145,352,505,-153
29,119,40,41,125,97,28
29,121,29,1,141,147,-6
29,121,29,19,0,115,-115
29,121,29,175,111,98,13
29,121,29,205,0,61,-61
29,123,29,93,62,86,-24
29,123,29,187,213,249,-36
29,125,29,73,82,53,29
29,125,29,151,0,154,-154
29,125,29,161,145,166,-21
29,125,29,169,66,72,-6
29,127,17,1,286,198,88
29,127,29,19,0,72,-72
29,127,29,111,105,56,49
29,127,29,137,128,166,-38
29,127,29,163,77,69,8
29,127,29,173,425,409,16
29,127,29,189,0,64,-64
29,131,29,19,0,68,-68
29,131,29,29,717,492,225
29,131,29,51,167,220,-53
29,131,29,77,0,70,-70
29,131,29,141,214,186,28
29,131,29,169,74,0,74
29,133,29,31,59,62,-3
29,133,29,143,57,66,-9
29,133,29,201,222,307,-85
29,135,29,19,66,72,-6
29,135,29,51,298,219,79
29,135,29,53,77,72,5
29,135,29,141,84,117,-33
29,137,29,19,0,114,-114
29,137,29,127,166,128,38
29,137,29,173,79,0,79
29,137,29,175,89,86,3
29,139,29,7,59,67,-8
29,139,29,27,64,76,-12
29,139,29,73,0,82,-82
29,139,29,183,112,65,47
29,139,29,219,198,147,51
29,141,29,19,72,0,72
29,141,29,29,240,256,-16
29,141,29,95,101,54,47
29,141,29,131,186,214,-28
29,141,29,135,117,84,33
29,141,29,159,108,100,8
29,143,29,31,61,90,-29
29,143,29,69,147,120,27
29,143,29,133,66,57,9
29,143,29,155,81,77,4
29,143,29,201,442,482,-40
29,143,29,207,83,108,-25
29,145,5,7,107,130,-23
29,145,20,21,117,123,-6
29,145,29,9,163,151,12
29,145,29,77,138,178,-40
29,145,29,95,0,71,-71
29,145,29,97,2414,2226,188
29,145,29,109,185,158,27
29,145,29,119,505,352,153
29,145,40,41,0,67,-67
29,145,40,115,132,109,23
29,147,29,21,109,118,-9
29,147,29,47,0,109,-109
29,147,29,75,0,72,-72
29,147,29,95,70,80,-10
29,147,29,165,0,57,-57
29,149,5,49,0,81,-81
29,149,29,91,151,218,-67
29,151,29,51,249,193,56
29,151,29,73,0,81,-81
29,151,29,125,154,0,154
29,153,5,5,0,105,-105
29,153,29,91,84,144,-60
29,155,5,31,0,113,-113
29,155,5,93,101,165,-64
29,155,29,69,109,182,-73
29,155,29,143,77,81,-4
29,155,47,45,0,71,-71
29,157,17,157,84,57,27
29,157,29,31,184,234,-50
29,157,29,186,89,158,-69
29,157,29,187,0,69,-69
29,159,29,15,234,253,-19
29,159,29,19,73,123,-50
29,159,29,47,61,0,61
29,159,29,53,93,68,25
29,159,29,77,0,77,-77
29,159,29,83,129,96,33
29,159,29,95,128,265,-137
29,159,29,101,262,336,-74
29,159,29,107,0,52,-52
29,159,29,141,100,108,-8
29,159,29,195,111,164,-53
29,161,29,19,63,127,-64
29,161,29,51,0,72,-72
29,161,29,55,209,173,36
29,161,29,65,219,138,81
29,161,29,71,103,80,23
29,161,29,77,66,117,-51
29,161,29,95,0,59,-59
29,161,29,99,0,90,-90
29,161,29,125,166,145,21
29,161,29,169,188,193,-5
29,161,29,183,0,90,-90
29,161,29,189,93,184,-91
29,161,29,215,83,97,-14
29,163,17,149,65,0,65
29,163,29,7,85,80,5
29,163,29,113,187,209,-22
29,163,29,127,69,77,-8
29,163,29,183,66,53,13
29,163,29,189,0,55,-55
29,165,4,13,64,102,-38
29,165,6,37,55,0,55
29,165,17,31,64,0,64
29,165,20,5,59,0,59
29,165,20,45,64,0,64
29,165,20,91,1015,825,190
29,165,20,103,275,288,-13
29,165,20,173,89,55,34
29,165,20,177,70,0,70
29,165,20,209,579,399,180
29,165,29,3,69,0,69
29,165,29,19,95,54,41
29,165,29,21,379,284,95
29,165,29,37,110,123,-13
29,165,29,47,4547,4703,-156
29,165,29,49,72,140,-68
29,165,29,77,86,54,32
29,165,29,95,1947,1627,320
29,165,29,101,58,0,58
29,165,29,147,57,0,57
29,165,29,189,69,82,-13
29,165,31,55,59,58,1
29,165,48,439,0,86,-86
29,167,29,39,89,143,-54
29,167,29,43,109,78,31
29,167,29,59,148,139,9
29,167,29,77,785,726,59
29,167,29,85,152,130,22
29,167,29,95,60,0,60
29,169,6,73,97,96,1
29,169,8,41,217,195,22
29,169,13,179,127,0,127
29,169,15,3,273,295,-22
29,169,20,61,96,113,-17
29,169,20,103,0,99,-99
29,169,21,93,73,0,73
29,169,22,115,123,0,123
29,169,29,29,87,114,-27
29,169,29,51,0,62,-62
29,169,29,77,109,189,-80
29,169,29,105,183,243,-60
29,169,29,125,72,66,6
29,169,29,131,0,74,-74
29,169,29,161,193,188,5
29,169,29,189,0,64,-64
29,169,29,215,69,70,-1
29,169,36,45,160,77,83
29,169,37,51,209,154,55
29,169,37,133,0,90,-90
29,169,47,125,211,132,79
29,169,48,27,273,253,20
29,169,48,29,127,139,-12
29,169,48,99,99,0,99
29,169,48,141,175,182,-7
29,169,51,59,101,122,-21
29,169,53,53,239,144,95
29,169,53,67,111,105,6
29,171,29,211,0,55,-55
29,173,29,7,0,59,-59
29,173,29,127,409,425,-16
29,173,29,137,0,79,-79
29,175,29,19,367,412,-45
29,175,29,41,57,87,-30
29,175,29,89,64,0,64
29,175,29,121,98,111,-13
29,175,29,137,86,89,-3
29,177,29,47,916,762,154
29,177,29,49,93,76,17
29,177,29,95,260,231,29
29,177,29,107,79,114,-35
29,181,29,23,213,316,-103
29,183,4,13,141,290,-149
29,183,6,37,146,127,19
29,183,6,59,76,64,12
29,183,6,73,103,91,12
29,183,8,31,0,73,-73
29,183,8,41,75,55,20
29,183,12,9,0,75,-75
29,183,12,11,0,55,-55
29,183,12,21,0,74,-74
29,183,12,57,0,129,-129
29,183,12,71,56,103,-47
29,183,12,103,56,122,-66
29,183,12,105,0,57,-57
29,183,17,1,95,0,95
29,183,17,31,215,179,36
29,183,17,43,0,78,-78
29,183,17,113,59,0,59
29,183,17,119,600,431,169
29,183,17,133,74,0,74
29,183,17,163,321,173,148
29,183,17,167,69,0,69
29,183,20,91,110,163,-53
29,183,20,173,67,0,67
29,183,29,19,331,229,102
29,183,29,29,108,132,-24
29,183,29,31,136,90,46
29,183,29,47,53,99,-46
29,183,29,51,85,67,18
29,183,29,71,327,424,-97
29,183,29,77,207,141,66
29,183,29,95,223,239,-16
29,183,29,99,870,679,191
29,183,29,113,1538,2698,-1160
29,183,29,139,65,112,-47
29,183,29,161,90,0,90
29,183,29,163,53,66,-13
29,183,29,187,104,85,19
29,183,29,189,12044,7450,4594
29,183,29,219,895,1542,-647
29,183,29,510,1496,1388,108
29,183,32,3,82,57,25
29,183,47,157,75,0,75
29,183,48,85,0,120,-120
29,183,48,113,88,126,-38
29,183,48,121,0,85,-85
29,183,48,201,129,158,-29
29,183,48,439,99,126,-27
29,183,48,453,0,51,-51
29,183,53,33,0,119,-119
29,185,29,83,73,89,-16
29,185,29,95,64,0,64
29,186,29,99,220,257,-37
29,186,29,157,158,89,69
29,186,29,187,274,326,-52
29,186,29,189,114,95,19
29,187,29,31,102,75,27
29,187,29,71,0,65,-65
29,187,29,93,226,217,9
29,187,29,99,803,551,252
29,187,29,123,249,213,36
29,187,29,157,69,0,69
29,187,29,183,85,104,-19
29,187,29,186,326,274,52
29,187,29,189,256,233,23
29,187,29,221,554,442,112
29,187,29,510,78,66,12
29,189,1,73,73,0,73
29,189,1,89,0,60,-60
29,189,4,13,411,736,-325
29,189,4,19,98,108,-10
29,189,5,7,93,131,-38
29,189,5,119,103,72,31
29,189,6,1,99,128,-29
29,189,6,13,56,85,-29
29,189,6,37,588,544,44
29,189,6,59,175,222,-47
29,189,6,65,82,72,10
29,189,6,67,87,60,27
29,189,6,71,0,62,-62
29,189,6,73,292,251,41
29,189,6,75,55,92,-37
29,189,6,81,0,78,-78
29,189,6,85,101,169,-68
29,189,8,1,0,54,-54
29,189,8,5,115,252,-137
29,189,8,13,0,74,-74
29,189,8,31,197,285,-88
29,189,8,35,70,102,-32
29,189,8,41,100,134,-34
29,189,8,59,55,123,-68
29,189,8,69,0,99,-99
29,189,9,1,81,0,81
29,189,11,1,82,93,-11
29,189,12,9,0,131,-131
29,189,12,11,132,182,-50
29,189,12,21,79,170,-91
29,189,12,31,97,132,-35
29,189,12,33,0,63,-63
29,189,12,57,176,243,-67
29,189,12,71,129,249,-120
29,189,12,81,0,104,-104
29,189,12,86,113,94,19
29,189,12,95,99,155,-56
29,189,12,99,153,140,13
29,189,12,101,0,78,-78
29,189,12,103,143,232,-89
29,189,12,105,0,68,-68
29,189,12,115,0,137,-137
29,189,13,67,133,132,1
29,189,13,89,112,163,-51
29,189,13,121,152,238,-86
29,189,13,135,84,156,-72
29,189,15,3,96,119,-23
29,189,16,1,0,55,-55
29,189,17,1,57,0,57
29,189,17,19,113,0,113
29,189,17,27,0,54,-54
29,189,17,31,897,855,42
29,189,17,43,168,165,3
29,189,17,77,91,0,91
29,189,17,83,65,58,7
29,189,17,89,86,0,86
29,189,17,97,107,105,2
29,189,17,113,89,0,89
29,189,17,115,58,0,58
29,189,17,119,1380,1367,13
29,189,17,133,304,381,-77
29,189,17,143,99,0,99
29,189,17,163,1672,1426,246
29,189,17,167,200,107,93
29,189,17,179,59,0,59
29,189,17,197,107,87,20
29,189,17,199,74,0,74
29,189,18,57,68,91,-23
29,189,18,97,124,121,3
29,189,18,163,80,0,80
29,189,19,103,59,0,59
29,189,19,153,78,59,19
29,189,20,91,262,456,-194
29,189,20,173,75,67,8
29,189,21,67,59,0,59
29,189,21,111,133,111,22
29,189,24,5,66,0,66
29,189,24,31,106,90,16
29,189,24,33,0,46,-46
29,189,25,17,109,143,-34
29,189,25,21,0,61,-61
29,189,25,25,0,74,-74
29,189,26,81,0,74,-74
29,189,26,125,106,129,-23
29,189,26,161,0,90,-90
29,189,26,163,91,75,16
29,189,27,37,0,64,-64
29,189,27,53,163,205,-42
29,189,29,19,622,544,78
29,189,29,23,56,0,56
29,189,29,27,84,78,6
29,189,29,29,103,141,-38
29,189,29,31,309,172,137
29,189,29,43,66,0,66
29,189,29,47,104,146,-42
29,189,29,51,254,171,83
29,189,29,55,92,101,-9
29,189,29,71,1224,1298,-74
29,189,29,77,393,329,64
29,189,29,95,455,492,-37
29,189,29,97,62,0,62
29,189,29,99,5360,6681,-1321
29,189,29,101,76,0,76
29,189,29,113,315,662,-347
29,189,29,127,64,0,64
29,189,29,161,184,93,91
29,189,29,163,55,0,55
29,189,29,165,82,69,13
29,189,29,169,64,0,64
29,189,29,183,7450,12044,-4594
29,189,29,186,95,114,-19
29,189,29,187,233,256,-23
29,189,29,201,52,58,-6
29,189,29,209,0,63,-63
29,189,29,219,191,431,-240
29,189,29,221,72,84,-12
29,189,29,510,22731,16235,6496
29,189,31,55,108,99,9
29,189,32,3,163,216,-53
29,189,34,17,69,51,18
29,189,34,23,100,80,20
29,189,36,47,116,79,37
29,189,36,61,205,210,-5
29,189,36,81,62,0,62
29,189,37,119,134,224,-90
29,189,37,183,80,152,-72
29,189,39,35,105,94,11
29,189,39,49,122,190,-68
29,189,39,61,111,80,31
29,189,39,113,90,0,90
29,189,40,109,113,80,33
29,189,40,143,93,79,14
29,189,41,51,0,77,-77
29,189,42,3,77,88,-11
29,189,42,101,97,75,22
29,189,47,37,167,179,-12
29,189,47,125,59,0,59
29,189,47,149,0,50,-50
29,189,47,157,219,165,54
29,189,47,187,0,103,-103
29,189,48,29,178,145,33
29,189,48,85,151,403,-252
29,189,48,113,311,554,-243
29,189,48,121,124,177,-53
29,189,48,141,0,66,-66
29,189,48,157,0,115,-115
29,189,48,201,363,473,-110
29,189,48,339,0,68,-68
29,189,48,439,179,395,-216
29,189,48,453,219,187,32
29,189,48,491,0,95,-95
29,189,49,35,79,97,-18
29,189,51,59,159,123,36
29,189,51,107,0,95,-95
29,189,53,33,183,371,-188
29,189,53,53,0,95,-95
29,189,53,61,60,71,-11
29,189,55,25,83,88,-5
29,189,55,79,88,97,-9
29,195,29,19,58,82,-24
29,195,29,95,72,114,-42
29,195,29,107,103,143,-40
29,195,29,159,164,111,53
29,197,29,1,123,92,31
29,199,19,177,86,0,86
29,199,29,45,0,95,-95
29,199,29,103,0,131,-131
29,201,29,17,84,0,84
29,201,29,23,64,57,7
29,201,29,31,709,828,-119
29,201,29,133,307,222,85
29,201,29,143,482,442,40
29,201,29,189,58,52,6
29,201,29,207,231,253,-22
29,203,29,91,113,188,-75
29,205,29,121,61,0,61
29,207,29,17,60,84,-24
29,207,29,23,245,237,8
29,207,29,31,123,171,-48
29,207,29,69,173,155,18
29,207,29,143,108,83,25
29,207,29,201,253,231,22
29,207,29,223,71,0,71
29,209,29,9,117,181,-64
29,209,29,43,544,413,131
29,209,29,77,390,459,-69
29,209,29,95,77,0,77
29,209,29,109,106,124,-18
29,209,29,189,63,0,63
29,209,29,213,604,622,-18
29,211,29,1,0,92,-92
29,211,29,171,55,0,55
29,213,4,13,0,67,-67
29,213,5,7,0,56,-56
29,213,5,9,161,211,-50
29,213,29,43,341,597,-256
29,213,29,77,469,624,-155
29,213,29,95,56,58,-2
29,213,29,97,55,0,55
29,213,29,109,0,56,-56
29,213,29,209,622,604,18
29,215,29,77,71,124,-53
29,215,29,91,183,211,-28
29,215,29,161,97,83,14
29,215,29,169,70,69,1
29,215,29,229,154,188,-34
29,217,20,11,100,71,29
29,217,29,11,88,67,21
29,217,29,13,92,76,16
29,217,29,39,196,197,-1
29,217,29,77,0,62,-62
29,217,29,95,56,0,56
29,217,29,97,80,84,-4
29,219,29,71,276,255,21
29,219,29,99,61,68,-7
29,219,29,113,384,352,32
29,219,29,139,147,198,-51
29,219,29,183,1542,895,647
29,219,29,189,431,191,240
29,219,29,510,0,48,-48
29,221,29,71,118,136,-18
29,221,29,99,268,294,-26
29,221,29,187,442,554,-112
29,221,29,189,84,72,12
29,223,29,17,0,76,-76
29,223,29,23,153,214,-61
29,223,29,207,0,71,-71
29,225,29,43,267,315,-48
29,225,29,59,108,54,54
29,225,29,67,81,0,81
29,225,29,77,1415,1226,189
29,225,29,105,131,135,-4
29,225,29,229,113,178,-65
29,229,29,67,141,136,5
29,229,29,77,147,176,-29
29,229,29,91,0,93,-93
29,229,29,105,70,102,-32
29,229,29,215,188,154,34
29,229,29,225,178,113,65
29,510,4,13,132,205,-73
29,510,6,1,0,75,-75
29,510,6,37,234,286,-52
29,510,6,59,49,53,-4
29,510,6,65,0,51,-51
29,510,6,73,120,155,-35
29,510,6,75,56,93,-37
29,510,6,85,58,79,-21
29,510,8,5,0,47,-47
29,510,8,31,94,181,-87
29,510,8,41,0,60,-60
29,510,8,59,0,51,-51
29,510,8,69,0,47,-47
29,510,11,1,99,80,19
29,510,12,11,0,60,-60
29,510,12,57,77,71,6
29,510,12,86,48,0,48
29,510,12,95,0,60,-60
29,510,12,103,0,46,-46
29,510,13,89,0,64,-64
29,510,13,121,69,131,-62
29,510,17,19,72,0,72
29,510,17,27,59,0,59
29,510,17,31,497,505,-8
29,510,17,43,70,61,9
29,510,17,77,73,0,73
29,510,17,119,727,820,-93
29,510,17,133,119,135,-16
29,510,17,163,1187,1166,21
29,510,17,167,151,100,51
29,510,18,97,100,112,-12
29,510,20,91,65,69,-4
29,510,21,111,72,53,19
29,510,24,31,0,56,-56
29,510,24,510,62,0,62
29,510,25,17,51,64,-13
29,510,25,25,59,61,-2
29,510,26,161,43,0,43
29,510,26,163,57,0,57
29,510,27,53,95,99,-4
29,510,29,19,240,188,52
29,510,29,23,0,49,-49
29,510,29,31,106,76,30
29,510,29,51,112,100,12
29,510,29,71,190,197,-7
29,510,29,77,143,114,29
29,510,29,95,233,231,2
29,510,29,99,902,1537,-635
29,510,29,113,63,64,-1
29,510,29,183,1388,1496,-108
29,510,29,187,66,78,-12
29,510,29,189,16235,22731,-6496
29,510,29,219,48,0,48
29,510,31,55,70,0,70
29,510,32,3,0,111,-111
29,510,36,47,72,80,-8
29,510,36,61,89,141,-52
29,510,37,119,0,75,-75
29,510,39,35,58,54,4
29,510,39,49,69,104,-35
29,510,39,61,52,84,-32
29,510,40,143,0,51,-51
29,510,41,51,0,62,-62
29,510,42,3,49,0,49
29,510,42,101,79,64,15
29,510,47,37,90,110,-20
29,510,47,157,111,104,7
29,510,48,29,54,75,-21
29,510,48,85,0,64,-64
29,510,48,113,139,236,-97
29,510,48,121,0,61,-61
29,510,48,201,145,247,-102
29,510,48,439,0,103,-103
29,510,48,453,91,70,21
29,510,51,59,0,58,-58
29,510,53,33,133,255,-122
29,510,55,25,55,0,55
29,510,55,79,63,90,-27
30,1,30,31,73,0,73
30,1,30,49,0,54,-54
30,3,30,111,211,246,-35
30,5,30,41,96,78,18
30,7,30,31,171,94,77
30,7,30,49,167,136,31
30,9,30,31,0,53,-53
30,9,30,111,320,329,-9
30,13,4,13,82,142,-60
30,13,6,83,89,0,89
30,13,8,41,65,60,5
30,13,30,15,99,75,24
30,13,30,27,62,0,62
30,13,30,29,102,126,-24
30,13,30,31,195,170,25
30,13,30,35,104,66,38
30,13,30,41,132,101,31
30,13,30,49,241,353,-112
30,13,30,63,227,278,-51
30,13,30,73,94,0,94
30,13,30,93,77,59,18
30,13,30,99,151,95,56
30,13,30,111,179,278,-99
30,13,32,3,113,92,21
30,13,38,101,0,70,-70
30,13,48,29,0,97,-97
30,13,53,33,49,0,49
30,13,53,63,0,95,-95
30,15,30,13,75,99,-24
30,17,30,111,69,137,-68
30,21,30,111,0,95,-95
30,23,30,31,0,59,-59
30,23,30,63,52,0,52
30,23,30,93,152,131,21
30,27,30,13,0,62,-62
30,27,30,31,58,57,1
30,27,30,111,85,121,-36
30,29,4,13,147,155,-8
30,29,6,37,74,0,74
30,29,6,59,64,0,64
30,29,6,65,83,0,83
30,29,6,73,144,59,85
30,29,8,41,73,0,73
30,29,16,1,0,80,-80
30,29,16,55,76,86,-10
30,29,30,13,126,102,24
30,29,30,31,260,259,1
30,29,30,41,0,56,-56
30,29,30,47,412,369,43
30,29,30,49,123,135,-12
30,29,30,53,275,280,-5
30,29,30,63,458,390,68
30,29,30,81,78,88,-10
30,29,30,93,48,48,0
30,29,30,111,205,129,76
30,29,32,3,84,75,9
30,29,38,105,0,61,-61
30,29,41,5,74,0,74
30,29,41,51,53,0,53
30,29,49,35,57,68,-11
30,29,53,33,195,95,100
30,29,53,53,98,69,29
30,29,53,61,93,0,93
30,29,53,63,122,170,-48
30,31,4,13,171,174,-3
30,31,4,19,0,52,-52
30,31,6,37,156,93,63
30,31,6,59,118,0,118
30,31,6,65,58,0,58
30,31,6,73,133,65,68
30,31,8,5,82,0,82
30,31,8,13,67,0,67
30,31,8,31,79,61,18
30,31,8,41,64,0,64
30,31,8,59,72,0,72
30,31,8,69,74,58,16
30,31,16,1,63,103,-40
30,31,16,55,0,56,-56
30,31,27,53,57,63,-6
30,31,30,1,0,73,-73
30,31,30,7,94,171,-77
30,31,30,9,53,0,53
30,31,30,13,170,195,-25
30,31,30,23,59,0,59
30,31,30,27,57,58,-1
30,31,30,29,259,260,-1
30,31,30,43,66,141,-75
30,31,30,47,46,50,-4
30,31,30,49,259,367,-108
30,31,30,57,93,314,-221
30,31,30,63,346,363,-17
30,31,30,67,381,501,-120
30,31,30,81,54,90,-36
30,31,30,93,104,160,-56
30,31,30,111,388,437,-49
30,31,32,3,96,114,-18
30,31,41,51,83,111,-28
30,31,48,201,65,0,65
30,31,49,35,77,82,-5
30,31,53,33,223,203,20
30,31,53,53,60,86,-26
30,31,53,61,61,62,-1
30,31,53,63,56,77,-21
30,31,56,39,88,0,88
30,35,30,13,66,104,-38
30,39,30,63,78,63,15
30,41,30,5,78,96,-18
30,41,30,13,101,132,-31
30,41,30,29,56,0,56
30,41,30,49,0,73,-73
30,41,30,63,0,61,-61
30,41,30,111,52,86,-34
30,43,30,31,141,66,75
30,43,30,49,427,396,31
30,43,30,57,69,0,69
30,43,30,93,108,104,4
30,47,30,29,369,412,-43
30,47,30,31,50,46,4
30,47,30,63,400,397,3
30,49,4,13,84,113,-29
30,49,16,1,0,65,-65
30,49,30,1,54,0,54
30,49,30,7,136,167,-31
30,49,30,13,353,241,112
30,49,30,29,135,123,12
30,49,30,31,367,259,108
30,49,30,41,73,0,73
30,49,30,43,396,427,-31
30,49,30,63,349,358,-9
30,49,30,77,63,0,63
30,49,30,81,51,53,-2
30,49,30,93,149,114,35
30,49,30,111,162,146,16
30,49,32,3,0,60,-60
30,49,49,35,0,61,-61
30,49,53,33,102,0,102
30,49,53,53,54,0,54
30,49,53,61,71,0,71
30,49,53,63,0,58,-58
30,53,30,29,280,275,5
30,53,30,63,59,44,15
30,53,53,63,0,65,-65
30,57,30,31,314,93,221
30,57,30,43,0,69,-69
30,61,30,63,156,120,36
30,63,4,13,136,180,-44
30,63,4,19,0,44,-44
30,63,6,37,125,58,67
30,63,6,59,77,0,77
30,63,6,65,59,0,59
30,63,6,73,110,63,47
30,63,16,1,74,120,-46
30,63,16,55,79,119,-40
30,63,17,31,51,0,51
30,63,27,53,59,0,59
30,63,30,13,278,227,51
30,63,30,23,0,52,-52
30,63,30,29,390,458,-68
30,63,30,31,363,346,17
30,63,30,39,63,78,-15
30,63,30,41,61,0,61
30,63,30,47,397,400,-3
30,63,30,49,358,349,9
30,63,30,53,44,59,-15
30,63,30,61,120,156,-36
30,63,30,81,910,1067,-157
30,63,30,89,109,79,30
30,63,30,93,171,154,17
30,63,30,111,318,264,54
30,63,32,3,80,99,-19
30,63,41,39,0,77,-77
30,63,41,51,91,123,-32
30,63,41,67,0,51,-51
30,63,49,35,71,77,-6
30,63,53,33,270,208,62
30,63,53,53,72,62,10
30,63,53,61,89,71,18
30,63,53,63,155,265,-110
30,65,30,111,149,187,-38
30,67,30,31,501,381,120
30,67,30,111,0,98,-98
30,73,30,13,0,94,-94
30,77,30,49,0,63,-63
30,81,4,13,0,78,-78
30,81,6,59,51,0,51
30,81,30,29,88,78,10
30,81,30,31,90,54,36
30,81,30,49,53,51,2
30,81,30,63,1067,910,157
30,81,30,111,67,0,67
30,81,53,33,69,0,69
30,81,53,63,0,57,-57
30,83,30,111,0,81,-81
30,83,38,53,0,76,-76
30,83,38,105,0,98,-98
30,87,30,111,107,173,-66
30,89,30,63,79,109,-30
30,93,30,13,59,77,-18
30,93,30,23,131,152,-21
30,93,30,29,48,48,0
30,93,30,31,160,104,56
30,93,30,43,104,108,-4
30,93,30,49,114,149,-35
30,93,30,63,154,171,-17
30,93,30,111,83,91,-8
30,95,30,111,282,294,-12
30,99,30,13,95,151,-56
30,105,30,111,0,64,-64
30,111,4,13,163,253,-90
30,111,4,19,0,81,-81
30,111,6,37,91,44,47
30,111,6,73,109,74,35
30,111,8,5,55,47,8
30,111,8,31,0,58,-58
30,111,8,59,61,0,61
30,111,16,1,50,93,-43
30,111,16,55,0,62,-62
30,111,30,3,246,211,35
30,111,30,9,329,320,9
30,111,30,13,278,179,99
30,111,30,17,137,69,68
30,111,30,21,95,0,95
30,111,30,27,121,85,36
30,111,30,29,129,205,-76
30,111,30,31,437,388,49
30,111,30,41,86,52,34
30,111,30,49,146,162,-16
30,111,30,63,264,318,-54
30,111,30,65,187,149,38
30,111,30,67,98,0,98
30,111,30,81,0,67,-67
30,111,30,83,81,0,81
30,111,30,87,173,107,66
30,111,30,93,91,83,8
30,111,30,95,294,282,12
30,111,30,105,64,0,64
30,111,32,3,131,133,-2
30,111,38,105,0,76,-76
30,111,48,201,0,87,-87
30,111,49,35,67,86,-19
30,111,53,33,118,93,25
30,111,53,53,65,80,-15
30,111,53,63,111,92,19
30,111,56,5,71,0,71
30,111,56,25,111,66,45
30,111,56,29,131,117,14
30,111,56,33,147,69,78
31,1,31,19,105,136,-31
31,1,31,35,115,155,-40
31,1,31,55,0,95,-95
31,1,31,79,266,307,-41
31,1,31,109,115,243,-128
31,1,31,181,96,62,34
31,3,31,119,106,85,21
31,13,31,157,69,72,-3
31,19,31,1,136,105,31
31,19,31,41,94,61,33
31,19,31,47,255,162,93
31,19,31,55,161,249,-88
31,19,31,79,279,200,79
31,19,31,99,216,228,-12
31,19,31,109,175,330,-155
31,19,31,111,86,105,-19
31,19,31,137,124,118,6
31,19,31,153,0,61,-61
31,19,31,163,91,0,91
31,21,31,53,67,0,67
31,21,31,55,70,62,8
31,21,31,177,72,63,9
31,23,31,109,93,103,-10
31,23,31,141,118,89,29
31,25,31,55,627,476,151
31,25,31,109,412,335,77
31,25,31,131,77,107,-30
31,25,31,153,665,557,108
31,25,31,155,74,61,13
31,27,31,119,0,65,-65
31,27,46,135,0,66,-66
31,33,8,75,99,0,99
31,33,29,77,0,80,-80
31,33,31,157,0,70,-70
31,35,31,1,155,115,40
31,37,31,53,0,74,-74
31,37,31,141,211,271,-60
31,39,31,53,0,62,-62
31,39,31,55,64,0,64
31,41,31,19,61,94,-33
31,41,31,109,0,54,-54
31,43,19,149,0,65,-65
31,43,19,193,711,879,-168
31,43,31,51,73,66,7
31,43,31,55,0,90,-90
31,43,31,173,66,0,66
31,43,46,127,0,75,-75
31,45,31,161,0,63,-63
31,47,31,19,162,255,-93
31,47,31,55,0,120,-120
31,47,31,79,95,76,19
31,47,31,109,0,100,-100
31,47,31,111,139,103,36
31,51,31,43,66,73,-7
31,51,31,179,69,76,-7
31,53,31,21,0,67,-67
31,53,31,37,74,0,74
31,53,31,39,62,0,62
31,53,31,55,554,636,-82
31,53,31,109,111,164,-53
31,53,31,153,63,140,-77
31,53,31,155,208,241,-33
31,53,31,177,117,174,-57
31,55,4,13,399,797,-398
31,55,4,19,63,93,-30
31,55,6,1,94,60,34
31,55,6,13,67,0,67
31,55,6,37,275,282,-7
31,55,6,59,107,123,-16
31,55,6,65,78,0,78
31,55,6,67,0,63,-63
31,55,6,71,0,68,-68
31,55,6,73,206,179,27
31,55,6,85,79,143,-64
31,55,8,1,105,103,2
31,55,8,5,224,153,71
31,55,8,13,0,95,-95
31,55,8,31,136,222,-86
31,55,8,35,92,108,-16
31,55,8,41,92,162,-70
31,55,8,59,85,116,-31
31,55,8,69,67,149,-82
31,55,8,123,0,62,-62
31,55,12,11,62,76,-14
31,55,12,57,72,109,-37
31,55,12,71,58,77,-19
31,55,12,86,52,0,52
31,55,12,95,0,99,-99
31,55,12,99,0,58,-58
31,55,12,103,45,83,-38
31,55,13,121,61,120,-59
31,55,15,3,80,0,80
31,55,17,31,367,338,29
31,55,17,43,57,102,-45
31,55,19,49,99,95,4
31,55,19,85,121,204,-83
31,55,19,103,76,74,2
31,55,19,113,86,84,2
31,55,19,129,105,204,-99
31,55,19,137,54,0,54
31,55,19,153,305,297,8
31,55,19,155,2035,1977,58
31,55,19,165,83,74,9
31,55,19,169,71,0,71
31,55,19,193,239,162,77
31,55,20,91,244,306,-62
31,55,20,173,101,57,44
31,55,20,177,48,0,48
31,55,21,111,0,52,-52
31,55,27,37,0,81,-81
31,55,27,53,177,251,-74
31,55,27,123,91,103,-12
31,55,29,47,89,103,-14
31,55,29,95,207,283,-76
31,55,29,165,58,59,-1
31,55,29,189,99,108,-9
31,55,29,510,0,70,-70
31,55,31,1,95,0,95
31,55,31,19,249,161,88
31,55,31,21,62,70,-8
31,55,31,25,476,627,-151
31,55,31,39,0,64,-64
31,55,31,43,90,0,90
31,55,31,47,120,0,120
31,55,31,53,636,554,82
31,55,31,67,49,0,49
31,55,31,79,315,194,121
31,55,31,89,61,0,61
31,55,31,109,2348,1411,937
31,55,31,111,141,90,51
31,55,31,119,244,92,152
31,55,31,131,116,76,40
31,55,31,141,218,107,111
31,55,31,153,8975,10824,-1849
31,55,31,155,303,481,-178
31,55,31,157,64,0,64
31,55,31,159,58,0,58
31,55,31,177,649,1022,-373
31,55,31,179,58,0,58
31,55,32,3,161,239,-78
31,55,35,1,76,0,76
31,55,36,47,0,53,-53
31,55,36,61,50,68,-18
31,55,36,81,59,0,59
31,55,37,119,78,98,-20
31,55,37,183,0,54,-54
31,55,39,49,89,84,5
31,55,40,109,73,77,-4
31,55,40,143,72,0,72
31,55,41,51,68,58,10
31,55,46,83,67,0,67
31,55,46,99,191,134,57
31,55,46,103,59,0,59
31,55,46,127,54,0,54
31,55,47,37,71,75,-4
31,55,47,157,55,61,-6
31,55,48,29,107,145,-38
31,55,48,85,97,171,-74
31,55,48,113,156,237,-81
31,55,48,121,97,109,-12
31,55,48,141,65,0,65
31,55,48,201,198,304,-106
31,55,48,439,192,188,4
31,55,48,453,104,130,-26
31,55,48,491,0,81,-81
31,55,49,35,91,121,-30
31,55,51,59,62,65,-3
31,55,53,33,216,205,11
31,55,53,53,67,76,-9
31,55,55,79,0,66,-66
31,59,31,185,62,0,62
31,67,31,55,0,49,-49
31,67,31,95,88,92,-4
31,67,31,109,428,387,41
31,67,31,151,0,76,-76
31,79,4,13,0,68,-68
31,79,12,86,163,100,63
31,79,31,1,307,266,41
31,79,31,19,200,279,-79
31,79,31,47,76,95,-19
31,79,31,55,194,315,-121
31,79,31,81,149,271,-122
31,79,31,93,158,200,-42
31,79,31,109,192,469,-277
31,79,31,121,183,224,-41
31,79,31,141,83,0,83
31,79,31,153,0,82,-82
31,81,31,79,271,149,122
31,81,31,109,0,76,-76
31,87,31,145,0,107,-107
31,89,31,55,0,61,-61
31,93,31,79,200,158,42
31,95,31,67,92,88,4
31,95,31,109,0,81,-81
31,95,31,169,0,58,-58
31,97,31,109,63,114,-51
31,99,31,19,228,216,12
31,99,31,137,0,58,-58
31,101,31,111,70,57,13
31,107,46,135,0,64,-64
31,109,4,13,230,393,-163
31,109,4,19,53,0,53
31,109,6,37,114,84,30
31,109,6,59,69,0,69
31,109,6,73,253,156,97
31,109,8,1,84,92,-8
31,109,8,5,114,66,48
31,109,8,13,0,51,-51
31,109,8,31,83,105,-22
31,109,8,41,0,115,-115
31,109,8,59,57,75,-18
31,109,8,69,78,111,-33
31,109,12,57,0,62,-62
31,109,17,31,111,148,-37
31,109,19,153,76,103,-27
31,109,19,155,73,73,0
31,109,20,91,147,165,-18
31,109,20,173,0,68,-68
31,109,27,53,59,73,-14
31,109,29,95,95,109,-14
31,109,31,1,243,115,128
31,109,31,19,330,175,155
31,109,31,23,103,93,10
31,109,31,25,335,412,-77
31,109,31,41,54,0,54
31,109,31,47,100,0,100
31,109,31,53,164,111,53
31,109,31,55,1411,2348,-937
31,109,31,67,387,428,-41
31,109,31,79,469,192,277
31,109,31,81,76,0,76
31,109,31,95,81,0,81
31,109,31,97,114,63,51
31,109,31,111,211,118,93
31,109,31,119,209,106,103
31,109,31,127,54,0,54
31,109,31,131,358,372,-14
31,109,31,141,180,110,70
31,109,31,147,51,0,51
31,109,31,151,446,386,60
31,109,31,153,424,773,-349
31,109,31,155,368,402,-34
31,109,31,157,140,80,60
31,109,31,159,438,403,35
31,109,31,169,70,0,70
31,109,31,179,56,0,56
31,109,31,185,201,78,123
31,109,32,3,100,107,-7
31,109,46,99,57,0,57
31,109,47,37,0,51,-51
31,109,48,29,75,0,75
31,109,48,113,0,96,-96
31,109,48,201,68,90,-22
31,109,48,439,66,76,-10
31,109,48,453,0,77,-77
31,109,53,33,0,104,-104
31,111,31,19,105,86,19
31,111,31,47,103,139,-36
31,111,31,55,90,141,-51
31,111,31,101,57,70,-13
31,111,31,109,118,211,-93
31,111,31,153,0,68,-68
31,119,12,86,96,0,96
31,119,31,3,85,106,-21
31,119,31,27,65,0,65
31,119,31,55,92,244,-152
31,119,31,109,106,209,-103
31,119,31,139,146,190,-44
31,119,31,141,197,109,88
31,119,31,153,0,60,-60
31,119,31,167,258,275,-17
31,119,31,179,110,83,27
31,121,31,79,224,183,41
31,123,31,157,129,100,29
31,125,31,141,0,63,-63
31,127,31,109,0,54,-54
31,127,31,131,79,60,19
31,131,19,71,0,72,-72
31,131,31,25,107,77,30
31,131,31,55,76,116,-40
31,131,31,109,372,358,14
31,131,31,127,60,79,-19
31,131,31,153,0,72,-72
31,137,31,19,118,124,-6
31,137,31,99,58,0,58
31,139,31,119,190,146,44
31,141,12,86,83,0,83
31,141,31,23,89,118,-29
31,141,31,37,271,211,60
31,141,31,55,107,218,-111
31,141,31,79,0,83,-83
31,141,31,109,110,180,-70
31,141,31,119,109,197,-88
31,141,31,125,63,0,63
31,141,31,143,74,107,-33
31,141,31,153,0,57,-57
31,143,31,141,107,74,33
31,143,31,185,0,71,-71
31,145,31,87,107,0,107
31,147,31,109,0,51,-51
31,151,31,67,76,0,76
31,151,31,109,386,446,-60
31,153,4,13,144,224,-80
31,153,4,19,0,103,-103
31,153,6,37,76,0,76
31,153,6,53,93,0,93
31,153,6,73,109,127,-18
31,153,8,41,127,233,-106
31,153,12,33,76,0,76
31,153,12,57,0,71,-71
31,153,15,3,101,105,-4
31,153,17,31,0,61,-61
31,153,19,71,0,66,-66
31,153,19,85,0,63,-63
31,153,19,129,128,165,-37
31,153,19,153,75,75,0
31,153,19,155,717,624,93
31,153,19,193,49,0,49
31,153,20,91,59,90,-31
31,153,22,15,120,0,120
31,153,29,95,0,81,-81
31,153,31,19,61,0,61
31,153,31,25,557,665,-108
31,153,31,53,140,63,77
31,153,31,55,10824,8975,1849
31,153,31,79,82,0,82
31,153,31,109,773,424,349
31,153,31,111,68,0,68
31,153,31,119,60,0,60
31,153,31,131,72,0,72
31,153,31,141,57,0,57
31,153,31,155,90,206,-116
31,153,31,177,81,82,-1
31,153,32,3,119,137,-18
31,153,40,109,0,83,-83
31,153,48,29,175,213,-38
31,153,48,201,75,58,17
31,153,48,451,86,0,86
31,155,31,25,61,74,-13
31,155,31,53,241,208,33
31,155,31,55,481,303,178
31,155,31,109,402,368,34
31,155,31,153,206,90,116
31,157,31,13,72,69,3
31,157,31,33,70,0,70
31,157,31,55,0,64,-64
31,157,31,109,80,140,-60
31,157,31,123,100,129,-29
31,157,56,15,117,70,47
31,157,56,21,53,64,-11
31,159,31,55,0,58,-58
31,159,31,109,403,438,-35
31,159,31,185,0,72,-72
31,161,31,45,63,0,63
31,163,31,19,0,91,-91
31,167,31,119,275,258,17
31,169,31,95,58,0,58
31,169,31,109,0,70,-70
31,173,31,43,0,66,-66
31,177,19,85,72,0,72
31,177,31,21,63,72,-9
31,177,31,53,174,117,57
31,177,31,55,1022,649,373
31,177,31,153,82,81,1
31,179,31,51,76,69,7
31,179,31,55,0,58,-58
31,179,31,109,0,56,-56
31,179,31,119,83,110,-27
31,181,31,1,62,96,-34
31,185,31,59,0,62,-62
31,185,31,109,78,201,-123
31,185,31,143,71,0,71
31,185,31,159,72,0,72
32,1,6,31,79,0,79
32,1,6,73,93,134,-41
32,1,32,3,104,0,104
32,1,32,19,384,239,145
32,1,32,31,413,345,68
32,1,51,810,75,0,75
32,3,1,73,117,0,117
32,3,1,89,64,94,-30
32,3,1,101,72,0,72
32,3,2,20,625,291,334
32,3,2,90,169,71,98
32,3,2,170,84,71,13
32,3,4,3,122,113,9
32,3,4,5,238,212,26
32,3,4,13,3504,4102,-598
32,3,4,15,1542,1699,-157
32,3,4,17,0,83,-83
32,3,4,19,746,734,12
32,3,4,21,297,319,-22
32,3,4,25,286,379,-93
32,3,4,27,176,180,-4
32,3,5,7,86,76,10
32,3,5,119,109,89,20
32,3,6,1,1528,626,902
32,3,6,7,112,62,50
32,3,6,13,1223,437,786
32,3,6,17,152,115,37
32,3,6,19,745,412,333
32,3,6,23,95,0,95
32,3,6,25,186,141,45
32,3,6,29,1102,674,428
32,3,6,31,80,79,1
32,3,6,37,19278,7814,11464
32,3,6,39,64,0,64
32,3,6,41,124,76,48
32,3,6,47,132,102,30
32,3,6,53,447,220,227
32,3,6,55,65,52,13
32,3,6,59,4963,2190,2773
32,3,6,61,263,202,61
32,3,6,65,3994,2274,1720
32,3,6,67,1382,728,654
32,3,6,71,4787,2537,2250
32,3,6,73,5147,2901,2246
32,3,6,75,628,300,328
32,3,6,77,601,319,282
32,3,6,79,322,161,161
32,3,6,81,801,331,470
32,3,6,83,551,224,327
32,3,6,85,1885,769,1116
32,3,6,87,157,67,90
32,3,6,89,73,76,-3
32,3,6,95,589,348,241
32,3,6,97,313,175,138
32,3,6,99,351,242,109
32,3,6,101,74,0,74
32,3,6,107,279,175,104
32,3,6,111,1321,549,772
32,3,6,113,95,0,95
32,3,6,115,77,0,77
32,3,8,1,423,302,121
32,3,8,5,650,477,173
32,3,8,13,167,101,66
32,3,8,14,57,0,57
32,3,8,31,554,403,151
32,3,8,35,236,274,-38
32,3,8,41,738,613,125
32,3,8,59,392,227,165
32,3,8,69,157,220,-63
32,3,8,77,187,150,37
32,3,8,101,108,93,15
32,3,8,123,154,139,15
32,3,9,1,134,60,74
32,3,9,3,146,93,53
32,3,9,9,120,84,36
32,3,9,11,66,0,66
32,3,10,1,63,0,63
32,3,10,3,85,0,85
32,3,11,1,223,149,74
32,3,12,1,76,0,76
32,3,12,5,163,97,66
32,3,12,9,226,214,12
32,3,12,11,717,444,273
32,3,12,15,47,0,47
32,3,12,21,127,116,11
32,3,12,31,264,197,67
32,3,12,33,118,124,-6
32,3,12,53,62,0,62
32,3,12,57,437,357,80
32,3,12,69,99,104,-5
32,3,12,71,205,211,-6
32,3,12,73,53,0,53
32,3,12,81,136,82,54
32,3,12,83,0,79,-79
32,3,12,86,1202,728,474
32,3,12,87,78,0,78
32,3,12,91,253,269,-16
32,3,12,95,544,435,109
32,3,12,97,110,102,8
32,3,12,99,393,410,-17
32,3,12,101,147,165,-18
32,3,12,103,275,271,4
32,3,12,105,154,191,-37
32,3,12,109,81,85,-4
32,3,12,111,103,60,43
32,3,12,113,107,85,22
32,3,12,115,157,143,14
32,3,12,117,153,83,70
32,3,12,119,0,66,-66
32,3,12,127,125,159,-34
32,3,12,131,0,64,-64
32,3,13,51,81,0,81
32,3,13,63,106,88,18
32,3,13,67,242,175,67
32,3,13,89,223,223,0
32,3,13,121,296,288,8
32,3,13,135,237,241,-4
32,3,13,151,0,62,-62
32,3,13,153,67,0,67
32,3,13,185,71,0,71
32,3,13,215,66,0,66
32,3,15,1,481,250,231
32,3,15,3,3432,1131,2301
32,3,15,7,142,76,66
32,3,15,9,410,216,194
32,3,16,1,383,428,-45
32,3,16,19,156,157,-1
32,3,16,27,137,195,-58
32,3,16,55,76,138,-62
32,3,16,65,96,62,34
32,3,16,83,98,111,-13
32,3,17,31,2744,1300,1444
32,3,17,43,418,149,269
32,3,17,89,183,89,94
32,3,17,91,64,0,64
32,3,17,97,352,139,213
32,3,17,111,139,61,78
32,3,17,113,78,0,78
32,3,17,143,99,0,99
32,3,17,163,93,0,93
32,3,17,167,65,54,11
32,3,17,197,306,114,192
32,3,17,201,140,60,80
32,3,18,3,95,0,95
32,3,18,57,80,105,-25
32,3,18,89,252,102,150
32,3,18,97,292,190,102
32,3,18,127,80,0,80
32,3,18,141,70,53,17
32,3,19,103,52,0,52
32,3,19,113,55,0,55
32,3,19,153,106,119,-13
32,3,19,163,66,0,66
32,3,20,91,213,142,71
32,3,20,173,190,198,-8
32,3,20,177,55,0,55
32,3,21,67,0,79,-79
32,3,21,111,159,146,13
32,3,22,15,94,0,94
32,3,22,17,75,0,75
32,3,22,33,169,70,99
32,3,22,51,81,0,81
32,3,22,71,105,77,28
32,3,23,5,72,0,72
32,3,24,3,169,135,34
32,3,24,5,170,115,55
32,3,24,17,78,0,78
32,3,24,21,0,73,-73
32,3,24,27,102,77,25
32,3,24,31,197,166,31
32,3,24,33,181,143,38
32,3,24,510,122,56,66
32,3,25,5,57,0,57
32,3,25,9,97,56,41
32,3,25,13,59,59,0
32,3,25,17,238,228,10
32,3,25,21,125,0,125
32,3,25,23,62,0,62
32,3,25,25,142,91,51
32,3,25,27,93,90,3
32,3,26,49,145,84,61
32,3,26,65,66,0,66
32,3,26,77,65,57,8
32,3,26,81,173,114,59
32,3,26,99,222,174,48
32,3,26,125,265,236,29
32,3,26,161,122,81,41
32,3,26,163,517,365,152
32,3,27,3,96,59,37
32,3,27,37,150,124,26
32,3,27,53,377,329,48
32,3,27,123,182,110,72
32,3,27,163,0,61,-61
32,3,28,47,112,129,-17
32,3,28,49,65,0,65
32,3,29,19,99,0,99
32,3,29,47,0,56,-56
32,3,29,77,76,93,-17
32,3,29,95,273,197,76
32,3,29,101,73,0,73
32,3,29,183,57,82,-25
32,3,29,189,216,163,53
32,3,29,510,111,0,111
32,3,30,13,92,113,-21
32,3,30,29,75,84,-9
32,3,30,31,114,96,18
32,3,30,49,60,0,60
32,3,30,63,99,80,19
32,3,30,111,133,131,2
32,3,31,55,239,161,78
32,3,31,109,107,100,7
32,3,31,153,137,119,18
32,3,32,1,0,104,-104
32,3,32,5,182,142,40
32,3,32,7,347,229,118
32,3,32,17,82,180,-98
32,3,32,19,101,261,-160
32,3,32,23,1067,2468,-1401
32,3,32,31,2141,2128,13
32,3,32,33,101,216,-115
32,3,32,510,197,340,-143
32,3,33,11,104,71,33
32,3,34,1,142,108,34
32,3,34,3,217,59,158
32,3,34,5,91,0,91
32,3,34,7,61,62,-1
32,3,34,13,159,53,106
32,3,34,17,170,84,86
32,3,34,21,62,0,62
32,3,34,23,175,65,110
32,3,34,25,103,0,103
32,3,34,27,85,89,-4
32,3,34,29,83,53,30
32,3,34,31,66,0,66
32,3,34,39,101,0,101
32,3,35,1,658,423,235
32,3,35,9,86,92,-6
32,3,35,13,162,127,35
32,3,35,35,244,165,79
32,3,35,43,107,131,-24
32,3,35,45,103,0,103
32,3,35,49,95,72,23
32,3,36,1,60,0,60
32,3,36,5,165,85,80
32,3,36,27,79,0,79
32,3,36,29,248,140,108
32,3,36,45,0,70,-70
32,3,36,47,472,183,289
32,3,36,55,191,94,97
32,3,36,59,263,119,144
32,3,36,61,378,249,129
32,3,36,63,53,55,-2
32,3,36,67,60,61,-1
32,3,36,71,98,0,98
32,3,36,81,484,185,299
32,3,36,85,95,52,43
32,3,36,103,351,144,207
32,3,36,119,145,66,79
32,3,37,51,129,122,7
32,3,37,63,0,73,-73
32,3,37,67,0,62,-62
32,3,37,81,69,111,-42
32,3,37,119,305,216,89
32,3,37,133,126,86,40
32,3,37,183,232,195,37
32,3,37,191,70,0,70
32,3,38,15,78,0,78
32,3,38,17,64,0,64
32,3,38,35,0,80,-80
32,3,38,101,152,111,41
32,3,38,105,74,95,-21
32,3,39,35,419,245,174
32,3,39,49,338,271,67
32,3,39,57,85,75,10
32,3,39,61,180,107,73
32,3,39,85,54,54,0
32,3,39,93,0,90,-90
32,3,39,95,89,79,10
32,3,39,99,83,0,83
32,3,39,103,51,0,51
32,3,39,113,146,116,30
32,3,39,151,89,72,17
32,3,39,153,129,115,14
32,3,40,27,101,0,101
32,3,40,31,90,85,5
32,3,40,109,273,181,92
32,3,40,143,161,150,11
32,3,41,5,280,204,76
32,3,41,11,0,64,-64
32,3,41,17,181,216,-35
32,3,41,19,80,77,3
32,3,41,29,190,163,27
32,3,41,33,48,62,-14
32,3,41,35,0,77,-77
32,3,41,39,217,231,-14
32,3,41,41,0,53,-53
32,3,41,43,0,58,-58
32,3,41,47,182,160,22
32,3,41,51,584,459,125
32,3,41,53,0,70,-70
32,3,41,67,488,410,78
32,3,42,3,303,188,115
32,3,42,11,51,0,51
32,3,42,17,67,0,67
32,3,42,29,54,0,54
32,3,42,45,73,0,73
32,3,42,71,64,0,64
32,3,42,77,63,0,63
32,3,42,91,105,67,38
32,3,42,95,53,0,53
32,3,42,101,204,127,77
32,3,42,129,58,0,58
32,3,42,133,58,0,58
32,3,44,7,92,0,92
32,3,45,15,58,0,58
32,3,45,19,125,74,51
32,3,45,45,71,85,-14
32,3,45,51,125,133,-8
32,3,45,79,81,68,13
32,3,45,85,79,126,-47
32,3,46,99,101,91,10
32,3,46,103,141,104,37
32,3,47,37,201,242,-41
32,3,47,65,61,140,-79
32,3,47,93,99,115,-16
32,3,47,125,147,111,36
32,3,47,149,100,76,24
32,3,47,157,258,232,26
32,3,47,187,88,71,17
32,3,48,27,190,205,-15
32,3,48,29,869,823,46
32,3,48,39,76,82,-6
32,3,48,41,52,0,52
32,3,48,61,57,0,57
32,3,48,85,312,398,-86
32,3,48,91,0,79,-79
32,3,48,113,661,734,-73
32,3,48,121,256,330,-74
32,3,48,141,453,452,1
32,3,48,157,172,151,21
32,3,48,167,80,106,-26
32,3,48,187,113,98,15
32,3,48,201,1080,1002,78
32,3,48,209,0,79,-79
32,3,48,215,64,76,-12
32,3,48,257,0,75,-75
32,3,48,303,76,0,76
32,3,48,309,59,75,-16
32,3,48,329,89,108,-19
32,3,48,339,147,141,6
32,3,48,355,54,77,-23
32,3,48,381,55,0,55
32,3,48,439,578,720,-142
32,3,48,441,0,60,-60
32,3,48,453,558,495,63
32,3,48,485,108,125,-17
32,3,48,491,132,272,-140
32,3,49,5,120,161,-41
32,3,49,11,469,387,82
32,3,49,21,364,529,-165
32,3,49,35,1616,1397,219
32,3,49,43,71,69,2
32,3,49,45,87,68,19
32,3,49,49,816,721,95
32,3,49,51,0,89,-89
32,3,49,53,947,1237,-290
32,3,49,57,352,262,90
32,3,51,13,110,115,-5
32,3,51,41,63,0,63
32,3,51,59,369,378,-9
32,3,51,87,0,63,-63
32,3,51,107,133,84,49
32,3,51,153,152,85,67
32,3,51,179,67,0,67
32,3,51,199,70,80,-10
32,3,51,510,61,67,-6
32,3,51,650,86,63,23
32,3,51,700,89,73,16
32,3,51,710,78,74,4
32,3,51,810,171,118,53
32,3,53,5,169,153,16
32,3,53,9,56,0,56
32,3,53,11,457,399,58
32,3,53,15,0,68,-68
32,3,53,21,0,96,-96
32,3,53,25,0,80,-80
32,3,53,29,101,74,27
32,3,53,33,1647,1457,190
32,3,53,35,191,185,6
32,3,53,53,932,667,265
32,3,53,57,0,68,-68
32,3,53,61,625,468,157
32,3,53,63,342,368,-26
32,3,53,67,244,173,71
32,3,53,73,136,158,-22
32,3,53,77,125,74,51
32,3,55,25,140,98,42
32,3,55,59,103,0,103
32,3,55,79,416,222,194
32,3,55,101,68,0,68
32,3,55,133,80,52,28
32,3,56,21,132,125,7
32,3,56,25,84,113,-29
32,3,56,37,67,0,67
32,5,4,13,0,68,-68
32,5,6,1,125,0,125
32,5,6,13,120,0,120
32,5,6,17,541,366,175
32,5,6,37,239,56,183
32,5,6,59,130,0,130
32,5,6,61,92,0,92
32,5,6,65,111,0,111
32,5,6,67,139,70,69
32,5,6,71,68,0,68
32,5,6,73,122,52,70
32,5,6,85,156,0,156
32,5,32,3,142,182,-40
32,5,32,19,261,328,-67
32,5,32,31,664,627,37
32,5,32,510,765,910,-145
32,7,2,90,63,0,63
32,7,4,13,66,94,-28
32,7,16,1,86,131,-45
32,7,16,27,0,76,-76
32,7,16,83,137,88,49
32,7,32,3,229,347,-118
32,7,32,13,122,104,18
32,7,32,15,109,77,32
32,7,32,19,67,59,8
32,7,32,23,72,0,72
32,7,32,31,271,361,-90
32,7,32,33,96,0,96
32,7,49,35,158,214,-56
32,7,49,45,200,137,63
32,7,49,49,0,73,-73
32,13,32,7,104,122,-18
32,13,32,27,103,99,4
32,13,32,31,176,195,-19
32,15,32,7,77,109,-32
32,17,32,3,180,82,98
32,19,4,13,69,69,0
32,19,6,1,61,0,61
32,19,6,13,120,0,120
32,19,6,17,103,0,103
32,19,6,37,159,0,159
32,19,6,61,62,0,62
32,19,6,65,85,0,85
32,19,6,67,168,77,91
32,19,6,71,86,0,86
32,19,6,73,101,71,30
32,19,6,77,129,0,129
32,19,6,85,110,0,110
32,19,6,97,68,0,68
32,19,6,99,65,0,65
32,19,32,1,239,384,-145
32,19,32,3,261,101,160
32,19,32,5,328,261,67
32,19,32,7,59,67,-8
32,19,32,29,101,49,52
32,19,32,31,2076,1372,704
32,19,32,510,1097,851,246
32,21,32,31,0,67,-67
32,23,4,13,77,70,7
32,23,6,29,72,0,72
32,23,6,37,140,0,140
32,23,6,59,62,0,62
32,23,6,65,107,0,107
32,23,6,71,109,0,109
32,23,6,73,85,0,85
32,23,32,3,2468,1067,1401
32,23,32,7,0,72,-72
32,23,32,31,96,99,-3
32,27,32,13,99,103,-4
32,27,32,31,74,66,8
32,29,32,19,49,101,-52
32,29,32,31,348,177,171
32,31,2,20,73,0,73
32,31,4,13,636,837,-201
32,31,4,15,110,111,-1
32,31,4,19,185,170,15
32,31,4,21,0,103,-103
32,31,4,25,71,48,23
32,31,4,27,0,55,-55
32,31,6,1,892,295,597
32,31,6,7,308,104,204
32,31,6,13,932,213,719
32,31,6,17,381,205,176
32,31,6,19,202,167,35
32,31,6,23,63,0,63
32,31,6,27,72,0,72
32,31,6,29,226,110,116
32,31,6,35,255,217,38
32,31,6,37,1268,611,657
32,31,6,41,194,0,194
32,31,6,45,72,0,72
32,31,6,47,56,0,56
32,31,6,53,156,99,57
32,31,6,55,84,0,84
32,31,6,57,728,359,369
32,31,6,59,589,247,342
32,31,6,61,883,505,378
32,31,6,63,184,180,4
32,31,6,65,402,303,99
32,31,6,67,1136,736,400
32,31,6,71,314,205,109
32,31,6,73,839,402,437
32,31,6,75,295,196,99
32,31,6,77,289,238,51
32,31,6,79,96,51,45
32,31,6,81,417,150,267
32,31,6,83,95,68,27
32,31,6,85,1088,320,768
32,31,6,87,185,0,185
32,31,6,89,167,83,84
32,31,6,91,77,0,77
32,31,6,95,343,96,247
32,31,6,97,377,109,268
32,31,6,99,230,146,84
32,31,6,101,106,0,106
32,31,6,107,94,0,94
32,31,6,111,267,145,122
32,31,6,113,138,69,69
32,31,6,115,59,0,59
32,31,8,5,63,77,-14
32,31,8,13,54,0,54
32,31,8,31,109,85,24
32,31,8,41,114,78,36
32,31,8,59,67,66,1
32,31,8,69,0,68,-68
32,31,12,11,95,0,95
32,31,12,31,52,0,52
32,31,12,95,86,0,86
32,31,12,99,60,53,7
32,31,13,121,62,0,62
32,31,15,1,64,70,-6
32,31,15,3,242,65,177
32,31,16,1,124,256,-132
32,31,16,27,0,72,-72
32,31,16,55,0,49,-49
32,31,17,31,166,121,45
32,31,27,53,57,58,-1
32,31,32,1,345,413,-68
32,31,32,3,2128,2141,-13
32,31,32,5,627,664,-37
32,31,32,7,361,271,90
32,31,32,13,195,176,19
32,31,32,19,1372,2076,-704
32,31,32,21,67,0,67
32,31,32,23,99,96,3
32,31,32,27,66,74,-8
32,31,32,29,177,348,-171
32,31,32,510,1270,1188,82
32,31,35,1,65,52,13
32,31,36,47,61,0,61
32,31,37,183,64,0,64
32,31,39,49,52,0,52
32,31,41,5,99,102,-3
32,31,41,17,92,70,22
32,31,41,29,84,76,8
32,31,41,39,86,119,-33
32,31,41,43,0,54,-54
32,31,41,47,61,72,-11
32,31,41,51,129,186,-57
32,31,41,67,91,116,-25
32,31,42,3,69,0,69
32,31,48,29,64,121,-57
32,31,48,85,0,90,-90
32,31,48,113,101,71,30
32,31,48,141,78,0,78
32,31,48,201,209,165,44
32,31,48,439,76,108,-32
32,31,48,453,119,112,7
32,31,48,491,67,103,-36
32,31,49,11,0,78,-78
32,31,49,35,246,214,32
32,31,49,49,77,93,-16
32,31,51,59,0,57,-57
32,31,53,11,109,143,-34
32,31,53,33,364,367,-3
32,31,53,53,148,187,-39
32,31,53,61,115,61,54
32,31,53,63,89,124,-35
32,33,32,3,216,101,115
32,33,32,7,0,96,-96
32,510,4,13,0,80,-80
32,510,6,13,55,0,55
32,510,6,17,246,66,180
32,510,6,37,156,81,75
32,510,6,59,77,0,77
32,510,6,61,60,0,60
32,510,6,65,67,0,67
32,510,6,67,118,0,118
32,510,6,71,64,0,64
32,510,6,73,98,60,38
32,510,6,85,82,0,82
32,510,32,3,340,197,143
32,510,32,5,910,765,145
32,510,32,19,851,1097,-246
32,510,32,31,1188,1270,-82
33,1,23,5,48,52,-4
33,1,23,31,69,69,0
33,1,25,9,169,92,77
33,1,25,17,280,127,153
33,1,25,21,85,0,85
33,1,25,25,0,67,-67
33,1,25,27,83,0,83
33,1,33,3,247,278,-31
33,1,33,7,0,64,-64
33,1,33,9,467,450,17
33,1,33,11,655,457,198
33,1,33,13,1463,1385,78
33,1,33,15,383,247,136
33,1,33,17,403,314,89
33,3,23,5,86,90,-4
33,3,23,17,172,181,-9
33,3,23,31,147,139,8
33,3,25,9,274,94,180
33,3,25,17,239,103,136
33,3,25,21,85,0,85
33,3,25,23,0,54,-54
33,3,25,25,51,58,-7
33,3,25,27,92,0,92
33,3,33,1,278,247,31
33,3,33,7,57,111,-54
33,3,33,9,104,80,24
33,3,33,11,195,99,96
33,3,33,13,118,123,-5
33,3,33,15,343,198,145
33,3,33,17,553,453,100
33,5,9,3,56,0,56
33,5,23,5,0,51,-51
33,5,23,31,0,68,-68
33,5,25,11,95,97,-2
33,5,25,13,70,0,70
33,5,25,17,220,168,52
33,5,25,21,50,0,50
33,5,25,25,0,59,-59
33,5,25,27,334,205,129
33,5,33,9,88,78,10
33,5,33,11,858,712,146
33,5,33,13,83,181,-98
33,5,33,15,140,158,-18
33,5,33,17,0,83,-83
33,5,33,19,288,207,81
33,5,50,25,411,269,142
33,5,50,27,84,85,-1
33,7,33,1,64,0,64
33,7,33,3,111,57,54
33,7,33,9,367,263,104
33,7,33,11,191,97,94
33,7,33,13,89,78,11
33,7,33,15,100,0,100
33,7,33,17,74,58,16
33,7,50,9,72,125,-53
33,9,6,37,69,46,23
33,9,6,75,0,68,-68
33,9,6,85,0,45,-45
33,9,9,1,49,0,49
33,9,9,3,69,0,69
33,9,9,9,68,0,68
33,9,17,31,0,65,-65
33,9,23,5,55,87,-32
33,9,23,31,0,72,-72
33,9,25,5,66,0,66
33,9,25,9,144,70,74
33,9,25,17,424,261,163
33,9,25,21,103,74,29
33,9,25,23,64,0,64
33,9,25,25,109,188,-79
33,9,25,27,100,58,42
33,9,33,1,450,467,-17
33,9,33,3,80,104,-24
33,9,33,5,78,88,-10
33,9,33,7,263,367,-104
33,9,33,11,400,320,80
33,9,33,13,497,602,-105
33,9,33,15,243,186,57
33,9,33,17,116,122,-6
33,9,33,19,405,552,-147
33,9,36,47,57,0,57
33,9,36,61,71,97,-26
33,9,44,7,72,55,17
33,9,50,5,127,113,14
33,9,50,7,72,79,-7
33,9,50,9,0,57,-57
33,9,50,17,223,241,-18
33,9,50,27,596,605,-9
33,9,53,33,0,92,-92
33,11,4,13,166,183,-17
33,11,4,19,67,54,13
33,11,6,1,0,58,-58
33,11,6,37,127,174,-47
33,11,6,73,111,147,-36
33,11,6,85,0,61,-61
33,11,8,31,0,61,-61
33,11,8,41,0,54,-54
33,11,9,1,131,62,69
33,11,9,3,167,135,32
33,11,9,9,115,62,53
33,11,11,1,0,69,-69
33,11,12,9,77,86,-9
33,11,12,11,99,80,19
33,11,12,15,0,54,-54
33,11,12,21,0,88,-88
33,11,12,57,90,130,-40
33,11,12,69,0,78,-78
33,11,12,71,72,149,-77
33,11,12,81,64,96,-32
33,11,12,83,0,55,-55
33,11,12,86,0,50,-50
33,11,12,95,78,110,-32
33,11,12,97,0,65,-65
33,11,12,99,120,135,-15
33,11,12,101,0,117,-117
33,11,12,103,122,158,-36
33,11,12,105,0,75,-75
33,11,12,111,0,72,-72
33,11,12,115,0,171,-171
33,11,12,127,56,68,-12
33,11,17,31,107,88,19
33,11,23,1,0,62,-62
33,11,23,5,135,217,-82
33,11,23,11,56,0,56
33,11,23,19,78,51,27
33,11,23,31,186,342,-156
33,11,25,1,140,161,-21
33,11,25,5,189,138,51
33,11,25,9,1824,915,909
33,11,25,13,98,64,34
33,11,25,15,0,52,-52
33,11,25,17,5790,2998,2792
33,11,25,21,402,343,59
33,11,25,23,208,159,49
33,11,25,25,592,533,59
33,11,25,27,742,642,100
33,11,32,3,71,104,-33
33,11,33,1,457,655,-198
33,11,33,3,99,195,-96
33,11,33,5,712,858,-146
33,11,33,7,97,191,-94
33,11,33,9,320,400,-80
33,11,33,13,3017,4188,-1171
33,11,33,15,4849,4861,-12
33,11,33,17,481,590,-109
33,11,33,19,177,256,-79
33,11,36,5,62,0,62
33,11,36,47,93,74,19
33,11,36,55,56,0,56
33,11,36,61,124,59,65
33,11,36,81,113,61,52
33,11,36,103,79,0,79
33,11,37,119,0,84,-84
33,11,37,183,50,147,-97
33,11,42,101,62,0,62
33,11,44,3,52,59,-7
33,11,44,7,165,141,24
33,11,45,19,0,72,-72
33,11,45,51,0,85,-85
33,11,48,113,56,64,-8
33,11,48,201,75,73,2
33,11,48,439,74,91,-17
33,11,48,453,0,79,-79
33,11,48,491,0,82,-82
33,11,50,7,91,85,6
33,11,51,59,69,65,4
33,11,53,33,65,106,-41
33,13,4,13,0,64,-64
33,13,9,3,73,0,73
33,13,12,103,0,49,-49
33,13,23,5,67,122,-55
33,13,23,31,83,156,-73
33,13,25,1,61,0,61
33,13,25,5,44,0,44
33,13,25,9,229,162,67
33,13,25,17,448,222,226
33,13,25,21,118,66,52
33,13,25,23,45,0,45
33,13,25,25,116,146,-30
33,13,25,27,169,57,112
33,13,33,1,1385,1463,-78
33,13,33,3,123,118,5
33,13,33,5,181,83,98
33,13,33,7,78,89,-11
33,13,33,9,602,497,105
33,13,33,11,4188,3017,1171
33,13,33,15,1590,1046,544
33,13,33,17,315,380,-65
33,13,33,19,364,399,-35
33,13,44,7,52,0,52
33,13,50,7,55,54,1
33,13,50,27,58,0,58
33,15,4,13,88,126,-38
33,15,6,37,120,94,26
33,15,6,73,119,137,-18
33,15,9,1,83,59,24
33,15,9,3,116,79,37
33,15,9,9,74,61,13
33,15,9,11,116,66,50
33,15,11,1,54,0,54
33,15,12,9,0,62,-62
33,15,12,11,66,69,-3
33,15,12,15,0,74,-74
33,15,12,21,0,104,-104
33,15,12,57,0,109,-109
33,15,12,71,75,109,-34
33,15,12,81,0,71,-71
33,15,12,83,0,59,-59
33,15,12,95,0,74,-74
33,15,12,99,57,82,-25
33,15,12,101,0,80,-80
33,15,12,103,60,131,-71
33,15,12,105,0,76,-76
33,15,12,115,70,156,-86
33,15,17,31,58,51,7
33,15,23,5,216,313,-97
33,15,23,11,66,0,66
33,15,23,31,829,1122,-293
33,15,25,1,82,84,-2
33,15,25,5,103,64,39
33,15,25,9,5884,2573,3311
33,15,25,13,51,63,-12
33,15,25,17,2981,1414,1567
33,15,25,21,274,271,3
33,15,25,23,165,114,51
33,15,25,25,655,478,177
33,15,25,27,348,188,160
33,15,33,1,247,383,-136
33,15,33,3,198,343,-145
33,15,33,5,158,140,18
33,15,33,7,0,100,-100
33,15,33,9,186,243,-57
33,15,33,11,4861,4849,12
33,15,33,13,1046,1590,-544
33,15,33,17,2326,3110,-784
33,15,33,19,49,69,-20
33,15,36,47,64,55,9
33,15,36,61,82,79,3
33,15,37,183,0,98,-98
33,15,44,7,107,79,28
33,15,45,19,0,59,-59
33,15,45,51,0,70,-70
33,15,48,453,0,79,-79
33,15,50,7,76,0,76
33,17,4,13,0,55,-55
33,17,6,37,0,50,-50
33,17,6,73,0,87,-87
33,17,9,11,84,0,84
33,17,23,5,116,174,-58
33,17,23,31,1359,1543,-184
33,17,25,9,511,238,273
33,17,25,17,329,264,65
33,17,25,21,78,70,8
33,17,25,25,103,107,-4
33,17,25,27,108,60,48
33,17,33,1,314,403,-89
33,17,33,3,453,553,-100
33,17,33,5,83,0,83
33,17,33,7,58,74,-16
33,17,33,9,122,116,6
33,17,33,11,590,481,109
33,17,33,13,380,315,65
33,17,33,15,3110,2326,784
33,17,33,19,49,0,49
33,19,25,17,66,0,66
33,19,25,27,59,0,59
33,19,33,5,207,288,-81
33,19,33,9,552,405,147
33,19,33,11,256,177,79
33,19,33,13,399,364,35
33,19,33,15,69,49,20
33,19,33,17,0,49,-49
33,19,50,25,82,83,-1
33,19,50,27,338,326,12
34,1,6,37,51,114,-63
34,1,6,73,0,54,-54
34,1,10,3,66,145,-79
34,1,12,9,0,53,-53
34,1,12,11,95,173,-78
34,1,12,57,63,77,-14
34,1,12,71,0,110,-110
34,1,12,86,0,73,-73
34,1,12,95,80,97,-17
34,1,12,99,110,204,-94
34,1,12,103,55,74,-19
34,1,12,105,0,58,-58
34,1,12,115,0,57,-57
34,1,24,3,0,55,-55
34,1,24,5,0,72,-72
34,1,24,33,0,67,-67
34,1,32,3,108,142,-34
34,1,34,3,107,84,23
34,1,34,5,582,443,139
34,1,34,7,1471,1364,107
34,1,34,9,1176,938,238
34,1,34,11,1081,977,104
34,1,34,13,126,96,30
34,1,34,15,864,758,106
34,1,34,17,113,141,-28
34,1,34,21,75,125,-50
34,1,34,23,151,196,-45
34,1,34,25,190,146,44
34,1,34,27,92,56,36
34,1,34,29,804,562,242
34,1,34,33,118,79,39
34,1,34,35,56,56,0
34,1,34,39,64,0,64
34,1,36,5,99,62,37
34,1,36,47,110,135,-25
34,1,36,61,111,106,5
34,1,36,81,106,110,-4
34,1,42,17,208,159,49
34,1,42,29,79,83,-4
34,1,42,45,124,150,-26
34,1,42,91,257,192,65
34,1,42,101,516,769,-253
34,1,45,51,0,75,-75
34,1,51,59,0,71,-71
34,3,4,13,173,274,-101
34,3,4,19,0,50,-50
34,3,6,1,103,170,-67
34,3,6,13,0,92,-92
34,3,6,37,505,786,-281
34,3,6,59,173,339,-166
34,3,6,65,0,68,-68
34,3,6,73,196,307,-111
34,3,6,75,95,141,-46
34,3,6,81,0,97,-97
34,3,6,85,109,225,-116
34,3,6,111,0,63,-63
34,3,8,5,0,68,-68
34,3,8,31,0,127,-127
34,3,9,1,354,403,-49
34,3,9,3,107,125,-18
34,3,9,9,133,145,-12
34,3,10,3,69,129,-60
34,3,10,5,0,141,-141
34,3,11,1,114,133,-19
34,3,12,9,0,66,-66
34,3,12,11,281,530,-249
34,3,12,21,54,178,-124
34,3,12,31,55,90,-35
34,3,12,35,0,73,-73
34,3,12,57,103,256,-153
34,3,12,61,0,69,-69
34,3,12,71,47,237,-190
34,3,12,81,0,97,-97
34,3,12,86,281,442,-161
34,3,12,95,197,353,-156
34,3,12,97,0,148,-148
34,3,12,99,378,894,-516
34,3,12,101,0,107,-107
34,3,12,103,88,193,-105
34,3,12,105,0,90,-90
34,3,12,111,0,108,-108
34,3,12,115,0,167,-167
34,3,12,117,0,95,-95
34,3,12,119,0,53,-53
34,3,12,127,0,82,-82
34,3,13,67,60,125,-65
34,3,13,89,57,87,-30
34,3,13,121,105,232,-127
34,3,13,135,56,250,-194
34,3,15,3,0,87,-87
34,3,17,31,266,278,-12
34,3,17,43,0,93,-93
34,3,24,3,0,63,-63
34,3,24,5,60,91,-31
34,3,24,27,0,71,-71
34,3,24,31,207,212,-5
34,3,24,33,51,69,-18
34,3,24,510,49,76,-27
34,3,25,1,0,65,-65
34,3,25,9,0,60,-60
34,3,25,17,171,278,-107
34,3,25,21,86,113,-27
34,3,25,25,150,143,7
34,3,25,27,0,65,-65
34,3,26,125,0,101,-101
34,3,27,53,61,0,61
34,3,32,3,59,217,-158
34,3,34,1,84,107,-23
34,3,34,5,124,202,-78
34,3,34,7,132,204,-72
34,3,34,13,3142,3388,-246
34,3,34,15,68,95,-27
34,3,34,17,10368,5656,4712
34,3,34,19,75,157,-82
34,3,34,21,229,336,-107
34,3,34,23,1382,1707,-325
34,3,34,25,581,1058,-477
34,3,34,27,1458,3106,-1648
34,3,34,29,557,1441,-884
34,3,34,31,7635,8191,-556
34,3,34,35,409,647,-238
34,3,34,37,390,848,-458
34,3,34,39,918,1038,-120
34,3,34,41,87,277,-190
34,3,36,5,2472,889,1583
34,3,36,27,86,109,-23
34,3,36,29,51,0,51
34,3,36,47,2375,1190,1185
34,3,36,55,0,51,-51
34,3,36,59,673,386,287
34,3,36,61,4526,3471,1055
34,3,36,71,576,581,-5
34,3,36,81,3851,1476,2375
34,3,36,85,447,172,275
34,3,36,87,1882,1211,671
34,3,36,103,341,262,79
34,3,36,105,0,76,-76
34,3,36,111,0,109,-109
34,3,36,119,896,681,215
34,3,37,19,0,108,-108
34,3,37,63,0,65,-65
34,3,37,119,103,308,-205
34,3,37,179,0,83,-83
34,3,37,183,67,364,-297
34,3,39,35,0,71,-71
34,3,39,49,56,75,-19
34,3,41,51,0,55,-55
34,3,41,67,0,51,-51
34,3,42,3,68,96,-28
34,3,42,17,88,155,-67
34,3,42,29,0,118,-118
34,3,42,45,62,0,62
34,3,42,69,0,63,-63
34,3,42,71,0,71,-71
34,3,42,77,92,135,-43
34,3,42,79,50,130,-80
34,3,42,89,126,282,-156
34,3,42,91,129,207,-78
34,3,42,95,60,159,-99
34,3,42,101,223,267,-44
34,3,42,103,0,129,-129
34,3,44,7,0,87,-87
34,3,45,13,0,72,-72
34,3,45,19,0,110,-110
34,3,45,45,0,101,-101
34,3,45,51,0,121,-121
34,3,47,37,0,62,-62
34,3,48,29,0,70,-70
34,3,48,85,81,245,-164
34,3,48,113,106,200,-94
34,3,48,121,0,104,-104
34,3,48,157,0,82,-82
34,3,48,201,120,200,-80
34,3,48,439,0,83,-83
34,3,48,453,0,144,-144
34,3,48,491,0,73,-73
34,3,51,13,46,62,-16
34,3,51,59,139,233,-94
34,3,51,107,74,78,-4
34,3,51,810,0,48,-48
34,3,53,33,103,295,-192
34,5,2,20,75,0,75
34,5,4,13,97,129,-32
34,5,4,19,0,70,-70
34,5,6,37,87,197,-110
34,5,6,59,0,50,-50
34,5,6,73,128,154,-26
34,5,6,95,76,0,76
34,5,8,5,0,54,-54
34,5,8,41,84,114,-30
34,5,9,1,0,69,-69
34,5,10,1,69,131,-62
34,5,10,3,147,308,-161
34,5,10,5,0,85,-85
34,5,11,1,53,71,-18
34,5,12,11,105,116,-11
34,5,12,21,0,54,-54
34,5,12,31,0,77,-77
34,5,12,57,122,212,-90
34,5,12,71,64,146,-82
34,5,12,81,0,57,-57
34,5,12,86,70,67,3
34,5,12,95,84,119,-35
34,5,12,99,139,212,-73
34,5,12,101,0,70,-70
34,5,12,103,70,88,-18
34,5,12,111,0,61,-61
34,5,12,115,0,88,-88
34,5,12,117,0,93,-93
34,5,12,119,0,65,-65
34,5,12,127,0,61,-61
34,5,13,67,0,54,-54
34,5,13,121,0,62,-62
34,5,13,135,0,63,-63
34,5,15,3,129,108,21
34,5,17,31,52,69,-17
34,5,17,163,0,90,-90
34,5,24,3,82,97,-15
34,5,24,5,69,78,-9
34,5,24,15,0,61,-61
34,5,24,31,60,71,-11
34,5,24,33,83,80,3
34,5,24,510,56,45,11
34,5,25,17,73,81,-8
34,5,32,3,0,91,-91
34,5,34,1,443,582,-139
34,5,34,3,202,124,78
34,5,34,7,6788,6511,277
34,5,34,9,207,310,-103
34,5,34,11,139,122,17
34,5,34,13,568,236,332
34,5,34,15,1134,1203,-69
34,5,34,17,292,253,39
34,5,34,19,84,83,1
34,5,34,21,3509,1970,1539
34,5,34,23,1457,568,889
34,5,34,25,664,403,261
34,5,34,27,146,143,3
34,5,34,29,1617,1108,509
34,5,34,31,117,94,23
34,5,34,33,73,104,-31
34,5,34,35,371,207,164
34,5,34,39,369,175,194
34,5,36,5,172,50,122
34,5,36,47,292,197,95
34,5,36,59,62,56,6
34,5,36,61,153,166,-13
34,5,36,81,300,99,201
34,5,36,85,97,0,97
34,5,36,103,69,0,69
34,5,36,119,70,0,70
34,5,37,51,62,69,-7
34,5,37,119,81,147,-66
34,5,37,133,87,69,18
34,5,37,183,0,110,-110
34,5,39,35,0,60,-60
34,5,42,3,67,60,7
34,5,42,11,66,65,1
34,5,42,17,1005,903,102
34,5,42,29,116,276,-160
34,5,42,45,320,278,42
34,5,42,71,0,64,-64
34,5,42,77,68,91,-23
34,5,42,91,389,466,-77
34,5,42,101,2044,1663,381
34,5,45,19,0,84,-84
34,5,45,51,0,108,-108
34,5,48,27,0,92,-92
34,5,48,29,100,157,-57
34,5,48,113,0,91,-91
34,5,48,201,71,62,9
34,5,48,439,0,104,-104
34,5,48,453,0,55,-55
34,5,51,59,117,143,-26
34,5,51,153,0,71,-71
34,5,51,810,69,69,0
34,5,53,33,0,69,-69
34,5,53,53,0,98,-98
34,7,4,13,68,59,9
34,7,6,37,157,148,9
34,7,6,59,0,74,-74
34,7,6,73,74,136,-62
34,7,6,75,0,50,-50
34,7,10,1,75,110,-35
34,7,10,3,283,436,-153
34,7,10,5,0,94,-94
34,7,11,1,44,64,-20
34,7,12,11,131,135,-4
34,7,12,31,0,60,-60
34,7,12,57,84,127,-43
34,7,12,69,0,92,-92
34,7,12,71,0,123,-123
34,7,12,86,61,0,61
34,7,12,95,97,193,-96
34,7,12,97,0,83,-83
34,7,12,99,97,196,-99
34,7,12,103,59,124,-65
34,7,12,105,0,71,-71
34,7,12,115,0,68,-68
34,7,13,121,0,66,-66
34,7,17,31,88,72,16
34,7,24,3,0,54,-54
34,7,24,5,55,58,-3
34,7,24,25,0,56,-56
34,7,24,31,83,91,-8
34,7,24,33,67,66,1
34,7,24,510,67,0,67
34,7,25,17,51,58,-7
34,7,25,25,0,50,-50
34,7,32,3,62,61,1
34,7,34,1,1364,1471,-107
34,7,34,3,204,132,72
34,7,34,5,6511,6788,-277
34,7,34,9,353,472,-119
34,7,34,11,611,414,197
34,7,34,13,316,95,221
34,7,34,15,5999,7255,-1256
34,7,34,17,303,131,172
34,7,34,21,451,358,93
34,7,34,23,484,335,149
34,7,34,25,238,141,97
34,7,34,27,111,63,48
34,7,34,29,359,284,75
34,7,34,31,88,51,37
34,7,34,33,310,398,-88
34,7,34,35,137,97,40
34,7,34,39,195,132,63
34,7,36,5,206,82,124
34,7,36,47,330,175,155
34,7,36,59,113,0,113
34,7,36,61,166,239,-73
34,7,36,81,211,130,81
34,7,36,85,72,0,72
34,7,36,103,111,0,111
34,7,36,119,76,0,76
34,7,37,119,0,117,-117
34,7,37,183,0,70,-70
34,7,42,3,60,53,7
34,7,42,11,86,0,86
34,7,42,17,377,386,-9
34,7,42,29,140,280,-140
34,7,42,45,512,479,33
34,7,42,71,0,79,-79
34,7,42,77,0,76,-76
34,7,42,91,447,522,-75
34,7,42,101,4394,2889,1505
34,7,45,51,0,92,-92
34,7,48,201,77,87,-10
34,7,51,59,56,88,-32
34,7,53,33,0,53,-53
34,9,10,3,60,0,60
34,9,12,21,0,51,-51
34,9,12,71,0,90,-90
34,9,12,99,0,72,-72
34,9,12,103,0,71,-71
34,9,12,115,0,57,-57
34,9,34,1,938,1176,-238
34,9,34,5,310,207,103
34,9,34,7,472,353,119
34,9,34,11,267,368,-101
34,9,34,15,344,276,68
34,9,34,23,71,0,71
34,9,34,25,64,54,10
34,9,34,27,84,0,84
34,9,34,29,98,104,-6
34,9,42,17,229,116,113
34,9,42,29,153,120,33
34,9,42,45,241,156,85
34,9,42,91,232,180,52
34,9,42,101,471,323,148
34,11,10,3,98,123,-25
34,11,34,1,977,1081,-104
34,11,34,5,122,139,-17
34,11,34,7,414,611,-197
34,11,34,9,368,267,101
34,11,34,15,836,1052,-216
34,11,34,29,0,65,-65
34,11,34,33,590,694,-104
34,11,36,47,64,0,64
34,11,42,45,54,0,54
34,11,42,101,179,137,42
34,13,4,13,97,195,-98
34,13,6,1,60,96,-36
34,13,6,37,294,393,-99
34,13,6,59,0,146,-146
34,13,6,65,0,63,-63
34,13,6,73,88,204,-116
34,13,6,75,77,97,-20
34,13,6,81,0,65,-65
34,13,6,85,61,126,-65
34,13,8,31,0,63,-63
34,13,9,1,234,209,25
34,13,9,3,88,90,-2
34,13,9,9,96,100,-4
34,13,10,1,0,96,-96
34,13,10,3,90,238,-148
34,13,10,5,0,57,-57
34,13,11,1,101,107,-6
34,13,12,9,0,92,-92
34,13,12,11,274,386,-112
34,13,12,21,0,110,-110
34,13,12,31,69,149,-80
34,13,12,57,105,283,-178
34,13,12,69,0,55,-55
34,13,12,71,0,104,-104
34,13,12,81,0,68,-68
34,13,12,86,291,288,3
34,13,12,95,141,324,-183
34,13,12,97,60,146,-86
34,13,12,99,284,472,-188
34,13,12,101,0,73,-73
34,13,12,103,0,104,-104
34,13,12,105,0,146,-146
34,13,12,109,0,82,-82
34,13,12,111,0,65,-65
34,13,12,115,0,95,-95
34,13,12,117,0,97,-97
34,13,12,127,0,86,-86
34,13,13,63,0,120,-120
34,13,13,67,0,210,-210
34,13,13,89,90,208,-118
34,13,13,121,113,251,-138
34,13,13,135,70,195,-125
34,13,13,151,0,79,-79
34,13,17,31,123,191,-68
34,13,18,97,0,55,-55
34,13,24,3,0,60,-60
34,13,24,5,100,138,-38
34,13,24,31,194,179,15
34,13,24,33,163,153,10
34,13,24,510,119,124,-5
34,13,25,17,125,217,-92
34,13,25,21,0,91,-91
34,13,25,25,115,119,-4
34,13,25,27,0,79,-79
34,13,27,53,55,0,55
34,13,32,3,53,159,-106
34,13,34,1,96,126,-30
34,13,34,3,3388,3142,246
34,13,34,5,236,568,-332
34,13,34,7,95,316,-221
34,13,34,15,61,91,-30
34,13,34,17,7607,4328,3279
34,13,34,19,109,193,-84
34,13,34,21,286,480,-194
34,13,34,23,1929,2830,-901
34,13,34,25,553,1174,-621
34,13,34,27,2446,4437,-1991
34,13,34,29,453,1079,-626
34,13,34,31,3641,3117,524
34,13,34,35,730,1226,-496
34,13,34,37,311,631,-320
34,13,34,39,5998,8233,-2235
34,13,34,41,171,410,-239
34,13,36,5,2113,841,1272
34,13,36,27,0,68,-68
34,13,36,47,4641,1812,2829
34,13,36,55,54,0,54
34,13,36,59,378,239,139
34,13,36,61,2814,1858,956
34,13,36,71,143,137,6
34,13,36,81,2360,828,1532
34,13,36,85,415,144,271
34,13,36,87,203,123,80
34,13,36,103,255,195,60
34,13,36,119,392,315,77
34,13,37,51,0,79,-79
34,13,37,63,0,88,-88
34,13,37,81,53,149,-96
34,13,37,119,98,362,-264
34,13,37,183,120,329,-209
34,13,39,35,0,54,-54
34,13,39,49,66,118,-52
34,13,42,3,0,119,-119
34,13,42,11,0,74,-74
34,13,42,17,102,183,-81
34,13,42,29,0,70,-70
34,13,42,43,0,102,-102
34,13,42,45,66,82,-16
34,13,42,69,0,129,-129
34,13,42,71,0,78,-78
34,13,42,77,167,289,-122
34,13,42,79,65,280,-215
34,13,42,89,154,391,-237
34,13,42,91,66,103,-37
34,13,42,95,191,464,-273
34,13,42,101,239,444,-205
34,13,42,103,0,107,-107
34,13,45,45,0,97,-97
34,13,45,51,0,70,-70
34,13,45,79,0,60,-60
34,13,48,85,0,98,-98
34,13,48,113,49,130,-81
34,13,48,157,0,73,-73
34,13,48,201,139,292,-153
34,13,48,439,69,70,-1
34,13,48,453,56,106,-50
34,13,51,13,0,70,-70
34,13,51,59,71,130,-59
34,13,51,87,0,76,-76
34,13,51,700,0,61,-61
34,13,51,710,0,69,-69
34,13,51,810,0,54,-54
34,13,53,33,83,160,-77
34,15,4,13,0,61,-61
34,15,6,37,0,64,-64
34,15,10,1,0,98,-98
34,15,10,3,284,422,-138
34,15,10,5,0,80,-80
34,15,12,9,0,64,-64
34,15,12,11,0,59,-59
34,15,12,71,0,96,-96
34,15,12,95,0,81,-81
34,15,12,99,0,78,-78
34,15,12,103,0,78,-78
34,15,12,105,0,65,-65
34,15,34,1,758,864,-106
34,15,34,3,95,68,27
34,15,34,5,1203,1134,69
34,15,34,7,7255,5999,1256
34,15,34,9,276,344,-68
34,15,34,11,1052,836,216
34,15,34,13,91,61,30
34,15,34,17,71,61,10
34,15,34,21,105,130,-25
34,15,34,23,222,107,115
34,15,34,25,92,70,22
34,15,34,29,179,115,64
34,15,34,33,926,1136,-210
34,15,34,35,0,68,-68
34,15,34,39,67,0,67
34,15,36,47,99,0,99
34,15,36,81,106,0,106
34,15,42,17,205,212,-7
34,15,42,29,90,147,-57
34,15,42,45,525,385,140
34,15,42,91,206,269,-63
34,15,42,101,1576,1117,459
34,15,45,51,0,85,-85
34,17,4,13,227,248,-21
34,17,6,1,221,281,-60
34,17,6,13,0,111,-111
34,17,6,37,479,931,-452
34,17,6,59,150,216,-66
34,17,6,65,56,49,7
34,17,6,73,155,265,-110
34,17,6,75,180,345,-165
34,17,6,81,72,189,-117
34,17,6,85,294,580,-286
34,17,8,13,0,68,-68
34,17,8,31,0,139,-139
34,17,9,1,432,539,-107
34,17,9,3,173,203,-30
34,17,9,9,130,122,8
34,17,10,1,0,66,-66
34,17,10,3,169,203,-34
34,17,11,1,214,184,30
34,17,12,11,282,488,-206
34,17,12,21,0,86,-86
34,17,12,31,78,141,-63
34,17,12,57,191,520,-329
34,17,12,71,0,170,-170
34,17,12,86,503,701,-198
34,17,12,95,183,400,-217
34,17,12,97,65,234,-169
34,17,12,99,171,345,-174
34,17,12,101,0,94,-94
34,17,12,103,58,201,-143
34,17,12,105,0,131,-131
34,17,12,115,0,76,-76
34,17,12,117,0,110,-110
34,17,12,127,0,67,-67
34,17,13,67,58,88,-30
34,17,13,89,76,114,-38
34,17,13,121,205,220,-15
34,17,13,135,0,87,-87
34,17,17,31,627,519,108
34,17,17,43,59,56,3
34,17,18,97,0,75,-75
34,17,20,91,0,65,-65
34,17,21,111,0,78,-78
34,17,24,5,110,89,21
34,17,24,27,0,65,-65
34,17,24,31,224,253,-29
34,17,24,33,150,121,29
34,17,24,510,146,91,55
34,17,25,9,62,85,-23
34,17,25,17,435,396,39
34,17,25,21,135,135,0
34,17,25,25,364,254,110
34,17,25,27,72,68,4
34,17,26,125,75,76,-1
34,17,26,161,55,63,-8
34,17,26,163,0,67,-67
34,17,27,53,100,126,-26
34,17,29,95,0,52,-52
34,17,29,189,51,69,-18
34,17,32,3,84,170,-86
34,17,34,1,141,113,28
34,17,34,3,5656,10368,-4712
34,17,34,5,253,292,-39
34,17,34,7,131,303,-172
34,17,34,13,4328,7607,-3279
34,17,34,15,61,71,-10
34,17,34,19,176,206,-30
34,17,34,21,540,709,-169
34,17,34,23,2856,4645,-1789
34,17,34,25,1390,1861,-471
34,17,34,27,1512,2109,-597
34,17,34,29,484,927,-443
34,17,34,31,1437,2420,-983
34,17,34,35,928,923,5
34,17,34,37,193,330,-137
34,17,34,39,2121,4573,-2452
34,17,34,41,75,204,-129
34,17,36,1,77,73,4
34,17,36,5,1559,878,681
34,17,36,7,44,0,44
34,17,36,27,88,61,27
34,17,36,29,145,73,72
34,17,36,47,4326,2420,1906
34,17,36,55,127,75,52
34,17,36,59,633,675,-42
34,17,36,61,8848,4652,4196
34,17,36,67,133,53,80
34,17,36,71,191,160,31
34,17,36,81,3943,2082,1861
34,17,36,85,609,348,261
34,17,36,87,338,220,118
34,17,36,91,0,60,-60
34,17,36,103,497,380,117
34,17,36,109,63,0,63
34,17,36,111,0,73,-73
34,17,36,119,674,693,-19
34,17,37,63,69,69,0
34,17,37,81,0,57,-57
34,17,37,119,228,441,-213
34,17,37,183,161,374,-213
34,17,39,35,78,66,12
34,17,39,49,107,217,-110
34,17,39,61,89,0,89
34,17,41,51,0,58,-58
34,17,42,3,235,183,52
34,17,42,11,0,101,-101
34,17,42,17,179,169,10
34,17,42,27,42,0,42
34,17,42,29,97,149,-52
34,17,42,45,80,79,1
34,17,42,69,57,72,-15
34,17,42,71,0,80,-80
34,17,42,77,91,244,-153
34,17,42,79,72,184,-112
34,17,42,89,117,215,-98
34,17,42,91,188,185,3
34,17,42,95,91,281,-190
34,17,42,101,530,630,-100
34,17,42,103,0,55,-55
34,17,44,7,113,88,25
34,17,45,19,51,71,-20
34,17,47,37,87,151,-64
34,17,48,29,71,75,-4
34,17,48,85,93,263,-170
34,17,48,113,219,340,-121
34,17,48,121,0,107,-107
34,17,48,157,0,101,-101
34,17,48,201,311,373,-62
34,17,48,439,79,119,-40
34,17,48,453,131,193,-62
34,17,48,491,0,68,-68
34,17,49,35,90,73,17
34,17,51,13,137,101,36
34,17,51,59,217,288,-71
34,17,51,87,0,68,-68
34,17,51,107,58,83,-25
34,17,51,510,54,83,-29
34,17,51,810,0,72,-72
34,17,53,33,234,592,-358
34,17,55,25,53,0,53
34,19,12,99,0,65,-65
34,19,25,17,0,67,-67
34,19,34,3,157,75,82
34,19,34,5,83,84,-1
34,19,34,13,193,109,84
34,19,34,17,206,176,30
34,19,34,21,403,300,103
34,19,34,23,834,317,517
34,19,34,25,167,191,-24
34,19,34,27,616,425,191
34,19,34,29,162,235,-73
34,19,34,31,60,55,5
34,19,34,35,2119,976,1143
34,19,34,37,61,0,61
34,19,34,39,515,181,334
34,19,34,41,627,857,-230
34,19,36,47,105,89,16
34,19,36,61,94,118,-24
34,19,36,81,0,52,-52
34,19,36,85,102,0,102
34,19,37,183,0,80,-80
34,19,42,17,357,504,-147
34,19,42,77,0,92,-92
34,19,42,91,70,84,-14
34,19,42,95,187,372,-185
34,19,42,101,66,143,-77
34,21,4,13,0,139,-139
34,21,6,1,86,120,-34
34,21,6,37,159,193,-34
34,21,6,59,0,65,-65
34,21,6,73,84,154,-70
34,21,6,75,48,98,-50
34,21,6,81,0,57,-57
34,21,6,85,114,130,-16
34,21,9,1,104,68,36
34,21,9,9,111,69,42
34,21,10,3,74,119,-45
34,21,10,5,0,68,-68
34,21,11,1,100,139,-39
34,21,12,11,75,98,-23
34,21,12,21,0,62,-62
34,21,12,31,0,67,-67
34,21,12,57,71,110,-39
34,21,12,71,0,72,-72
34,21,12,86,58,74,-16
34,21,12,95,0,101,-101
34,21,12,99,107,126,-19
34,21,12,103,0,52,-52
34,21,12,115,0,69,-69
34,21,13,121,58,92,-34
34,21,17,31,124,141,-17
34,21,24,31,110,157,-47
34,21,24,33,77,81,-4
34,21,24,510,57,77,-20
34,21,25,17,153,242,-89
34,21,25,25,63,97,-34
34,21,27,53,0,63,-63
34,21,32,3,0,62,-62
34,21,34,1,125,75,50
34,21,34,3,336,229,107
34,21,34,5,1970,3509,-1539
34,21,34,7,358,451,-93
34,21,34,13,480,286,194
34,21,34,15,130,105,25
34,21,34,17,709,540,169
34,21,34,19,300,403,-103
34,21,34,23,4266,2570,1696
34,21,34,25,962,811,151
34,21,34,27,237,182,55
34,21,34,29,745,822,-77
34,21,34,31,164,116,48
34,21,34,35,1210,923,287
34,21,34,39,527,254,273
34,21,34,41,57,0,57
34,21,36,5,239,87,152
34,21,36,47,534,303,231
34,21,36,59,132,64,68
34,21,36,61,573,737,-164
34,21,36,81,318,217,101
34,21,36,85,138,0,138
34,21,36,103,94,67,27
34,21,36,119,108,64,44
34,21,37,63,0,55,-55
34,21,37,119,0,127,-127
34,21,37,183,0,156,-156
34,21,42,3,60,53,7
34,21,42,17,1330,2390,-1060
34,21,42,29,71,141,-70
34,21,42,45,101,116,-15
34,21,42,91,136,225,-89
34,21,42,95,0,85,-85
34,21,42,101,484,736,-252
34,21,45,51,0,135,-135
34,21,48,85,0,70,-70
34,21,48,113,0,78,-78
34,21,48,201,114,98,16
34,21,48,453,0,83,-83
34,21,51,59,79,130,-51
34,21,53,33,64,147,-83
34,23,4,13,242,303,-61
34,23,6,1,165,259,-94
34,23,6,13,72,67,5
34,23,6,37,346,461,-115
34,23,6,59,112,183,-71
34,23,6,65,60,0,60
34,23,6,67,0,64,-64
34,23,6,71,0,64,-64
34,23,6,73,158,234,-76
34,23,6,75,55,122,-67
34,23,6,81,0,70,-70
34,23,6,85,185,360,-175
34,23,8,5,0,65,-65
34,23,8,31,0,62,-62
34,23,9,1,279,205,74
34,23,9,3,206,189,17
34,23,9,9,172,128,44
34,23,10,1,0,100,-100
34,23,10,3,215,361,-146
34,23,10,5,0,160,-160
34,23,11,1,87,114,-27
34,23,12,9,0,79,-79
34,23,12,11,259,373,-114
34,23,12,21,0,115,-115
34,23,12,31,92,153,-61
34,23,12,57,214,577,-363
34,23,12,69,0,75,-75
34,23,12,71,0,155,-155
34,23,12,81,0,80,-80
34,23,12,83,0,60,-60
34,23,12,86,181,212,-31
34,23,12,95,150,338,-188
34,23,12,97,104,192,-88
34,23,12,99,284,575,-291
34,23,12,101,0,104,-104
34,23,12,103,63,192,-129
34,23,12,105,56,168,-112
34,23,12,111,0,86,-86
34,23,12,115,0,137,-137
34,23,12,117,0,156,-156
34,23,12,127,0,94,-94
34,23,13,67,74,133,-59
34,23,13,89,0,129,-129
34,23,13,117,0,96,-96
34,23,13,121,144,291,-147
34,23,13,135,76,177,-101
34,23,15,3,55,0,55
34,23,17,31,355,313,42
34,23,17,43,106,106,0
34,23,17,97,60,69,-9
34,23,18,97,0,84,-84
34,23,20,91,0,68,-68
34,23,24,3,96,137,-41
34,23,24,5,137,164,-27
34,23,24,27,0,100,-100
34,23,24,31,172,295,-123
34,23,24,33,162,144,18
34,23,24,510,66,76,-10
34,23,25,9,58,66,-8
34,23,25,17,272,392,-120
34,23,25,21,121,177,-56
34,23,25,25,134,125,9
34,23,25,27,118,141,-23
34,23,26,125,96,126,-30
34,23,26,161,0,53,-53
34,23,26,163,0,76,-76
34,23,27,53,96,111,-15
34,23,29,189,80,100,-20
34,23,32,3,65,175,-110
34,23,34,1,196,151,45
34,23,34,3,1707,1382,325
34,23,34,5,568,1457,-889
34,23,34,7,335,484,-149
34,23,34,9,0,71,-71
34,23,34,13,2830,1929,901
34,23,34,15,107,222,-115
34,23,34,17,4645,2856,1789
34,23,34,19,317,834,-517
34,23,34,21,2570,4266,-1696
34,23,34,25,4158,6538,-2380
34,23,34,27,951,1190,-239
34,23,34,29,1344,2899,-1555
34,23,34,31,674,485,189
34,23,34,35,5775,7949,-2174
34,23,34,37,121,134,-13
34,23,34,39,6807,4846,1961
34,23,34,41,215,408,-193
34,23,36,1,104,54,50
34,23,36,5,729,345,384
34,23,36,29,71,80,-9
34,23,36,47,2131,894,1237
34,23,36,55,109,55,54
34,23,36,59,403,311,92
34,23,36,61,929,1139,-210
34,23,36,67,56,0,56
34,23,36,71,138,95,43
34,23,36,81,1557,758,799
34,23,36,85,2370,550,1820
34,23,36,87,120,91,29
34,23,36,103,328,221,107
34,23,36,109,55,0,55
34,23,36,119,261,198,63
34,23,37,19,0,69,-69
34,23,37,25,0,84,-84
34,23,37,63,61,64,-3
34,23,37,81,0,127,-127
34,23,37,119,201,482,-281
34,23,37,179,0,83,-83
34,23,37,183,193,449,-256
34,23,39,35,79,103,-24
34,23,39,49,133,178,-45
34,23,42,3,172,176,-4
34,23,42,11,68,106,-38
34,23,42,17,315,658,-343
34,23,42,27,59,0,59
34,23,42,29,113,216,-103
34,23,42,41,0,82,-82
34,23,42,43,0,72,-72
34,23,42,45,78,131,-53
34,23,42,69,0,71,-71
34,23,42,71,0,60,-60
34,23,42,77,135,205,-70
34,23,42,79,79,114,-35
34,23,42,89,101,243,-142
34,23,42,91,222,376,-154
34,23,42,95,157,386,-229
34,23,42,101,360,576,-216
34,23,42,103,0,68,-68
34,23,44,7,73,94,-21
34,23,45,13,0,69,-69
34,23,45,19,0,58,-58
34,23,45,45,0,67,-67
34,23,45,51,0,167,-167
34,23,45,91,0,94,-94
34,23,47,37,0,65,-65
34,23,47,157,0,71,-71
34,23,48,29,78,101,-23
34,23,48,85,131,503,-372
34,23,48,113,201,368,-167
34,23,48,121,0,121,-121
34,23,48,157,0,156,-156
34,23,48,201,238,296,-58
34,23,48,439,72,134,-62
34,23,48,453,111,191,-80
34,23,48,491,0,97,-97
34,23,51,13,54,47,7
34,23,51,59,207,264,-57
34,23,51,87,69,123,-54
34,23,51,107,80,204,-124
34,23,51,810,0,90,-90
34,23,53,33,124,467,-343
34,23,55,25,0,56,-56
34,25,4,13,70,186,-116
34,25,6,1,0,69,-69
34,25,6,37,183,338,-155
34,25,6,59,64,47,17
34,25,6,73,120,197,-77
34,25,6,75,0,57,-57
34,25,6,85,0,94,-94
34,25,8,41,0,66,-66
34,25,9,1,120,107,13
34,25,9,9,0,61,-61
34,25,10,3,0,97,-97
34,25,10,5,0,136,-136
34,25,11,1,83,112,-29
34,25,12,9,0,85,-85
34,25,12,11,154,292,-138
34,25,12,21,63,225,-162
34,25,12,31,0,72,-72
34,25,12,35,0,60,-60
34,25,12,53,0,61,-61
34,25,12,57,79,174,-95
34,25,12,61,0,90,-90
34,25,12,71,71,210,-139
34,25,12,81,0,133,-133
34,25,12,85,0,98,-98
34,25,12,86,96,130,-34
34,25,12,95,0,194,-194
34,25,12,99,261,781,-520
34,25,12,101,0,105,-105
34,25,12,103,63,191,-128
34,25,12,105,0,77,-77
34,25,12,109,0,135,-135
34,25,12,111,0,105,-105
34,25,12,115,51,149,-98
34,25,12,117,0,67,-67
34,25,12,127,0,89,-89
34,25,13,121,61,63,-2
34,25,17,31,79,105,-26
34,25,24,3,68,86,-18
34,25,24,5,79,52,27
34,25,24,25,0,72,-72
34,25,24,31,106,110,-4
34,25,24,33,106,83,23
34,25,24,510,63,81,-18
34,25,25,17,99,104,-5
34,25,25,25,96,90,6
34,25,32,3,0,103,-103
34,25,34,1,146,190,-44
34,25,34,3,1058,581,477
34,25,34,5,403,664,-261
34,25,34,7,141,238,-97
34,25,34,9,54,64,-10
34,25,34,13,1174,553,621
34,25,34,15,70,92,-22
34,25,34,17,1861,1390,471
34,25,34,19,191,167,24
34,25,34,21,811,962,-151
34,25,34,23,6538,4158,2380
34,25,34,27,757,480,277
34,25,34,29,6126,8623,-2497
34,25,34,31,359,166,193
34,25,34,35,828,540,288
34,25,34,37,119,61,58
34,25,34,39,1521,799,722
34,25,34,41,75,100,-25
34,25,36,5,150,75,75
34,25,36,47,1854,769,1085
34,25,36,59,237,157,80
34,25,36,61,1107,1304,-197
34,25,36,71,90,62,28
34,25,36,81,577,328,249
34,25,36,85,3095,506,2589
34,25,36,87,77,0,77
34,25,36,103,160,149,11
34,25,36,119,206,116,90
34,25,37,19,0,116,-116
34,25,37,119,60,190,-130
34,25,37,183,0,115,-115
34,25,42,3,0,46,-46
34,25,42,17,165,314,-149
34,25,42,29,69,78,-9
34,25,42,45,0,76,-76
34,25,42,71,0,56,-56
34,25,42,77,66,0,66
34,25,42,89,58,103,-45
34,25,42,91,111,130,-19
34,25,42,95,0,113,-113
34,25,42,101,250,360,-110
34,25,45,13,0,108,-108
34,25,45,19,0,63,-63
34,25,45,51,0,239,-239
34,25,48,113,0,92,-92
34,25,48,201,84,109,-25
34,25,48,453,0,70,-70
34,25,51,13,0,51,-51
34,25,51,59,63,92,-29
34,25,53,33,52,105,-53
34,27,4,13,156,257,-101
34,27,6,1,74,78,-4
34,27,6,37,173,315,-142
34,27,6,59,0,121,-121
34,27,6,73,137,174,-37
34,27,6,75,54,82,-28
34,27,6,85,62,104,-42
34,27,8,31,0,86,-86
34,27,9,1,176,170,6
34,27,9,3,106,81,25
34,27,9,9,87,83,4
34,27,10,3,89,110,-21
34,27,10,5,0,168,-168
34,27,11,1,73,119,-46
34,27,12,9,0,70,-70
34,27,12,11,117,247,-130
34,27,12,21,50,171,-121
34,27,12,31,0,61,-61
34,27,12,57,64,187,-123
34,27,12,71,70,168,-98
34,27,12,81,0,120,-120
34,27,12,86,94,123,-29
34,27,12,95,56,161,-105
34,27,12,99,208,531,-323
34,27,12,101,0,91,-91
34,27,12,103,70,96,-26
34,27,12,109,0,86,-86
34,27,12,115,0,163,-163
34,27,12,127,0,57,-57
34,27,13,67,0,59,-59
34,27,13,121,64,111,-47
34,27,17,31,171,235,-64
34,27,24,5,0,57,-57
34,27,24,31,134,113,21
34,27,24,33,62,57,5
34,27,24,510,0,55,-55
34,27,25,17,110,187,-77
34,27,25,21,0,65,-65
34,27,25,25,90,114,-24
34,27,32,3,89,85,4
34,27,34,1,56,92,-36
34,27,34,3,3106,1458,1648
34,27,34,5,143,146,-3
34,27,34,7,63,111,-48
34,27,34,9,0,84,-84
34,27,34,13,4437,2446,1991
34,27,34,17,2109,1512,597
34,27,34,19,425,616,-191
34,27,34,21,182,237,-55
34,27,34,23,1190,951,239
34,27,34,25,480,757,-277
34,27,34,29,476,816,-340
34,27,34,31,3723,2150,1573
34,27,34,35,1612,1843,-231
34,27,34,37,2147,2786,-639
34,27,34,39,1850,1272,578
34,27,34,41,978,1525,-547
34,27,36,5,142,89,53
34,27,36,47,436,427,9
34,27,36,59,166,103,63
34,27,36,61,797,1052,-255
34,27,36,71,151,155,-4
34,27,36,81,384,251,133
34,27,36,85,194,0,194
34,27,36,87,161,94,67
34,27,36,103,205,185,20
34,27,36,119,200,151,49
34,27,37,19,0,95,-95
34,27,37,119,71,260,-189
34,27,37,129,0,56,-56
34,27,37,179,0,66,-66
34,27,37,183,65,256,-191
34,27,39,49,0,65,-65
34,27,42,3,99,113,-14
34,27,42,17,104,171,-67
34,27,42,19,0,136,-136
34,27,42,29,76,114,-38
34,27,42,69,0,53,-53
34,27,42,77,66,111,-45
34,27,42,79,49,0,49
34,27,42,89,162,281,-119
34,27,42,91,138,176,-38
34,27,42,95,119,240,-121
34,27,42,101,123,231,-108
34,27,42,103,91,105,-14
34,27,45,13,0,102,-102
34,27,45,19,0,79,-79
34,27,45,51,0,217,-217
34,27,47,37,0,70,-70
34,27,48,85,0,157,-157
34,27,48,113,0,156,-156
34,27,48,201,99,143,-44
34,27,48,439,0,68,-68
34,27,48,453,50,145,-95
34,27,51,13,0,62,-62
34,27,51,59,106,170,-64
34,27,51,107,0,84,-84
34,27,53,33,69,211,-142
34,29,4,13,105,140,-35
34,29,6,37,137,201,-64
34,29,6,59,0,47,-47
34,29,6,73,102,145,-43
34,29,9,1,69,89,-20
34,29,10,3,67,97,-30
34,29,10,5,54,122,-68
34,29,12,9,52,127,-75
34,29,12,11,142,231,-89
34,29,12,15,0,102,-102
34,29,12,21,72,155,-83
34,29,12,31,50,82,-32
34,29,12,35,0,79,-79
34,29,12,53,0,87,-87
34,29,12,57,75,165,-90
34,29,12,61,0,117,-117
34,29,12,69,0,72,-72
34,29,12,71,134,270,-136
34,29,12,81,0,90,-90
34,29,12,83,0,60,-60
34,29,12,85,64,89,-25
34,29,12,86,59,91,-32
34,29,12,95,88,125,-37
34,29,12,97,0,62,-62
34,29,12,99,243,427,-184
34,29,12,101,0,116,-116
34,29,12,103,83,159,-76
34,29,12,105,0,91,-91
34,29,12,109,0,77,-77
34,29,12,111,61,131,-70
34,29,12,115,72,224,-152
34,29,12,119,0,70,-70
34,29,12,127,0,124,-124
34,29,17,31,66,93,-27
34,29,24,3,0,52,-52
34,29,24,5,0,58,-58
34,29,24,25,0,71,-71
34,29,24,31,0,75,-75
34,29,24,510,66,74,-8
34,29,25,17,53,0,53
34,29,32,3,53,83,-30
34,29,34,1,562,804,-242
34,29,34,3,1441,557,884
34,29,34,5,1108,1617,-509
34,29,34,7,284,359,-75
34,29,34,9,104,98,6
34,29,34,11,65,0,65
34,29,34,13,1079,453,626
34,29,34,15,115,179,-64
34,29,34,17,927,484,443
34,29,34,19,235,162,73
34,29,34,21,822,745,77
34,29,34,23,2899,1344,1555
34,29,34,25,8623,6126,2497
34,29,34,27,816,476,340
34,29,34,31,693,275,418
34,29,34,35,670,390,280
34,29,34,37,205,134,71
34,29,34,39,1300,446,854
34,29,34,41,174,107,67
34,29,36,5,137,0,137
34,29,36,47,2601,408,2193
34,29,36,59,156,97,59
34,29,36,61,251,291,-40
34,29,36,71,92,69,23
34,29,36,81,387,193,194
34,29,36,85,915,299,616
34,29,36,87,292,163,129
34,29,36,103,108,105,3
34,29,36,119,119,82,37
34,29,37,19,0,100,-100
34,29,37,119,0,69,-69
34,29,37,129,0,56,-56
34,29,37,133,0,58,-58
34,29,37,183,0,91,-91
34,29,39,35,0,85,-85
34,29,42,17,266,307,-41
34,29,42,29,66,83,-17
34,29,42,71,0,64,-64
34,29,42,77,63,57,6
34,29,42,89,55,68,-13
34,29,42,91,121,202,-81
34,29,42,95,69,89,-20
34,29,42,101,225,338,-113
34,29,42,103,49,0,49
34,29,45,13,0,62,-62
34,29,45,19,0,73,-73
34,29,45,45,0,75,-75
34,29,45,51,66,388,-322
34,29,51,59,0,55,-55
34,29,51,107,0,57,-57
34,29,51,810,0,55,-55
34,29,53,33,0,48,-48
34,31,4,13,68,81,-13
34,31,6,1,0,55,-55
34,31,6,37,81,232,-151
34,31,6,73,82,74,8
34,31,9,1,60,109,-49
34,31,9,3,0,65,-65
34,31,9,9,59,0,59
34,31,10,1,0,57,-57
34,31,10,3,0,68,-68
34,31,10,5,0,64,-64
34,31,12,11,145,205,-60
34,31,12,21,0,71,-71
34,31,12,57,86,216,-130
34,31,12,69,0,60,-60
34,31,12,71,0,102,-102
34,31,12,86,151,162,-11
34,31,12,95,74,181,-107
34,31,12,97,72,201,-129
34,31,12,99,118,345,-227
34,31,12,101,0,87,-87
34,31,12,103,0,91,-91
34,31,12,105,0,115,-115
34,31,12,115,0,59,-59
34,31,12,117,0,83,-83
34,31,12,127,0,83,-83
34,31,13,67,0,86,-86
34,31,13,135,0,129,-129
34,31,17,31,60,100,-40
34,31,24,31,0,93,-93
34,31,24,510,0,64,-64
34,31,25,9,0,69,-69
34,31,25,17,0,66,-66
34,31,25,25,0,57,-57
34,31,32,3,0,66,-66
34,31,34,3,8191,7635,556
34,31,34,5,94,117,-23
34,31,34,7,51,88,-37
34,31,34,13,3117,3641,-524
34,31,34,17,2420,1437,983
34,31,34,19,55,60,-5
34,31,34,21,116,164,-48
34,31,34,23,485,674,-189
34,31,34,25,166,359,-193
34,31,34,27,2150,3723,-1573
34,31,34,29,275,693,-418
34,31,34,35,154,313,-159
34,31,34,37,493,1281,-788
34,31,34,39,514,593,-79
34,31,34,41,84,214,-130
34,31,36,5,1093,449,644
34,31,36,47,752,317,435
34,31,36,59,149,126,23
34,31,36,61,789,621,168
34,31,36,71,184,313,-129
34,31,36,81,820,292,528
34,31,36,85,112,91,21
34,31,36,87,416,185,231
34,31,36,103,111,80,31
34,31,36,119,219,157,62
34,31,37,119,0,164,-164
34,31,37,183,0,138,-138
34,31,42,11,0,103,-103
34,31,42,17,0,70,-70
34,31,42,77,56,273,-217
34,31,42,79,136,399,-263
34,31,42,89,77,313,-236
34,31,42,95,0,129,-129
34,31,42,101,102,160,-58
34,31,42,103,0,73,-73
34,31,44,7,0,72,-72
34,31,45,51,0,75,-75
34,31,48,113,0,67,-67
34,31,48,201,0,109,-109
34,31,48,453,0,51,-51
34,31,51,59,0,77,-77
34,33,10,3,282,410,-128
34,33,34,1,79,118,-39
34,33,34,5,104,73,31
34,33,34,7,398,310,88
34,33,34,11,694,590,104
34,33,34,15,1136,926,210
34,33,42,45,88,55,33
34,33,42,101,141,112,29
34,35,4,13,51,97,-46
34,35,6,1,0,105,-105
34,35,6,37,119,232,-113
34,35,6,59,0,86,-86
34,35,6,73,106,115,-9
34,35,6,75,0,54,-54
34,35,6,85,67,182,-115
34,35,8,31,0,48,-48
34,35,9,1,134,132,2
34,35,9,3,83,0,83
34,35,9,9,62,0,62
34,35,10,1,0,60,-60
34,35,10,3,85,84,1
34,35,10,5,0,108,-108
34,35,11,1,46,82,-36
34,35,12,11,76,124,-48
34,35,12,21,0,64,-64
34,35,12,31,0,59,-59
34,35,12,57,0,132,-132
34,35,12,71,0,158,-158
34,35,12,86,0,65,-65
34,35,12,95,0,128,-128
34,35,12,99,86,270,-184
34,35,12,103,0,111,-111
34,35,13,121,0,82,-82
34,35,13,135,0,62,-62
34,35,17,31,151,143,8
34,35,24,5,62,0,62
34,35,24,31,124,118,6
34,35,24,510,51,0,51
34,35,25,17,117,189,-72
34,35,25,21,0,55,-55
34,35,25,25,62,67,-5
34,35,34,1,56,56,0
34,35,34,3,647,409,238
34,35,34,5,207,371,-164
34,35,34,7,97,137,-40
34,35,34,13,1226,730,496
34,35,34,15,68,0,68
34,35,34,17,923,928,-5
34,35,34,19,976,2119,-1143
34,35,34,21,923,1210,-287
34,35,34,23,7949,5775,2174
34,35,34,25,540,828,-288
34,35,34,27,1843,1612,231
34,35,34,29,390,670,-280
34,35,34,31,313,154,159
34,35,34,37,116,93,23
34,35,34,39,3639,2207,1432
34,35,34,41,280,392,-112
34,35,36,5,155,54,101
34,35,36,47,417,301,116
34,35,36,59,143,63,80
34,35,36,61,472,634,-162
34,35,36,81,372,194,178
34,35,36,85,211,61,150
34,35,36,103,112,78,34
34,35,36,119,76,83,-7
34,35,37,19,0,76,-76
34,35,37,119,59,147,-88
34,35,37,183,0,173,-173
34,35,39,49,0,60,-60
34,35,42,3,58,52,6
34,35,42,17,150,346,-196
34,35,42,29,71,92,-21
34,35,42,45,0,62,-62
34,35,42,77,95,148,-53
34,35,42,89,0,70,-70
34,35,42,91,99,115,-16
34,35,42,95,112,212,-100
34,35,42,101,138,257,-119
34,35,45,19,0,63,-63
34,35,45,51,0,111,-111
34,35,48,85,0,141,-141
34,35,48,113,67,91,-24
34,35,48,121,0,63,-63
34,35,48,201,74,141,-67
34,35,48,453,0,74,-74
34,35,51,59,94,107,-13
34,35,53,33,0,120,-120
34,37,4,13,0,60,-60
34,37,6,37,0,50,-50
34,37,6,73,0,49,-49
34,37,12,71,0,71,-71
34,37,12,99,50,86,-36
34,37,12,103,0,59,-59
34,37,34,3,848,390,458
34,37,34,13,631,311,320
34,37,34,17,330,193,137
34,37,34,19,0,61,-61
34,37,34,23,134,121,13
34,37,34,25,61,119,-58
34,37,34,27,2786,2147,639
34,37,34,29,134,205,-71
34,37,34,31,1281,493,788
34,37,34,35,93,116,-23
34,37,34,39,190,114,76
34,37,34,41,464,630,-166
34,37,36,47,61,60,1
34,37,36,61,117,90,27
34,37,36,71,317,216,101
34,37,36,81,80,63,17
34,37,36,85,69,0,69
34,37,36,87,62,0,62
34,37,42,89,75,126,-51
34,37,42,95,0,123,-123
34,37,42,101,0,46,-46
34,37,42,103,206,322,-116
34,37,45,51,0,64,-64
34,39,4,13,61,167,-106
34,39,6,37,150,258,-108
34,39,6,59,0,72,-72
34,39,6,73,102,107,-5
34,39,6,75,0,54,-54
34,39,6,85,0,62,-62
34,39,8,31,0,61,-61
34,39,9,1,100,93,7
34,39,9,3,54,0,54
34,39,9,9,0,61,-61
34,39,10,3,58,99,-41
34,39,10,5,0,70,-70
34,39,11,1,53,62,-9
34,39,12,11,147,331,-184
34,39,12,31,0,90,-90
34,39,12,57,75,217,-142
34,39,12,71,0,107,-107
34,39,12,81,0,57,-57
34,39,12,86,175,321,-146
34,39,12,95,124,270,-146
34,39,12,97,0,119,-119
34,39,12,99,150,324,-174
34,39,12,101,0,73,-73
34,39,12,103,0,83,-83
34,39,12,105,0,91,-91
34,39,12,115,0,74,-74
34,39,12,127,0,65,-65
34,39,13,67,0,88,-88
34,39,13,89,0,86,-86
34,39,13,121,0,90,-90
34,39,13,135,0,97,-97
34,39,17,31,114,112,2
34,39,24,3,0,62,-62
34,39,24,5,71,76,-5
34,39,24,31,154,166,-12
34,39,24,33,112,119,-7
34,39,24,510,71,94,-23
34,39,25,17,82,148,-66
34,39,25,25,73,91,-18
34,39,32,3,0,101,-101
34,39,34,1,0,64,-64
34,39,34,3,1038,918,120
34,39,34,5,175,369,-194
34,39,34,7,132,195,-63
34,39,34,13,8233,5998,2235
34,39,34,15,0,67,-67
34,39,34,17,4573,2121,2452
34,39,34,19,181,515,-334
34,39,34,21,254,527,-273
34,39,34,23,4846,6807,-1961
34,39,34,25,799,1521,-722
34,39,34,27,1272,1850,-578
34,39,34,29,446,1300,-854
34,39,34,31,593,514,79
34,39,34,35,2207,3639,-1432
34,39,34,37,114,190,-76
34,39,34,41,147,393,-246
34,39,36,5,781,296,485
34,39,36,47,1966,616,1350
34,39,36,59,265,96,169
34,39,36,61,1302,950,352
34,39,36,81,1319,528,791
34,39,36,85,681,208,473
34,39,36,87,97,59,38
34,39,36,103,220,126,94
34,39,36,119,241,150,91
34,39,37,67,0,64,-64
34,39,37,81,0,103,-103
34,39,37,119,94,186,-92
34,39,37,183,0,200,-200
34,39,42,3,68,0,68
34,39,42,17,56,173,-117
34,39,42,29,0,67,-67
34,39,42,77,102,152,-50
34,39,42,79,0,81,-81
34,39,42,89,86,150,-64
34,39,42,91,98,97,1
34,39,42,95,104,317,-213
34,39,42,101,181,248,-67
34,39,45,51,0,114,-114
34,39,48,113,0,71,-71
34,39,48,201,128,200,-72
34,39,48,439,0,65,-65
34,39,48,453,0,61,-61
34,39,51,59,0,79,-79
34,39,53,33,0,82,-82
34,41,34,3,277,87,190
34,41,34,13,410,171,239
34,41,34,17,204,75,129
34,41,34,19,857,627,230
34,41,34,21,0,57,-57
34,41,34,23,408,215,193
34,41,34,25,100,75,25
34,41,34,27,1525,978,547
34,41,34,29,107,174,-67
34,41,34,31,214,84,130
34,41,34,35,392,280,112
34,41,34,37,630,464,166
34,41,34,39,393,147,246
34,41,36,47,83,0,83
34,41,36,61,58,59,-1
34,41,36,81,67,0,67
34,41,42,17,62,127,-65
34,41,42,77,99,194,-95
34,41,42,89,151,281,-130
34,41,42,91,0,56,-56
34,41,42,95,673,1056,-383
34,41,45,51,0,69,-69
35,1,2,20,108,0,108
35,1,4,1,161,136,25
35,1,4,5,61,76,-15
35,1,4,13,980,1759,-779
35,1,4,15,0,74,-74
35,1,4,17,69,80,-11
35,1,4,19,392,440,-48
35,1,4,21,84,132,-48
35,1,4,25,0,107,-107
35,1,6,1,147,116,31
35,1,6,13,102,68,34
35,1,6,29,0,72,-72
35,1,6,37,727,647,80
35,1,6,59,242,220,22
35,1,6,65,223,161,62
35,1,6,67,99,103,-4
35,1,6,71,173,109,64
35,1,6,73,467,475,-8
35,1,6,75,77,69,8
35,1,6,83,67,0,67
35,1,6,85,177,126,51
35,1,6,97,51,0,51
35,1,6,111,71,81,-10
35,1,8,1,190,232,-42
35,1,8,5,225,332,-107
35,1,8,13,116,157,-41
35,1,8,31,269,316,-47
35,1,8,35,117,125,-8
35,1,8,41,255,533,-278
35,1,8,59,172,221,-49
35,1,8,67,102,137,-35
35,1,8,69,83,147,-64
35,1,8,77,0,54,-54
35,1,8,101,0,66,-66
35,1,8,123,0,87,-87
35,1,11,1,75,79,-4
35,1,12,9,0,89,-89
35,1,12,11,102,66,36
35,1,12,33,56,0,56
35,1,12,57,95,137,-42
35,1,12,86,83,105,-22
35,1,12,91,73,176,-103
35,1,12,95,61,90,-29
35,1,12,99,50,54,-4
35,1,12,103,88,95,-7
35,1,12,113,0,65,-65
35,1,13,121,67,61,6
35,1,13,185,0,74,-74
35,1,15,3,81,98,-17
35,1,16,1,48,103,-55
35,1,17,31,237,168,69
35,1,18,97,55,0,55
35,1,20,173,0,58,-58
35,1,24,3,0,65,-65
35,1,24,31,103,0,103
35,1,25,17,59,64,-5
35,1,25,25,0,51,-51
35,1,26,163,56,0,56
35,1,27,53,0,88,-88
35,1,29,95,90,0,90
35,1,31,55,0,76,-76
35,1,32,3,423,658,-235
35,1,32,31,52,65,-13
35,1,35,5,294,175,119
35,1,35,6,364,292,72
35,1,35,7,71,70,1
35,1,35,9,181,179,2
35,1,35,13,860,590,270
35,1,35,15,223,171,52
35,1,35,17,89,80,9
35,1,35,25,135,155,-20
35,1,35,27,99,72,27
35,1,35,28,208,175,33
35,1,35,29,87,0,87
35,1,35,31,949,613,336
35,1,35,35,153,122,31
35,1,35,37,59,0,59
35,1,35,39,334,206,128
35,1,35,41,87,0,87
35,1,35,43,5557,6462,-905
35,1,35,45,633,425,208
35,1,35,47,313,213,100
35,1,35,49,1911,1706,205
35,1,35,51,62,64,-2
35,1,35,53,283,182,101
35,1,35,55,255,244,11
35,1,35,57,310,458,-148
35,1,35,61,1880,2327,-447
35,1,36,47,68,58,10
35,1,36,61,61,65,-4
35,1,36,81,48,0,48
35,1,36,103,58,0,58
35,1,37,119,51,0,51
35,1,39,49,78,60,18
35,1,39,57,65,72,-7
35,1,39,113,81,0,81
35,1,40,109,116,112,4
35,1,40,143,80,55,25
35,1,41,39,0,59,-59
35,1,41,51,193,153,40
35,1,41,67,118,99,19
35,1,42,3,71,0,71
35,1,42,101,53,0,53
35,1,47,37,64,58,6
35,1,48,27,0,106,-106
35,1,48,29,297,436,-139
35,1,48,85,71,219,-148
35,1,48,113,222,280,-58
35,1,48,121,89,119,-30
35,1,48,135,0,74,-74
35,1,48,141,498,542,-44
35,1,48,201,329,330,-1
35,1,48,303,114,94,20
35,1,48,329,0,68,-68
35,1,48,381,66,61,5
35,1,48,439,178,340,-162
35,1,48,453,241,300,-59
35,1,48,491,86,153,-67
35,1,49,11,0,91,-91
35,1,49,35,123,192,-69
35,1,49,49,97,83,14
35,1,51,13,0,54,-54
35,1,51,59,176,156,20
35,1,51,510,50,0,50
35,1,53,11,0,76,-76
35,1,53,33,222,357,-135
35,1,53,53,113,91,22
35,1,53,61,81,74,7
35,1,53,63,0,89,-89
35,1,53,67,61,0,61
35,1,55,25,52,0,52
35,1,55,79,56,0,56
35,5,4,13,68,145,-77
35,5,35,1,175,294,-119
35,5,35,13,100,164,-64
35,5,35,15,449,307,142
35,5,35,25,86,122,-36
35,5,35,27,64,90,-26
35,5,35,35,79,0,79
35,5,35,43,0,61,-61
35,5,48,141,79,0,79
35,5,48,303,0,80,-80
35,6,35,1,292,364,-72
35,6,35,31,304,229,75
35,6,35,43,0,70,-70
35,6,35,61,85,172,-87
35,7,35,1,70,71,-1
35,7,35,55,0,54,-54
35,9,4,13,79,109,-30
35,9,6,53,61,0,61
35,9,8,41,0,71,-71
35,9,12,91,119,295,-176
35,9,12,113,0,151,-151
35,9,32,3,92,86,6
35,9,35,1,179,181,-2
35,9,35,41,404,454,-50
35,9,48,29,138,139,-1
35,9,48,141,78,0,78
35,9,48,303,138,230,-92
35,9,48,369,137,115,22
35,9,48,381,0,97,-97
35,9,48,451,51,0,51
35,13,4,13,442,538,-96
35,13,4,19,135,216,-81
35,13,6,37,234,116,118
35,13,6,59,73,0,73
35,13,6,65,86,0,86
35,13,6,71,117,0,117
35,13,6,73,148,87,61
35,13,8,5,78,105,-27
35,13,8,31,62,89,-27
35,13,8,41,112,128,-16
35,13,8,59,62,0,62
35,13,32,3,127,162,-35
35,13,35,1,590,860,-270
35,13,35,5,164,100,64
35,13,35,15,126,172,-46
35,13,35,17,220,163,57
35,13,35,25,69,110,-41
35,13,35,27,112,104,8
35,13,35,29,337,235,102
35,13,35,35,633,841,-208
35,13,35,43,117,164,-47
35,13,35,45,80,0,80
35,13,35,49,103,138,-35
35,13,35,51,148,189,-41
35,13,35,61,55,74,-19
35,13,48,29,117,176,-59
35,13,48,113,79,96,-17
35,13,48,135,72,169,-97
35,13,48,141,3384,2956,428
35,13,48,201,111,137,-26
35,13,48,329,0,166,-166
35,13,48,439,93,97,-4
35,13,48,453,60,110,-50
35,13,53,33,53,82,-29
35,15,4,13,72,0,72
35,15,12,86,50,0,50
35,15,35,1,171,223,-52
35,15,35,5,307,449,-142
35,15,35,13,172,126,46
35,15,35,25,135,178,-43
35,15,35,27,0,74,-74
35,15,35,35,54,88,-34
35,15,35,45,171,0,171
35,15,48,29,67,0,67
35,15,48,135,0,80,-80
35,15,48,141,211,169,42
35,15,48,201,91,0,91
35,15,48,303,98,116,-18
35,15,48,329,79,124,-45
35,15,48,439,73,0,73
35,17,4,13,90,103,-13
35,17,4,19,109,186,-77
35,17,35,1,80,89,-9
35,17,35,13,163,220,-57
35,25,4,13,83,68,15
35,25,12,86,74,0,74
35,25,35,1,155,135,20
35,25,35,5,122,86,36
35,25,35,13,110,69,41
35,25,35,15,178,135,43
35,25,35,45,74,0,74
35,25,48,29,0,73,-73
35,25,48,113,0,63,-63
35,25,48,135,92,258,-166
35,25,48,141,195,162,33
35,25,48,165,82,143,-61
35,25,48,201,49,61,-12
35,25,48,303,214,243,-29
35,25,48,329,107,184,-77
35,25,48,439,76,0,76
35,27,35,1,72,99,-27
35,27,35,5,90,64,26
35,27,35,13,104,112,-8
35,27,35,15,74,0,74
35,27,35,35,185,223,-38
35,27,48,141,63,73,-10
35,28,35,1,175,208,-33
35,28,35,39,85,67,18
35,28,35,43,91,137,-46
35,28,35,49,242,295,-53
35,29,4,13,129,77,52
35,29,35,1,0,87,-87
35,29,35,13,235,337,-102
35,29,48,141,60,87,-27
35,31,4,1,921,982,-61
35,31,4,5,96,124,-28
35,31,4,13,197,293,-96
35,31,4,17,151,158,-7
35,31,35,1,613,949,-336
35,31,35,6,229,304,-75
35,31,35,43,117,212,-95
35,31,35,45,718,1280,-562
35,33,35,47,106,82,24
35,35,2,20,66,0,66
35,35,4,13,197,205,-8
35,35,4,19,0,89,-89
35,35,8,41,68,80,-12
35,35,12,91,0,92,-92
35,35,32,3,165,244,-79
35,35,35,1,122,153,-31
35,35,35,5,0,79,-79
35,35,35,13,841,633,208
35,35,35,15,88,54,34
35,35,35,27,223,185,38
35,35,48,29,153,160,-7
35,35,48,141,654,444,210
35,35,48,485,67,0,67
35,37,35,1,0,59,-59
35,39,35,1,206,334,-128
35,39,35,28,67,85,-18
35,39,35,43,73,127,-54
35,39,35,45,179,101,78
35,39,35,49,589,635,-46
35,39,35,55,105,70,35
35,41,35,1,0,87,-87
35,41,35,9,454,404,50
35,41,48,303,0,80,-80
35,43,4,13,252,464,-212
35,43,4,19,0,72,-72
35,43,4,21,0,71,-71
35,43,6,37,163,66,97
35,43,6,59,58,0,58
35,43,6,65,77,0,77
35,43,6,73,117,97,20
35,43,8,1,90,0,90
35,43,8,5,62,0,62
35,43,8,31,72,0,72
35,43,8,41,105,121,-16
35,43,8,59,58,58,0
35,43,32,3,131,107,24
35,43,35,1,6462,5557,905
35,43,35,5,61,0,61
35,43,35,6,70,0,70
35,43,35,13,164,117,47
35,43,35,28,137,91,46
35,43,35,31,212,117,95
35,43,35,39,127,73,54
35,43,35,45,331,167,164
35,43,35,47,145,61,84
35,43,35,49,818,421,397
35,43,35,55,63,0,63
35,43,35,57,0,78,-78
35,43,35,61,195,176,19
35,43,48,113,59,0,59
35,43,48,141,83,71,12
35,43,48,201,75,0,75
35,43,48,439,76,104,-28
35,43,48,453,65,0,65
35,45,4,1,395,562,-167
35,45,4,5,0,115,-115
35,45,4,13,253,426,-173
35,45,4,17,107,191,-84
35,45,4,19,65,64,1
35,45,4,21,0,111,-111
35,45,8,41,0,73,-73
35,45,8,67,467,328,139
35,45,8,83,112,224,-112
35,45,32,3,0,103,-103
35,45,35,1,425,633,-208
35,45,35,13,0,80,-80
35,45,35,15,0,171,-171
35,45,35,25,0,74,-74
35,45,35,31,1280,718,562
35,45,35,39,101,179,-78
35,45,35,43,167,331,-164
35,45,35,49,0,54,-54
35,45,48,135,0,113,-113
35,45,48,329,0,158,-158
35,45,49,35,0,57,-57
35,45,49,37,71,173,-102
35,47,35,1,213,313,-100
35,47,35,33,82,106,-24
35,47,35,43,61,145,-84
35,47,35,49,233,267,-34
35,49,4,13,159,247,-88
35,49,4,19,106,131,-25
35,49,6,1,102,0,102
35,49,6,37,299,205,94
35,49,6,59,94,0,94
35,49,6,73,139,79,60
35,49,6,75,91,0,91
35,49,8,5,50,74,-24
35,49,8,13,68,66,2
35,49,8,31,115,149,-34
35,49,8,41,69,81,-12
35,49,8,59,73,63,10
35,49,8,69,58,0,58
35,49,17,31,127,48,79
35,49,25,17,59,0,59
35,49,27,53,48,0,48
35,49,32,3,72,95,-23
35,49,35,1,1706,1911,-205
35,49,35,13,138,103,35
35,49,35,28,295,242,53
35,49,35,39,635,589,46
35,49,35,43,421,818,-397
35,49,35,45,54,0,54
35,49,35,47,267,233,34
35,49,35,55,166,107,59
35,49,35,57,151,142,9
35,49,35,61,95,73,22
35,49,36,47,67,0,67
35,49,36,61,72,0,72
35,49,41,51,106,77,29
35,49,48,29,76,0,76
35,49,48,113,134,59,75
35,49,48,141,72,70,2
35,49,48,201,111,0,111
35,49,48,439,76,79,-3
35,49,48,453,161,90,71
35,49,53,33,134,84,50
35,51,35,1,64,62,2
35,51,35,13,189,148,41
35,53,35,1,182,283,-101
35,53,35,61,111,181,-70
35,55,35,1,244,255,-11
35,55,35,7,54,0,54
35,55,35,39,70,105,-35
35,55,35,43,0,63,-63
35,55,35,49,107,166,-59
35,57,35,1,458,310,148
35,57,35,43,78,0,78
35,57,35,49,142,151,-9
35,61,4,13,131,99,32
35,61,6,37,61,0,61
35,61,35,1,2327,1880,447
35,61,35,6,172,85,87
35,61,35,13,74,55,19
35,61,35,43,176,195,-19
35,61,35,49,73,95,-22
35,61,35,53,181,111,70
36,1,4,13,80,156,-76
36,1,6,37,86,106,-20
36,1,6,73,0,83,-83
36,1,6,85,0,56,-56
36,1,8,31,0,51,-51
36,1,9,1,57,79,-22
36,1,9,3,80,103,-23
36,1,9,9,57,61,-4
36,1,11,1,0,49,-49
36,1,12,11,0,116,-116
36,1,12,31,0,93,-93
36,1,12,57,0,93,-93
36,1,12,71,0,108,-108
36,1,12,95,0,67,-67
36,1,12,99,74,85,-11
36,1,12,103,54,79,-25
36,1,12,115,0,76,-76
36,1,13,121,0,58,-58
36,1,17,31,59,95,-36
36,1,24,31,0,79,-79
36,1,25,3,73,81,-8
36,1,25,17,106,170,-64
36,1,25,25,79,74,5
36,1,32,3,0,60,-60
36,1,34,17,73,77,-4
36,1,34,23,54,104,-50
36,1,36,5,388,159,229
36,1,36,7,89,75,14
36,1,36,19,63,0,63
36,1,36,21,307,220,87
36,1,36,25,61,0,61
36,1,36,27,260,169,91
36,1,36,29,182,176,6
36,1,36,31,0,61,-61
36,1,36,35,120,140,-20
36,1,36,39,574,546,28
36,1,36,43,55,0,55
36,1,36,47,620,375,245
36,1,36,55,159,169,-10
36,1,36,57,178,139,39
36,1,36,59,157,123,34
36,1,36,61,245,373,-128
36,1,36,65,152,101,51
36,1,36,67,203,143,60
36,1,36,71,186,162,24
36,1,36,77,69,79,-10
36,1,36,81,477,304,173
36,1,36,83,4387,4677,-290
36,1,36,85,75,0,75
36,1,36,87,77,0,77
36,1,36,89,50,54,-4
36,1,36,91,2268,3359,-1091
36,1,36,93,2870,3553,-683
36,1,36,95,189,186,3
36,1,36,103,202,85,117
36,1,36,111,265,163,102
36,1,36,113,146,197,-51
36,1,36,115,128,101,27
36,1,36,119,180,108,72
36,1,37,119,0,128,-128
36,1,37,183,0,94,-94
36,1,39,49,0,69,-69
36,1,42,3,0,58,-58
36,1,42,101,0,80,-80
36,1,44,7,0,49,-49
36,1,45,51,0,82,-82
36,1,50,7,45,0,45
36,1,51,59,0,106,-106
36,1,53,33,0,93,-93
36,3,36,9,397,345,52
36,3,36,29,142,113,29
36,3,36,51,86,131,-45
36,3,36,55,82,150,-68
36,3,36,63,53,0,53
36,3,36,101,269,257,12
36,3,36,121,61,65,-4
36,5,4,13,112,176,-64
36,5,6,1,60,71,-11
36,5,6,37,224,415,-191
36,5,6,71,0,56,-56
36,5,6,73,134,149,-15
36,5,6,75,0,68,-68
36,5,6,85,0,65,-65
36,5,8,31,0,57,-57
36,5,8,41,49,0,49
36,5,9,1,846,2716,-1870
36,5,9,3,211,498,-287
36,5,9,5,76,99,-23
36,5,9,9,446,1399,-953
36,5,9,11,0,110,-110
36,5,10,1,0,83,-83
36,5,10,3,86,241,-155
36,5,11,1,91,98,-7
36,5,12,9,0,114,-114
36,5,12,11,437,847,-410
36,5,12,21,0,52,-52
36,5,12,31,101,240,-139
36,5,12,53,0,128,-128
36,5,12,57,247,619,-372
36,5,12,69,0,187,-187
36,5,12,71,61,201,-140
36,5,12,83,0,134,-134
36,5,12,86,467,614,-147
36,5,12,95,428,1062,-634
36,5,12,97,192,687,-495
36,5,12,99,243,381,-138
36,5,12,101,0,176,-176
36,5,12,103,88,137,-49
36,5,12,105,97,334,-237
36,5,12,111,0,132,-132
36,5,12,115,0,67,-67
36,5,12,117,111,271,-160
36,5,12,127,0,210,-210
36,5,13,63,69,101,-32
36,5,13,67,82,176,-94
36,5,13,89,125,265,-140
36,5,13,121,122,276,-154
36,5,13,135,144,384,-240
36,5,13,151,0,130,-130
36,5,17,31,179,211,-32
36,5,18,97,0,127,-127
36,5,22,51,0,92,-92
36,5,24,3,0,81,-81
36,5,24,5,86,204,-118
36,5,24,31,159,230,-71
36,5,24,33,124,270,-146
36,5,24,43,0,68,-68
36,5,24,510,127,201,-74
36,5,25,3,0,53,-53
36,5,25,5,0,76,-76
36,5,25,9,222,321,-99
36,5,25,13,69,154,-85
36,5,25,17,97,197,-100
36,5,25,21,60,58,2
36,5,25,25,112,217,-105
36,5,25,27,77,227,-150
36,5,26,125,0,64,-64
36,5,26,163,78,225,-147
36,5,27,53,0,73,-73
36,5,32,3,85,165,-80
36,5,33,11,0,62,-62
36,5,34,1,62,99,-37
36,5,34,3,889,2472,-1583
36,5,34,5,50,172,-122
36,5,34,7,82,206,-124
36,5,34,13,841,2113,-1272
36,5,34,17,878,1559,-681
36,5,34,21,87,239,-152
36,5,34,23,345,729,-384
36,5,34,25,75,150,-75
36,5,34,27,89,142,-53
36,5,34,29,0,137,-137
36,5,34,31,449,1093,-644
36,5,34,35,54,155,-101
36,5,34,39,296,781,-485
36,5,36,1,159,388,-229
36,5,36,7,76,154,-78
36,5,36,27,361,1252,-891
36,5,36,29,156,341,-185
36,5,36,45,0,66,-66
36,5,36,47,8626,7801,825
36,5,36,55,84,148,-64
36,5,36,59,786,1286,-500
36,5,36,61,20800,16117,4683
36,5,36,65,0,124,-124
36,5,36,67,114,198,-84
36,5,36,71,728,2514,-1786
36,5,36,79,211,697,-486
36,5,36,81,8301,7882,419
36,5,36,83,0,68,-68
36,5,36,85,731,970,-239
36,5,36,87,454,1259,-805
36,5,36,93,61,267,-206
36,5,36,103,602,1079,-477
36,5,36,105,68,190,-122
36,5,36,111,93,184,-91
36,5,36,119,6357,14142,-7785
36,5,37,51,0,135,-135
36,5,37,63,0,101,-101
36,5,37,67,0,72,-72
36,5,37,81,0,153,-153
36,5,37,119,148,481,-333
36,5,37,133,0,64,-64
36,5,37,183,75,344,-269
36,5,39,17,0,66,-66
36,5,39,35,96,155,-59
36,5,39,49,136,436,-300
36,5,39,61,48,75,-27
36,5,42,3,0,75,-75
36,5,42,11,240,598,-358
36,5,42,17,0,87,-87
36,5,42,25,0,50,-50
36,5,42,43,79,274,-195
36,5,42,45,0,103,-103
36,5,42,69,0,145,-145
36,5,42,71,0,182,-182
36,5,42,75,0,84,-84
36,5,42,77,282,947,-665
36,5,42,79,267,808,-541
36,5,42,89,290,768,-478
36,5,42,91,0,112,-112
36,5,42,95,76,233,-157
36,5,42,101,421,927,-506
36,5,42,103,58,99,-41
36,5,42,133,0,159,-159
36,5,44,7,158,470,-312
36,5,45,15,0,63,-63
36,5,45,19,0,75,-75
36,5,45,45,0,70,-70
36,5,45,51,0,55,-55
36,5,45,79,0,91,-91
36,5,47,125,0,56,-56
36,5,47,157,0,99,-99
36,5,48,27,0,75,-75
36,5,48,29,54,79,-25
36,5,48,113,70,184,-114
36,5,48,121,0,67,-67
36,5,48,157,0,61,-61
36,5,48,201,233,528,-295
36,5,48,439,65,165,-100
36,5,48,453,186,110,76
36,5,51,41,0,79,-79
36,5,51,59,55,104,-49
36,5,51,87,0,79,-79
36,5,51,153,79,72,7
36,5,51,550,0,79,-79
36,5,51,650,0,64,-64
36,5,51,700,0,62,-62
36,5,51,710,0,103,-103
36,5,51,760,72,0,72
36,5,51,810,58,154,-96
36,5,53,33,0,142,-142
36,5,53,53,0,61,-61
36,7,6,37,0,53,-53
36,7,12,95,0,70,-70
36,7,12,127,0,53,-53
36,7,34,17,0,44,-44
36,7,36,1,75,89,-14
36,7,36,5,154,76,78
36,7,36,15,109,103,6
36,7,36,17,471,477,-6
36,7,36,23,171,173,-2
36,7,36,25,261,188,73
36,7,36,29,79,105,-26
36,7,36,47,345,197,148
36,7,36,55,98,152,-54
36,7,36,59,66,51,15
36,7,36,61,71,98,-27
36,7,36,65,57,0,57
36,7,36,67,169,304,-135
36,7,36,71,69,59,10
36,7,36,77,101,95,6
36,7,36,81,191,129,62
36,7,36,91,0,68,-68
36,7,36,103,90,58,32
36,7,36,107,952,1051,-99
36,7,36,109,125,200,-75
36,7,36,119,69,0,69
36,7,37,119,0,67,-67
36,7,37,183,0,79,-79
36,7,42,15,60,76,-16
36,7,42,69,48,58,-10
36,7,42,115,258,310,-52
36,7,45,51,0,72,-72
36,9,36,3,345,397,-52
36,9,36,13,360,459,-99
36,9,36,29,979,941,38
36,9,36,55,50,88,-38
36,9,36,63,88,65,23
36,9,36,121,201,252,-51
36,9,42,83,182,159,23
36,11,36,23,120,147,-27
36,11,36,55,99,114,-15
36,11,36,67,898,1010,-112
36,11,36,69,64,0,64
36,11,36,75,285,286,-1
36,11,36,99,188,125,63
36,11,36,109,288,196,92
36,11,36,117,220,234,-14
36,13,36,9,459,360,99
36,13,36,29,835,945,-110
36,13,36,55,0,124,-124
36,13,36,63,71,66,5
36,13,42,3,0,51,-51
36,13,42,49,295,339,-44
36,13,42,123,198,193,5
36,15,36,7,103,109,-6
36,15,36,29,54,0,54
36,15,36,55,83,101,-18
36,15,36,67,0,54,-54
36,15,36,97,193,279,-86
36,15,36,101,929,752,177
36,15,36,107,292,316,-24
36,15,36,109,205,149,56
36,15,36,123,0,66,-66
36,15,42,15,227,250,-23
36,15,42,117,126,112,14
36,17,36,7,477,471,6
36,17,36,23,115,91,24
36,17,36,25,245,251,-6
36,17,36,53,184,203,-19
36,17,36,65,78,75,3
36,17,36,67,75,71,4
36,17,36,77,332,342,-10
36,19,36,1,0,63,-63
36,19,36,31,543,395,148
36,19,36,33,316,234,82
36,19,36,89,116,97,19
36,19,36,91,56,84,-28
36,19,50,7,106,100,6
36,19,50,11,100,0,100
36,21,25,3,141,165,-24
36,21,36,1,220,307,-87
36,21,36,27,425,440,-15
36,21,36,39,225,378,-153
36,21,36,47,293,105,188
36,21,36,59,56,0,56
36,21,36,61,296,122,174
36,21,36,81,62,0,62
36,21,36,83,304,500,-196
36,21,36,91,72,82,-10
36,21,36,93,0,85,-85
36,21,36,111,106,102,4
36,21,36,119,82,53,29
36,23,36,7,173,171,2
36,23,36,11,147,120,27
36,23,36,17,91,115,-24
36,23,36,53,62,65,-3
36,23,36,67,373,411,-38
36,23,36,107,82,64,18
36,23,36,109,669,532,137
36,25,36,1,0,61,-61
36,25,36,7,188,261,-73
36,25,36,17,251,245,6
36,25,36,47,125,0,125
36,25,36,61,88,0,88
36,25,36,77,575,545,30
36,25,36,81,88,0,88
36,25,36,95,124,106,18
36,25,36,103,64,0,64
36,25,36,105,66,0,66
36,25,36,111,69,78,-9
36,27,4,13,0,101,-101
36,27,6,37,93,110,-17
36,27,6,73,64,75,-11
36,27,9,1,323,413,-90
36,27,9,3,63,70,-7
36,27,9,5,131,248,-117
36,27,9,9,86,101,-15
36,27,10,5,0,53,-53
36,27,11,1,0,59,-59
36,27,12,9,0,74,-74
36,27,12,11,79,66,13
36,27,12,57,0,67,-67
36,27,12,71,61,0,61
36,27,12,95,0,90,-90
36,27,12,99,95,158,-63
36,27,12,101,0,67,-67
36,27,12,103,53,70,-17
36,27,12,115,0,75,-75
36,27,17,31,56,46,10
36,27,24,31,0,58,-58
36,27,25,17,65,118,-53
36,27,25,25,0,59,-59
36,27,32,3,0,79,-79
36,27,34,3,109,86,23
36,27,34,13,68,0,68
36,27,34,17,61,88,-27
36,27,36,1,169,260,-91
36,27,36,5,1252,361,891
36,27,36,21,440,425,15
36,27,36,29,0,57,-57
36,27,36,39,81,136,-55
36,27,36,47,832,394,438
36,27,36,55,0,61,-61
36,27,36,59,249,112,137
36,27,36,61,734,495,239
36,27,36,67,0,61,-61
36,27,36,71,1240,1240,0
36,27,36,79,1328,703,625
36,27,36,81,783,375,408
36,27,36,83,0,75,-75
36,27,36,85,85,0,85
36,27,36,87,196,102,94
36,27,36,91,64,168,-104
36,27,36,93,53,67,-14
36,27,36,103,258,127,131
36,27,36,105,111,71,40
36,27,36,111,1530,1616,-86
36,27,36,119,3034,1341,1693
36,27,37,19,0,60,-60
36,27,37,119,0,86,-86
36,27,37,183,0,145,-145
36,27,42,101,50,73,-23
36,27,45,51,0,170,-170
36,27,48,453,0,55,-55
36,29,4,13,246,397,-151
36,29,4,19,48,71,-23
36,29,6,1,69,81,-12
36,29,6,37,234,283,-49
36,29,6,59,75,79,-4
36,29,6,67,0,85,-85
36,29,6,73,139,212,-73
36,29,6,75,0,59,-59
36,29,6,85,45,102,-57
36,29,8,13,42,53,-11
36,29,8,31,0,104,-104
36,29,8,41,57,62,-5
36,29,9,1,66,66,0
36,29,9,3,68,71,-3
36,29,9,9,0,59,-59
36,29,10,3,49,59,-10
36,29,11,1,84,100,-16
36,29,12,9,0,95,-95
36,29,12,11,175,148,27
36,29,12,15,0,65,-65
36,29,12,21,0,91,-91
36,29,12,31,0,111,-111
36,29,12,57,159,288,-129
36,29,12,69,0,72,-72
36,29,12,71,104,258,-154
36,29,12,81,60,109,-49
36,29,12,83,0,61,-61
36,29,12,86,79,100,-21
36,29,12,95,166,173,-7
36,29,12,97,0,100,-100
36,29,12,99,176,231,-55
36,29,12,101,68,108,-40
36,29,12,103,137,297,-160
36,29,12,105,72,181,-109
36,29,12,111,0,55,-55
36,29,12,115,69,202,-133
36,29,12,117,0,61,-61
36,29,12,127,49,74,-25
36,29,13,67,0,77,-77
36,29,13,89,100,122,-22
36,29,13,121,80,111,-31
36,29,13,135,88,80,8
36,29,15,3,0,78,-78
36,29,17,31,212,224,-12
36,29,24,5,0,65,-65
36,29,24,31,61,98,-37
36,29,24,33,0,61,-61
36,29,24,510,0,65,-65
36,29,25,9,90,0,90
36,29,25,17,98,141,-43
36,29,25,25,87,111,-24
36,29,25,27,78,0,78
36,29,26,125,66,85,-19
36,29,26,161,0,49,-49
36,29,26,163,88,107,-19
36,29,27,53,0,76,-76
36,29,32,3,140,248,-108
36,29,34,3,0,51,-51
36,29,34,17,73,145,-72
36,29,34,23,80,71,9
36,29,36,1,176,182,-6
36,29,36,3,113,142,-29
36,29,36,5,341,156,185
36,29,36,7,105,79,26
36,29,36,9,941,979,-38
36,29,36,13,945,835,110
36,29,36,15,0,54,-54
36,29,36,27,57,0,57
36,29,36,37,588,663,-75
36,29,36,45,91,61,30
36,29,36,47,805,361,444
36,29,36,51,97,81,16
36,29,36,55,1126,1205,-79
36,29,36,59,127,99,28
36,29,36,61,330,305,25
36,29,36,63,5118,5370,-252
36,29,36,65,110,100,10
36,29,36,67,344,333,11
36,29,36,69,147,127,20
36,29,36,71,59,0,59
36,29,36,73,132,139,-7
36,29,36,75,60,0,60
36,29,36,81,962,246,716
36,29,36,83,0,58,-58
36,29,36,85,62,0,62
36,29,36,89,72,0,72
36,29,36,91,69,93,-24
36,29,36,101,97,56,41
36,29,36,103,195,118,77
36,29,36,109,67,57,10
36,29,36,117,61,65,-4
36,29,36,119,147,96,51
36,29,36,121,482,588,-106
36,29,37,63,0,50,-50
36,29,37,81,0,72,-72
36,29,37,119,183,361,-178
36,29,37,133,71,0,71
36,29,37,179,0,74,-74
36,29,37,183,124,205,-81
36,29,39,35,168,167,1
36,29,39,49,102,169,-67
36,29,39,61,52,0,52
36,29,39,153,0,66,-66
36,29,41,51,67,61,6
36,29,41,67,0,48,-48
36,29,42,3,156,222,-66
36,29,42,49,125,98,27
36,29,42,91,0,62,-62
36,29,42,101,129,121,8
36,29,45,19,0,59,-59
36,29,45,45,0,88,-88
36,29,45,51,0,62,-62
36,29,45,91,0,66,-66
36,29,47,37,53,89,-36
36,29,47,157,0,68,-68
36,29,48,29,102,94,8
36,29,48,85,0,105,-105
36,29,48,113,73,104,-31
36,29,48,201,161,179,-18
36,29,48,439,0,117,-117
36,29,48,453,96,109,-13
36,29,49,35,0,61,-61
36,29,50,7,0,46,-46
36,29,51,13,0,62,-62
36,29,51,59,102,138,-36
36,29,51,107,0,84,-84
36,29,51,153,0,50,-50
36,29,53,33,105,155,-50
36,29,53,53,0,72,-72
36,31,36,1,61,0,61
36,31,36,19,395,543,-148
36,31,36,33,295,337,-42
36,31,36,91,93,100,-7
36,31,36,113,135,151,-16
36,31,36,115,105,0,105
36,31,50,1,70,53,17
36,31,50,7,0,58,-58
36,33,36,19,234,316,-82
36,33,36,31,337,295,42
36,33,36,89,371,375,-4
36,35,36,1,140,120,20
36,35,36,41,61,0,61
36,35,36,43,209,179,30
36,35,36,57,905,868,37
36,35,36,83,61,55,6
36,35,36,91,443,390,53
36,35,36,93,252,190,62
36,35,36,95,77,0,77
36,37,36,29,663,588,75
36,37,36,51,186,183,3
36,37,36,55,650,750,-100
36,37,36,63,105,116,-11
36,37,36,73,199,226,-27
36,37,36,121,495,343,152
36,39,36,1,546,574,-28
36,39,36,21,378,225,153
36,39,36,27,136,81,55
36,39,36,47,158,106,52
36,39,36,59,60,0,60
36,39,36,61,113,58,55
36,39,36,71,69,0,69
36,39,36,81,86,56,30
36,39,36,83,80,141,-61
36,39,36,91,0,50,-50
36,39,36,95,0,51,-51
36,39,36,103,67,0,67
36,39,36,111,438,349,89
36,41,36,35,0,61,-61
36,43,36,1,0,55,-55
36,43,36,35,179,209,-30
36,43,36,53,68,94,-26
36,43,36,55,0,49,-49
36,43,36,57,124,131,-7
36,43,36,65,1289,1229,60
36,43,36,67,61,80,-19
36,43,36,77,215,186,29
36,45,1,31,77,93,-16
36,45,1,45,153,108,45
36,45,2,90,120,0,120
36,45,4,3,100,0,100
36,45,4,13,75,139,-64
36,45,6,37,142,98,44
36,45,6,59,0,62,-62
36,45,6,65,69,57,12
36,45,6,71,87,144,-57
36,45,6,73,68,78,-10
36,45,8,41,281,410,-129
36,45,12,9,0,57,-57
36,45,12,57,59,72,-13
36,45,13,51,81,0,81
36,45,13,179,134,122,12
36,45,13,215,185,207,-22
36,45,13,245,86,0,86
36,45,15,3,417,464,-47
36,45,20,61,115,119,-4
36,45,21,47,104,94,10
36,45,29,169,77,160,-83
36,45,32,3,70,0,70
36,45,36,5,66,0,66
36,45,36,29,61,91,-30
36,45,36,47,68,82,-14
36,45,36,49,387,364,23
36,45,36,55,127,147,-20
36,45,36,65,86,125,-39
36,45,36,67,254,433,-179
36,45,36,75,239,277,-38
36,45,36,81,79,89,-10
36,45,36,89,322,322,0
36,45,36,103,60,0,60
36,45,37,51,156,340,-184
36,45,37,85,0,186,-186
36,45,40,31,116,129,-13
36,45,45,79,93,119,-26
36,45,47,125,191,222,-31
36,45,48,27,259,402,-143
36,45,48,29,160,278,-118
36,45,48,99,0,139,-139
36,45,48,141,370,263,107
36,45,48,201,0,92,-92
36,45,51,59,91,90,1
36,45,51,149,0,96,-96
36,45,51,700,75,0,75
36,45,53,53,193,207,-14
36,45,53,67,0,139,-139
36,47,1,73,44,78,-34
36,47,4,13,354,474,-120
36,47,4,19,83,109,-26
36,47,6,1,709,1000,-291
36,47,6,13,102,236,-134
36,47,6,37,2340,5102,-2762
36,47,6,41,71,139,-68
36,47,6,53,0,54,-54
36,47,6,59,398,483,-85
36,47,6,65,83,138,-55
36,47,6,67,129,244,-115
36,47,6,71,115,123,-8
36,47,6,73,500,663,-163
36,47,6,75,1370,1396,-26
36,47,6,77,54,0,54
36,47,6,81,186,286,-100
36,47,6,83,71,69,2
36,47,6,85,378,582,-204
36,47,6,87,52,53,-1
36,47,6,97,65,65,0
36,47,6,111,55,72,-17
36,47,8,5,52,163,-111
36,47,8,13,97,169,-72
36,47,8,31,294,537,-243
36,47,8,41,51,102,-51
36,47,8,59,55,88,-33
36,47,8,69,0,44,-44
36,47,9,1,1195,1787,-592
36,47,9,3,471,660,-189
36,47,9,5,85,149,-64
36,47,9,7,86,84,2
36,47,9,9,700,926,-226
36,47,9,11,149,172,-23
36,47,9,13,61,0,61
36,47,10,1,59,143,-84
36,47,10,3,178,347,-169
36,47,10,5,59,74,-15
36,47,11,1,1261,925,336
36,47,12,1,86,0,86
36,47,12,9,145,249,-104
36,47,12,11,951,1628,-677
36,47,12,15,0,74,-74
36,47,12,21,58,101,-43
36,47,12,31,193,277,-84
36,47,12,35,0,83,-83
36,47,12,53,0,59,-59
36,47,12,57,302,676,-374
36,47,12,69,55,177,-122
36,47,12,71,116,274,-158
36,47,12,73,64,83,-19
36,47,12,81,54,83,-29
36,47,12,83,0,123,-123
36,47,12,86,1081,1340,-259
36,47,12,95,654,1000,-346
36,47,12,97,164,555,-391
36,47,12,99,554,1003,-449
36,47,12,101,83,150,-67
36,47,12,103,170,312,-142
36,47,12,105,80,354,-274
36,47,12,109,0,87,-87
36,47,12,111,83,189,-106
36,47,12,115,89,141,-52
36,47,12,117,108,237,-129
36,47,12,127,91,188,-97
36,47,13,51,88,92,-4
36,47,13,63,98,243,-145
36,47,13,67,169,279,-110
36,47,13,89,318,602,-284
36,47,13,97,0,92,-92
36,47,13,121,478,722,-244
36,47,13,135,238,596,-358
36,47,13,151,0,196,-196
36,47,13,215,0,56,-56
36,47,13,217,0,116,-116
36,47,13,247,0,73,-73
36,47,15,3,151,203,-52
36,47,16,1,0,47,-47
36,47,17,31,1428,1662,-234
36,47,17,43,71,120,-49
36,47,17,97,57,82,-25
36,47,17,197,0,66,-66
36,47,18,57,0,64,-64
36,47,18,97,86,192,-106
36,47,18,105,45,57,-12
36,47,19,153,68,0,68
36,47,20,91,58,93,-35
36,47,21,111,83,110,-27
36,47,22,33,55,0,55
36,47,22,51,64,63,1
36,47,22,71,241,212,29
36,47,23,5,124,211,-87
36,47,23,31,0,87,-87
36,47,24,3,109,148,-39
36,47,24,5,254,372,-118
36,47,24,21,0,67,-67
36,47,24,25,0,89,-89
36,47,24,27,87,149,-62
36,47,24,31,446,607,-161
36,47,24,33,309,477,-168
36,47,24,510,382,447,-65
36,47,25,1,67,96,-29
36,47,25,3,50,125,-75
36,47,25,5,105,123,-18
36,47,25,9,232,248,-16
36,47,25,13,109,188,-79
36,47,25,15,114,95,19
36,47,25,17,1154,889,265
36,47,25,21,356,404,-48
36,47,25,23,80,106,-26
36,47,25,25,978,669,309
36,47,25,27,143,215,-72
36,47,26,81,67,60,7
36,47,26,99,53,0,53
36,47,26,125,169,214,-45
36,47,26,161,140,126,14
36,47,26,163,177,457,-280
36,47,27,37,0,73,-73
36,47,27,53,318,335,-17
36,47,27,123,71,87,-16
36,47,29,95,99,96,3
36,47,29,189,79,116,-37
36,47,29,510,80,72,8
36,47,31,55,53,0,53
36,47,32,3,183,472,-289
36,47,32,31,0,61,-61
36,47,33,9,0,57,-57
36,47,33,11,74,93,-19
36,47,33,15,55,64,-9
36,47,34,1,135,110,25
36,47,34,3,1190,2375,-1185
36,47,34,5,197,292,-95
36,47,34,7,175,330,-155
36,47,34,11,0,64,-64
36,47,34,13,1812,4641,-2829
36,47,34,15,0,99,-99
36,47,34,17,2420,4326,-1906
36,47,34,19,89,105,-16
36,47,34,21,303,534,-231
36,47,34,23,894,2131,-1237
36,47,34,25,769,1854,-1085
36,47,34,27,427,436,-9
36,47,34,29,408,2601,-2193
36,47,34,31,317,752,-435
36,47,34,35,301,417,-116
36,47,34,37,60,61,-1
36,47,34,39,616,1966,-1350
36,47,34,41,0,83,-83
36,47,35,1,58,68,-10
36,47,35,49,0,67,-67
36,47,36,1,375,620,-245
36,47,36,5,7801,8626,-825
36,47,36,7,197,345,-148
36,47,36,21,105,293,-188
36,47,36,25,0,125,-125
36,47,36,27,394,832,-438
36,47,36,29,361,805,-444
36,47,36,39,106,158,-52
36,47,36,45,82,68,14
36,47,36,55,366,413,-47
36,47,36,59,4003,7734,-3731
36,47,36,61,35164,23113,12051
36,47,36,65,76,145,-69
36,47,36,67,216,317,-101
36,47,36,71,864,2178,-1314
36,47,36,77,0,49,-49
36,47,36,79,152,287,-135
36,47,36,81,24986,34862,-9876
36,47,36,83,99,146,-47
36,47,36,85,4267,13785,-9518
36,47,36,87,679,2055,-1376
36,47,36,91,96,147,-51
36,47,36,93,111,241,-130
36,47,36,103,2877,4034,-1157
36,47,36,105,465,459,6
36,47,36,109,116,160,-44
36,47,36,111,293,669,-376
36,47,36,119,1981,3652,-1671
36,47,37,21,49,80,-31
36,47,37,25,0,69,-69
36,47,37,51,153,195,-42
36,47,37,63,110,208,-98
36,47,37,67,79,152,-73
36,47,37,81,111,230,-119
36,47,37,101,0,66,-66
36,47,37,119,404,839,-435
36,47,37,129,0,72,-72
36,47,37,133,0,129,-129
36,47,37,135,61,76,-15
36,47,37,147,0,66,-66
36,47,37,183,284,523,-239
36,47,39,35,226,258,-32
36,47,39,49,275,434,-159
36,47,39,61,151,187,-36
36,47,39,113,55,58,-3
36,47,39,153,49,58,-9
36,47,39,165,0,62,-62
36,47,40,109,67,67,0
36,47,40,143,43,0,43
36,47,41,39,0,53,-53
36,47,41,51,390,630,-240
36,47,41,67,46,118,-72
36,47,42,3,307,455,-148
36,47,42,11,151,427,-276
36,47,42,17,193,332,-139
36,47,42,25,0,54,-54
36,47,42,29,125,91,34
36,47,42,41,0,66,-66
36,47,42,43,72,224,-152
36,47,42,45,168,251,-83
36,47,42,69,105,222,-117
36,47,42,71,61,195,-134
36,47,42,75,0,69,-69
36,47,42,77,312,638,-326
36,47,42,79,213,562,-349
36,47,42,89,351,994,-643
36,47,42,91,198,414,-216
36,47,42,95,176,465,-289
36,47,42,101,1335,3093,-1758
36,47,42,103,108,184,-76
36,47,42,107,0,73,-73
36,47,42,127,0,84,-84
36,47,42,133,0,147,-147
36,47,44,5,43,57,-14
36,47,44,7,238,371,-133
36,47,45,15,0,79,-79
36,47,45,19,94,155,-61
36,47,45,45,68,88,-20
36,47,45,51,50,84,-34
36,47,45,63,0,74,-74
36,47,45,79,99,115,-16
36,47,47,37,183,391,-208
36,47,47,157,88,90,-2
36,47,48,27,75,134,-59
36,47,48,29,168,206,-38
36,47,48,85,112,193,-81
36,47,48,113,341,426,-85
36,47,48,121,76,109,-33
36,47,48,141,57,85,-28
36,47,48,157,77,182,-105
36,47,48,201,628,787,-159
36,47,48,439,130,247,-117
36,47,48,453,641,791,-150
36,47,48,491,0,97,-97
36,47,49,35,125,108,17
36,47,50,7,70,123,-53
36,47,51,13,208,221,-13
36,47,51,41,69,118,-49
36,47,51,59,370,375,-5
36,47,51,87,77,179,-102
36,47,51,107,88,126,-38
36,47,51,153,96,124,-28
36,47,51,510,86,87,-1
36,47,51,540,59,61,-2
36,47,51,550,58,99,-41
36,47,51,650,58,58,0
36,47,51,700,0,101,-101
36,47,51,710,95,155,-60
36,47,51,760,204,231,-27
36,47,51,810,149,202,-53
36,47,53,33,786,1271,-485
36,47,53,53,65,113,-48
36,47,53,61,0,56,-56
36,47,53,67,0,56,-56
36,47,55,25,111,88,23
36,47,55,79,87,93,-6
36,49,36,45,364,387,-23
36,49,36,65,179,220,-41
36,49,36,89,91,101,-10
36,51,36,3,131,86,45
36,51,36,29,81,97,-16
36,51,36,37,183,186,-3
36,51,36,55,1137,1228,-91
36,51,36,69,272,266,6
36,51,36,101,298,348,-50
36,51,36,117,0,57,-57
36,51,36,121,232,184,48
36,53,36,17,203,184,19
36,53,36,23,65,62,3
36,53,36,43,94,68,26
36,53,36,55,0,58,-58
36,53,36,65,1086,1064,22
36,53,36,67,1370,1276,94
36,53,36,75,108,145,-37
36,53,36,77,90,61,29
36,55,4,13,192,305,-113
36,55,4,19,60,63,-3
36,55,6,1,92,107,-15
36,55,6,37,154,291,-137
36,55,6,59,74,106,-32
36,55,6,65,70,0,70
36,55,6,73,161,216,-55
36,55,6,75,0,78,-78
36,55,6,85,0,213,-213
36,55,8,31,53,122,-69
36,55,8,41,0,77,-77
36,55,8,59,0,44,-44
36,55,9,1,85,78,7
36,55,9,3,81,96,-15
36,55,9,9,78,89,-11
36,55,11,1,88,124,-36
36,55,12,9,81,175,-94
36,55,12,11,113,188,-75
36,55,12,21,0,102,-102
36,55,12,31,68,121,-53
36,55,12,57,135,345,-210
36,55,12,69,60,86,-26
36,55,12,71,125,189,-64
36,55,12,81,49,119,-70
36,55,12,86,68,103,-35
36,55,12,95,165,256,-91
36,55,12,97,0,78,-78
36,55,12,99,127,203,-76
36,55,12,101,64,108,-44
36,55,12,103,112,270,-158
36,55,12,105,96,155,-59
36,55,12,111,0,67,-67
36,55,12,115,54,162,-108
36,55,12,117,56,79,-23
36,55,12,119,0,57,-57
36,55,12,127,91,84,7
36,55,13,67,63,87,-24
36,55,13,89,0,86,-86
36,55,13,121,117,136,-19
36,55,13,135,0,84,-84
36,55,17,31,201,249,-48
36,55,23,5,0,56,-56
36,55,24,3,0,47,-47
36,55,24,31,58,132,-74
36,55,24,510,62,53,9
36,55,25,9,0,43,-43
36,55,25,13,65,63,2
36,55,25,17,245,267,-22
36,55,25,21,67,71,-4
36,55,25,25,132,153,-21
36,55,25,27,64,62,2
36,55,26,125,54,60,-6
36,55,27,53,59,59,0
36,55,32,3,94,191,-97
36,55,33,11,0,56,-56
36,55,34,3,51,0,51
36,55,34,13,0,54,-54
36,55,34,17,75,127,-52
36,55,34,23,55,109,-54
36,55,36,1,169,159,10
36,55,36,3,150,82,68
36,55,36,5,148,84,64
36,55,36,7,152,98,54
36,55,36,9,88,50,38
36,55,36,11,114,99,15
36,55,36,13,124,0,124
36,55,36,15,101,83,18
36,55,36,27,61,0,61
36,55,36,29,1205,1126,79
36,55,36,37,750,650,100
36,55,36,43,49,0,49
36,55,36,45,147,127,20
36,55,36,47,413,366,47
36,55,36,51,1228,1137,91
36,55,36,53,58,0,58
36,55,36,59,101,50,51
36,55,36,61,240,379,-139
36,55,36,63,218,168,50
36,55,36,65,161,79,82
36,55,36,67,704,473,231
36,55,36,69,1988,2417,-429
36,55,36,71,49,0,49
36,55,36,73,924,885,39
36,55,36,75,136,95,41
36,55,36,77,62,0,62
36,55,36,81,292,234,58
36,55,36,83,0,52,-52
36,55,36,89,54,53,1
36,55,36,91,59,86,-27
36,55,36,93,0,70,-70
36,55,36,99,131,82,49
36,55,36,101,323,193,130
36,55,36,103,186,106,80
36,55,36,109,124,125,-1
36,55,36,117,2090,2041,49
36,55,36,119,123,73,50
36,55,36,121,130,77,53
36,55,36,123,130,112,18
36,55,37,63,0,48,-48
36,55,37,67,0,54,-54
36,55,37,81,0,78,-78
36,55,37,119,161,369,-208
36,55,37,129,0,55,-55
36,55,37,183,71,298,-227
36,55,39,35,88,100,-12
36,55,39,49,105,165,-60
36,55,41,51,0,66,-66
36,55,42,3,175,196,-21
36,55,42,29,0,52,-52
36,55,42,49,63,0,63
36,55,42,77,62,0,62
36,55,42,91,0,64,-64
36,55,42,101,159,149,10
36,55,44,7,0,50,-50
36,55,45,19,0,61,-61
36,55,45,45,0,80,-80
36,55,45,51,0,88,-88
36,55,45,91,0,71,-71
36,55,47,37,55,94,-39
36,55,47,93,0,65,-65
36,55,48,29,76,72,4
36,55,48,85,0,89,-89
36,55,48,113,92,81,11
36,55,48,201,142,178,-36
36,55,48,439,0,76,-76
36,55,48,453,68,134,-66
36,55,50,7,51,0,51
36,55,51,13,0,47,-47
36,55,51,59,99,139,-40
36,55,51,810,58,58,0
36,55,53,33,96,182,-86
36,55,55,25,0,50,-50
36,57,36,1,139,178,-39
36,57,36,35,868,905,-37
36,57,36,43,131,124,7
36,57,36,77,62,57,5
36,57,36,83,74,75,-1
36,57,36,91,238,277,-39
36,57,36,93,450,336,114
36,57,36,95,122,163,-41
36,59,4,13,139,359,-220
36,59,4,19,0,68,-68
36,59,6,1,75,97,-22
36,59,6,37,518,855,-337
36,59,6,59,92,218,-126
36,59,6,65,0,75,-75
36,59,6,67,0,76,-76
36,59,6,71,0,64,-64
36,59,6,73,178,314,-136
36,59,6,75,65,162,-97
36,59,6,81,0,63,-63
36,59,6,85,74,178,-104
36,59,8,5,0,63,-63
36,59,8,13,0,54,-54
36,59,8,31,54,102,-48
36,59,8,59,0,59,-59
36,59,9,1,353,795,-442
36,59,9,3,142,202,-60
36,59,9,5,0,67,-67
36,59,9,9,114,254,-140
36,59,9,11,0,61,-61
36,59,10,1,0,57,-57
36,59,10,3,73,125,-52
36,59,10,5,0,110,-110
36,59,11,1,148,207,-59
36,59,12,9,91,188,-97
36,59,12,11,525,997,-472
36,59,12,21,74,213,-139
36,59,12,31,62,204,-142
36,59,12,35,0,80,-80
36,59,12,53,0,92,-92
36,59,12,57,95,378,-283
36,59,12,61,0,76,-76
36,59,12,69,0,146,-146
36,59,12,71,110,310,-200
36,59,12,81,0,139,-139
36,59,12,83,0,105,-105
36,59,12,85,56,127,-71
36,59,12,86,282,517,-235
36,59,12,95,205,467,-262
36,59,12,97,73,178,-105
36,59,12,99,747,1981,-1234
36,59,12,101,0,225,-225
36,59,12,103,102,276,-174
36,59,12,105,0,134,-134
36,59,12,109,0,141,-141
36,59,12,111,52,202,-150
36,59,12,115,52,215,-163
36,59,12,117,0,171,-171
36,59,12,119,0,94,-94
36,59,12,127,63,148,-85
36,59,13,51,0,51,-51
36,59,13,63,0,92,-92
36,59,13,67,51,165,-114
36,59,13,89,71,141,-70
36,59,13,121,93,255,-162
36,59,13,135,56,322,-266
36,59,13,151,0,62,-62
36,59,15,3,75,54,21
36,59,17,31,159,272,-113
36,59,18,97,0,114,-114
36,59,24,3,0,104,-104
36,59,24,5,84,129,-45
36,59,24,21,0,75,-75
36,59,24,31,193,238,-45
36,59,24,33,122,223,-101
36,59,24,510,126,97,29
36,59,25,9,0,86,-86
36,59,25,17,132,263,-131
36,59,25,21,90,119,-29
36,59,25,25,136,202,-66
36,59,25,27,0,88,-88
36,59,26,125,0,63,-63
36,59,32,3,119,263,-144
36,59,34,3,386,673,-287
36,59,34,5,56,62,-6
36,59,34,7,0,113,-113
36,59,34,13,239,378,-139
36,59,34,17,675,633,42
36,59,34,21,64,132,-68
36,59,34,23,311,403,-92
36,59,34,25,157,237,-80
36,59,34,27,103,166,-63
36,59,34,29,97,156,-59
36,59,34,31,126,149,-23
36,59,34,35,63,143,-80
36,59,34,39,96,265,-169
36,59,36,1,123,157,-34
36,59,36,5,1286,786,500
36,59,36,7,51,66,-15
36,59,36,21,0,56,-56
36,59,36,27,112,249,-137
36,59,36,29,99,127,-28
36,59,36,39,0,60,-60
36,59,36,47,7734,4003,3731
36,59,36,55,50,101,-51
36,59,36,61,4517,5080,-563
36,59,36,67,75,119,-44
36,59,36,71,197,429,-232
36,59,36,79,53,136,-83
36,59,36,81,31561,12867,18694
36,59,36,83,0,77,-77
36,59,36,85,479,306,173
36,59,36,87,197,207,-10
36,59,36,91,63,237,-174
36,59,36,93,0,63,-63
36,59,36,103,11055,20213,-9158
36,59,36,105,0,78,-78
36,59,36,111,0,162,-162
36,59,36,113,0,65,-65
36,59,36,119,766,1208,-442
36,59,37,19,0,97,-97
36,59,37,25,0,75,-75
36,59,37,51,0,61,-61
36,59,37,63,0,118,-118
36,59,37,81,0,140,-140
36,59,37,97,0,116,-116
36,59,37,101,0,87,-87
36,59,37,119,173,609,-436
36,59,37,129,0,80,-80
36,59,37,133,0,108,-108
36,59,37,179,0,125,-125
36,59,37,183,73,583,-510
36,59,39,35,0,61,-61
36,59,39,49,0,158,-158
36,59,42,3,55,122,-67
36,59,42,11,0,104,-104
36,59,42,17,0,138,-138
36,59,42,29,0,78,-78
36,59,42,45,0,90,-90
36,59,42,71,0,73,-73
36,59,42,77,58,167,-109
36,59,42,79,0,67,-67
36,59,42,89,89,199,-110
36,59,42,91,0,146,-146
36,59,42,95,0,103,-103
36,59,42,101,166,295,-129
36,59,42,103,55,108,-53
36,59,42,127,0,66,-66
36,59,44,7,0,99,-99
36,59,45,13,0,80,-80
36,59,45,19,0,118,-118
36,59,45,45,0,94,-94
36,59,45,51,0,247,-247
36,59,45,57,0,65,-65
36,59,45,91,0,82,-82
36,59,47,37,0,81,-81
36,59,48,29,0,79,-79
36,59,48,85,0,215,-215
36,59,48,113,79,151,-72
36,59,48,121,0,109,-109
36,59,48,157,0,123,-123
36,59,48,201,154,358,-204
36,59,48,439,0,132,-132
36,59,48,453,68,166,-98
36,59,48,491,0,80,-80
36,59,51,13,73,76,-3
36,59,51,41,0,76,-76
36,59,51,59,177,177,0
36,59,51,87,0,55,-55
36,59,51,107,0,103,-103
36,59,51,153,0,105,-105
36,59,51,810,0,126,-126
36,59,53,33,68,176,-108
36,61,1,73,122,112,10
36,61,1,101,76,0,76
36,61,4,13,457,640,-183
36,61,4,19,109,136,-27
36,61,6,1,842,744,98
36,61,6,13,302,327,-25
36,61,6,37,4194,6923,-2729
36,61,6,41,174,151,23
36,61,6,59,848,778,70
36,61,6,61,51,0,51
36,61,6,65,156,198,-42
36,61,6,67,120,154,-34
36,61,6,71,98,82,16
36,61,6,73,765,948,-183
36,61,6,75,3030,3148,-118
36,61,6,81,493,660,-167
36,61,6,83,75,130,-55
36,61,6,85,1021,1156,-135
36,61,6,87,43,76,-33
36,61,6,97,68,94,-26
36,61,6,111,159,118,41
36,61,6,113,45,53,-8
36,61,8,5,107,124,-17
36,61,8,13,135,190,-55
36,61,8,31,328,957,-629
36,61,8,41,55,56,-1
36,61,8,59,0,118,-118
36,61,8,69,51,45,6
36,61,9,1,3446,4051,-605
36,61,9,3,573,393,180
36,61,9,5,189,282,-93
36,61,9,7,100,88,12
36,61,9,9,942,940,2
36,61,9,11,124,121,3
36,61,9,13,54,0,54
36,61,10,3,260,166,94
36,61,11,1,2434,1777,657
36,61,12,1,81,81,0
36,61,12,9,99,101,-2
36,61,12,11,752,1044,-292
36,61,12,21,129,203,-74
36,61,12,31,207,182,25
36,61,12,57,334,519,-185
36,61,12,61,0,75,-75
36,61,12,71,125,190,-65
36,61,12,73,67,0,67
36,61,12,81,0,95,-95
36,61,12,86,1513,2286,-773
36,61,12,95,489,521,-32
36,61,12,97,96,229,-133
36,61,12,99,966,1327,-361
36,61,12,101,0,98,-98
36,61,12,103,186,331,-145
36,61,12,105,42,109,-67
36,61,12,109,67,79,-12
36,61,12,111,0,64,-64
36,61,12,115,144,154,-10
36,61,12,117,129,119,10
36,61,12,127,47,102,-55
36,61,13,51,67,94,-27
36,61,13,63,0,75,-75
36,61,13,67,158,206,-48
36,61,13,89,297,343,-46
36,61,13,121,948,924,24
36,61,13,135,150,320,-170
36,61,15,3,179,174,5
36,61,17,19,62,0,62
36,61,17,31,2821,2453,368
36,61,17,43,101,149,-48
36,61,17,97,147,90,57
36,61,18,57,67,0,67
36,61,18,97,149,94,55
36,61,18,105,78,0,78
36,61,18,141,78,0,78
36,61,19,103,48,0,48
36,61,20,91,85,77,8
36,61,21,67,70,0,70
36,61,21,111,118,113,5
36,61,22,33,52,0,52
36,61,22,51,56,0,56
36,61,22,55,0,51,-51
36,61,22,71,211,242,-31
36,61,23,5,120,151,-31
36,61,24,3,127,108,19
36,61,24,5,216,237,-21
36,61,24,25,0,66,-66
36,61,24,27,145,114,31
36,61,24,31,835,698,137
36,61,24,33,193,178,15
36,61,24,510,429,388,41
36,61,25,1,107,136,-29
36,61,25,3,89,163,-74
36,61,25,5,96,73,23
36,61,25,9,311,359,-48
36,61,25,13,86,109,-23
36,61,25,15,137,105,32
36,61,25,17,1927,1532,395
36,61,25,21,600,488,112
36,61,25,23,136,137,-1
36,61,25,25,2036,1841,195
36,61,25,27,177,173,4
36,61,26,81,60,61,-1
36,61,26,99,66,0,66
36,61,26,125,334,272,62
36,61,26,161,309,225,84
36,61,26,163,181,459,-278
36,61,27,53,441,411,30
36,61,27,123,70,69,1
36,61,29,95,96,65,31
36,61,29,189,210,205,5
36,61,29,510,141,89,52
36,61,31,55,68,50,18
36,61,32,3,249,378,-129
36,61,33,9,97,71,26
36,61,33,11,59,124,-65
36,61,33,15,79,82,-3
36,61,34,1,106,111,-5
36,61,34,3,3471,4526,-1055
36,61,34,5,166,153,13
36,61,34,7,239,166,73
36,61,34,13,1858,2814,-956
36,61,34,17,4652,8848,-4196
36,61,34,19,118,94,24
36,61,34,21,737,573,164
36,61,34,23,1139,929,210
36,61,34,25,1304,1107,197
36,61,34,27,1052,797,255
36,61,34,29,291,251,40
36,61,34,31,621,789,-168
36,61,34,35,634,472,162
36,61,34,37,90,117,-27
36,61,34,39,950,1302,-352
36,61,34,41,59,58,1
36,61,35,1,65,61,4
36,61,35,49,0,72,-72
36,61,36,1,373,245,128
36,61,36,5,16117,20800,-4683
36,61,36,7,98,71,27
36,61,36,21,122,296,-174
36,61,36,25,0,88,-88
36,61,36,27,495,734,-239
36,61,36,29,305,330,-25
36,61,36,39,58,113,-55
36,61,36,47,23113,35164,-12051
36,61,36,55,379,240,139
36,61,36,59,5080,4517,563
36,61,36,65,113,88,25
36,61,36,67,224,167,57
36,61,36,71,558,984,-426
36,61,36,79,277,313,-36
36,61,36,81,13675,17169,-3494
36,61,36,83,87,75,12
36,61,36,85,1360,1451,-91
36,61,36,87,808,921,-113
36,61,36,91,130,166,-36
36,61,36,93,144,90,54
36,61,36,103,2814,2879,-65
36,61,36,105,84,209,-125
36,61,36,109,339,152,187
36,61,36,111,287,546,-259
36,61,36,119,5812,8414,-2602
36,61,37,21,56,78,-22
36,61,37,51,0,66,-66
36,61,37,63,279,298,-19
36,61,37,67,101,77,24
36,61,37,81,92,115,-23
36,61,37,119,580,679,-99
36,61,37,129,51,65,-14
36,61,37,135,135,137,-2
36,61,37,183,331,424,-93
36,61,39,35,395,360,35
36,61,39,49,352,310,42
36,61,39,61,245,184,61
36,61,39,153,59,69,-10
36,61,40,109,82,50,32
36,61,40,143,86,64,22
36,61,41,51,306,364,-58
36,61,41,67,53,83,-30
36,61,42,3,471,441,30
36,61,42,11,126,237,-111
36,61,42,17,331,265,66
36,61,42,27,101,56,45
36,61,42,29,211,186,25
36,61,42,41,54,57,-3
36,61,42,43,79,119,-40
36,61,42,45,261,203,58
36,61,42,69,68,75,-7
36,61,42,71,108,120,-12
36,61,42,77,172,409,-237
36,61,42,79,128,308,-180
36,61,42,89,178,317,-139
36,61,42,91,544,395,149
36,61,42,95,157,203,-46
36,61,42,101,1803,2038,-235
36,61,42,103,83,103,-20
36,61,42,133,54,75,-21
36,61,44,5,49,75,-26
36,61,44,7,310,356,-46
36,61,44,9,58,60,-2
36,61,45,13,55,85,-30
36,61,45,15,0,64,-64
36,61,45,19,165,283,-118
36,61,45,45,66,52,14
36,61,45,79,86,71,15
36,61,47,37,381,397,-16
36,61,47,93,77,50,27
36,61,47,157,78,127,-49
36,61,47,187,59,0,59
36,61,48,29,159,198,-39
36,61,48,85,181,179,2
36,61,48,113,822,786,36
36,61,48,121,107,112,-5
36,61,48,141,76,0,76
36,61,48,157,156,86,70
36,61,48,201,1127,1011,116
36,61,48,339,52,67,-15
36,61,48,439,184,162,22
36,61,48,453,788,1024,-236
36,61,48,491,60,60,0
36,61,49,35,239,177,62
36,61,49,49,122,68,54
36,61,50,7,91,89,2
36,61,51,3,102,96,6
36,61,51,13,550,362,188
36,61,51,41,0,51,-51
36,61,51,59,581,484,97
36,61,51,87,84,114,-30
36,61,51,107,93,109,-16
36,61,51,153,53,65,-12
36,61,51,510,98,140,-42
36,61,51,540,132,61,71
36,61,51,710,51,61,-10
36,61,51,760,128,166,-38
36,61,51,810,91,117,-26
36,61,53,33,1093,1470,-377
36,61,53,53,0,82,-82
36,61,53,61,50,52,-2
36,61,55,25,219,136,83
36,61,55,79,129,107,22
36,61,56,39,0,47,-47
36,63,4,13,0,78,-78
36,63,12,103,0,81,-81
36,63,32,3,55,53,2
36,63,36,3,0,53,-53
36,63,36,9,65,88,-23
36,63,36,13,66,71,-5
36,63,36,29,5370,5118,252
36,63,36,37,116,105,11
36,63,36,55,168,218,-50
36,63,36,67,66,0,66
36,63,36,73,336,336,0
36,63,36,81,72,0,72
36,63,36,121,0,64,-64
36,63,37,119,0,54,-54
36,65,4,13,0,53,-53
36,65,6,37,0,50,-50
36,65,12,9,0,54,-54
36,65,12,57,0,78,-78
36,65,12,71,0,81,-81
36,65,12,101,0,57,-57
36,65,12,103,0,67,-67
36,65,12,127,0,75,-75
36,65,25,17,0,57,-57
36,65,36,1,101,152,-51
36,65,36,5,124,0,124
36,65,36,7,0,57,-57
36,65,36,17,75,78,-3
36,65,36,29,100,110,-10
36,65,36,43,1229,1289,-60
36,65,36,45,125,86,39
36,65,36,47,145,76,69
36,65,36,49,220,179,41
36,65,36,53,1064,1086,-22
36,65,36,55,79,161,-82
36,65,36,61,88,113,-25
36,65,36,67,626,740,-114
36,65,36,75,240,291,-51
36,65,36,77,151,117,34
36,65,36,81,160,58,102
36,65,36,83,0,73,-73
36,65,36,89,51,0,51
36,65,36,91,81,88,-7
36,65,36,93,0,58,-58
36,65,36,103,86,0,86
36,65,36,109,0,58,-58
36,65,37,119,0,73,-73
36,65,37,183,0,73,-73
36,65,45,51,0,59,-59
36,67,4,13,121,196,-75
36,67,6,1,0,47,-47
36,67,6,37,130,165,-35
36,67,6,59,53,57,-4
36,67,6,73,97,123,-26
36,67,6,85,0,95,-95
36,67,8,5,0,50,-50
36,67,8,31,47,68,-21
36,67,9,1,72,78,-6
36,67,9,3,0,77,-77
36,67,9,9,0,74,-74
36,67,11,1,67,96,-29
36,67,12,9,0,81,-81
36,67,12,11,92,106,-14
36,67,12,31,0,116,-116
36,67,12,57,71,158,-87
36,67,12,69,0,64,-64
36,67,12,71,75,149,-74
36,67,12,81,0,71,-71
36,67,12,83,0,59,-59
36,67,12,86,75,64,11
36,67,12,95,80,141,-61
36,67,12,99,87,97,-10
36,67,12,101,0,94,-94
36,67,12,103,86,121,-35
36,67,12,105,0,91,-91
36,67,12,115,0,110,-110
36,67,12,127,48,92,-44
36,67,13,89,0,78,-78
36,67,13,121,0,83,-83
36,67,15,3,56,0,56
36,67,17,31,94,111,-17
36,67,24,5,0,54,-54
36,67,24,31,56,77,-21
36,67,24,510,0,54,-54
36,67,25,17,121,181,-60
36,67,25,21,0,51,-51
36,67,25,25,75,94,-19
36,67,25,27,0,72,-72
36,67,32,3,61,60,1
36,67,34,17,53,133,-80
36,67,34,23,0,56,-56
36,67,36,1,143,203,-60
36,67,36,5,198,114,84
36,67,36,7,304,169,135
36,67,36,11,1010,898,112
36,67,36,15,54,0,54
36,67,36,17,71,75,-4
36,67,36,23,411,373,38
36,67,36,27,61,0,61
36,67,36,29,333,344,-11
36,67,36,43,80,61,19
36,67,36,45,433,254,179
36,67,36,47,317,216,101
36,67,36,53,1276,1370,-94
36,67,36,55,473,704,-231
36,67,36,59,119,75,44
36,67,36,61,167,224,-57
36,67,36,63,0,66,-66
36,67,36,65,740,626,114
36,67,36,69,147,143,4
36,67,36,71,78,0,78
36,67,36,75,2415,2414,1
36,67,36,77,67,0,67
36,67,36,81,276,156,120
36,67,36,83,45,75,-30
36,67,36,89,174,98,76
36,67,36,91,110,143,-33
36,67,36,93,69,77,-8
36,67,36,99,47,68,-21
36,67,36,101,59,0,59
36,67,36,103,151,74,77
36,67,36,109,197,177,20
36,67,36,117,148,104,44
36,67,36,119,97,86,11
36,67,37,119,117,304,-187
36,67,37,133,0,64,-64
36,67,37,183,0,204,-204
36,67,39,35,0,73,-73
36,67,39,49,63,115,-52
36,67,41,51,0,53,-53
36,67,42,3,67,124,-57
36,67,42,101,65,123,-58
36,67,45,19,0,64,-64
36,67,45,51,0,83,-83
36,67,47,157,0,57,-57
36,67,48,29,59,68,-9
36,67,48,113,0,66,-66
36,67,48,201,75,87,-12
36,67,48,439,0,71,-71
36,67,48,453,0,75,-75
36,67,51,59,59,92,-33
36,67,51,153,0,62,-62
36,67,53,33,61,112,-51
36,69,36,11,0,64,-64
36,69,36,29,127,147,-20
36,69,36,51,266,272,-6
36,69,36,55,2417,1988,429
36,69,36,67,143,147,-4
36,69,36,99,492,506,-14
36,69,36,101,186,160,26
36,69,36,109,77,63,14
36,69,36,117,891,969,-78
36,69,36,123,410,372,38
36,71,4,13,59,71,-12
36,71,6,37,111,130,-19
36,71,6,59,0,51,-51
36,71,6,73,62,116,-54
36,71,8,41,67,71,-4
36,71,9,1,128,202,-74
36,71,9,9,58,91,-33
36,71,10,5,0,73,-73
36,71,12,9,0,84,-84
36,71,12,11,108,126,-18
36,71,12,21,0,71,-71
36,71,12,31,0,64,-64
36,71,12,57,72,162,-90
36,71,12,69,0,54,-54
36,71,12,71,0,87,-87
36,71,12,83,0,63,-63
36,71,12,86,0,59,-59
36,71,12,95,89,128,-39
36,71,12,97,0,82,-82
36,71,12,99,85,179,-94
36,71,12,101,0,98,-98
36,71,12,103,58,106,-48
36,71,12,105,0,70,-70
36,71,12,109,0,68,-68
36,71,12,111,0,62,-62
36,71,12,115,0,109,-109
36,71,12,117,0,62,-62
36,71,12,127,0,103,-103
36,71,13,53,0,54,-54
36,71,13,67,0,54,-54
36,71,13,215,0,53,-53
36,71,15,3,70,70,0
36,71,20,103,0,111,-111
36,71,24,31,0,69,-69
36,71,25,17,65,96,-31
36,71,25,25,0,51,-51
36,71,32,3,0,98,-98
36,71,34,3,581,576,5
36,71,34,13,137,143,-6
36,71,34,17,160,191,-31
36,71,34,23,95,138,-43
36,71,34,25,62,90,-28
36,71,34,27,155,151,4
36,71,34,29,69,92,-23
36,71,34,31,313,184,129
36,71,34,37,216,317,-101
36,71,36,1,162,186,-24
36,71,36,5,2514,728,1786
36,71,36,7,59,69,-10
36,71,36,27,1240,1240,0
36,71,36,29,0,59,-59
36,71,36,39,0,69,-69
36,71,36,47,2178,864,1314
36,71,36,55,0,49,-49
36,71,36,59,429,197,232
36,71,36,61,984,558,426
36,71,36,67,0,78,-78
36,71,36,79,178,105,73
36,71,36,81,1361,478,883
36,71,36,83,55,67,-12
36,71,36,85,303,99,204
36,71,36,87,2100,1095,1005
36,71,36,91,0,110,-110
36,71,36,93,0,56,-56
36,71,36,103,278,189,89
36,71,36,105,1173,1545,-372
36,71,36,111,1540,2010,-470
36,71,36,119,1283,892,391
36,71,37,51,0,98,-98
36,71,37,119,0,164,-164
36,71,37,133,0,62,-62
36,71,37,183,0,166,-166
36,71,42,69,0,68,-68
36,71,42,89,0,63,-63
36,71,42,101,0,84,-84
36,71,42,103,385,653,-268
36,71,42,127,0,97,-97
36,71,45,19,0,74,-74
36,71,45,51,68,305,-237
36,71,47,37,0,49,-49
36,71,48,27,64,57,7
36,71,48,29,0,115,-115
36,71,48,141,0,65,-65
36,71,48,201,69,95,-26
36,71,48,439,0,69,-69
36,71,48,453,0,56,-56
36,71,51,59,91,163,-72
36,71,53,33,0,51,-51
36,71,53,53,0,57,-57
36,73,36,29,139,132,7
36,73,36,37,226,199,27
36,73,36,55,885,924,-39
36,73,36,63,336,336,0
36,75,36,11,286,285,1
36,75,36,29,0,60,-60
36,75,36,45,277,239,38
36,75,36,53,145,108,37
36,75,36,55,95,136,-41
36,75,36,65,291,240,51
36,75,36,67,2414,2415,-1
36,75,36,89,56,0,56
36,75,36,117,82,63,19
36,77,36,1,79,69,10
36,77,36,7,95,101,-6
36,77,36,17,342,332,10
36,77,36,25,545,575,-30
36,77,36,43,186,215,-29
36,77,36,47,49,0,49
36,77,36,53,61,90,-29
36,77,36,55,0,62,-62
36,77,36,57,57,62,-5
36,77,36,65,117,151,-34
36,77,36,67,0,67,-67
36,77,36,81,52,0,52
36,77,36,91,0,57,-57
36,77,36,95,139,103,36
36,77,36,103,123,65,58
36,79,9,1,283,852,-569
36,79,9,5,0,67,-67
36,79,9,9,0,52,-52
36,79,12,99,0,109,-109
36,79,36,5,697,211,486
36,79,36,27,703,1328,-625
36,79,36,47,287,152,135
36,79,36,59,136,53,83
36,79,36,61,313,277,36
36,79,36,71,105,178,-73
36,79,36,81,305,126,179
36,79,36,87,120,79,41
36,79,36,103,81,68,13
36,79,36,111,66,99,-33
36,79,36,119,3250,1912,1338
36,79,45,51,0,70,-70
36,81,1,73,0,67,-67
36,81,4,13,257,550,-293
36,81,4,19,0,80,-80
36,81,6,1,218,363,-145
36,81,6,13,50,136,-86
36,81,6,19,55,62,-7
36,81,6,29,0,70,-70
36,81,6,37,1063,2154,-1091
36,81,6,59,264,409,-145
36,81,6,65,60,114,-54
36,81,6,67,74,187,-113
36,81,6,71,94,180,-86
36,81,6,73,271,543,-272
36,81,6,75,259,421,-162
36,81,6,81,58,198,-140
36,81,6,85,203,397,-194
36,81,6,111,0,72,-72
36,81,8,5,0,121,-121
36,81,8,13,0,64,-64
36,81,8,31,87,210,-123
36,81,8,41,0,87,-87
36,81,8,59,0,54,-54
36,81,9,1,943,1799,-856
36,81,9,3,299,537,-238
36,81,9,5,48,96,-48
36,81,9,7,0,73,-73
36,81,9,9,440,958,-518
36,81,9,11,141,171,-30
36,81,10,1,0,147,-147
36,81,10,3,131,297,-166
36,81,10,5,0,62,-62
36,81,11,1,240,291,-51
36,81,12,1,44,0,44
36,81,12,9,81,220,-139
36,81,12,11,837,1871,-1034
36,81,12,21,54,185,-131
36,81,12,31,104,266,-162
36,81,12,35,0,65,-65
36,81,12,53,0,116,-116
36,81,12,57,288,826,-538
36,81,12,69,0,274,-274
36,81,12,71,116,279,-163
36,81,12,81,0,105,-105
36,81,12,83,76,201,-125
36,81,12,85,0,43,-43
36,81,12,86,779,1389,-610
36,81,12,95,558,1396,-838
36,81,12,97,296,639,-343
36,81,12,99,505,1322,-817
36,81,12,101,95,311,-216
36,81,12,103,159,356,-197
36,81,12,105,111,381,-270
36,81,12,109,0,84,-84
36,81,12,111,97,278,-181
36,81,12,115,54,152,-98
36,81,12,117,158,359,-201
36,81,12,127,90,230,-140
36,81,13,51,50,60,-10
36,81,13,63,76,159,-83
36,81,13,67,101,264,-163
36,81,13,89,168,389,-221
36,81,13,97,0,84,-84
36,81,13,117,0,75,-75
36,81,13,121,211,424,-213
36,81,13,135,268,705,-437
36,81,13,151,0,139,-139
36,81,13,217,0,71,-71
36,81,13,247,0,78,-78
36,81,15,3,176,189,-13
36,81,17,31,648,723,-75
36,81,17,43,65,124,-59
36,81,18,57,0,77,-77
36,81,18,81,0,94,-94
36,81,18,97,0,218,-218
36,81,20,91,0,76,-76
36,81,21,111,0,77,-77
36,81,22,51,0,53,-53
36,81,22,71,47,0,47
36,81,23,5,49,80,-31
36,81,24,3,98,130,-32
36,81,24,5,211,358,-147
36,81,24,21,0,57,-57
36,81,24,25,0,74,-74
36,81,24,27,81,145,-64
36,81,24,31,340,465,-125
36,81,24,33,258,363,-105
36,81,24,510,242,294,-52
36,81,25,1,0,96,-96
36,81,25,3,0,51,-51
36,81,25,5,0,70,-70
36,81,25,9,113,139,-26
36,81,25,13,54,112,-58
36,81,25,15,47,0,47
36,81,25,17,454,490,-36
36,81,25,21,185,263,-78
36,81,25,23,0,81,-81
36,81,25,25,403,392,11
36,81,25,27,85,169,-84
36,81,26,81,0,70,-70
36,81,26,99,0,136,-136
36,81,26,125,90,146,-56
36,81,26,161,74,68,6
36,81,26,163,125,325,-200
36,81,27,37,0,74,-74
36,81,27,53,116,177,-61
36,81,27,123,0,75,-75
36,81,29,189,0,62,-62
36,81,31,55,0,59,-59
36,81,32,3,185,484,-299
36,81,33,11,61,113,-52
36,81,34,1,110,106,4
36,81,34,3,1476,3851,-2375
36,81,34,5,99,300,-201
36,81,34,7,130,211,-81
36,81,34,13,828,2360,-1532
36,81,34,15,0,106,-106
36,81,34,17,2082,3943,-1861
36,81,34,19,52,0,52
36,81,34,21,217,318,-101
36,81,34,23,758,1557,-799
36,81,34,25,328,577,-249
36,81,34,27,251,384,-133
36,81,34,29,193,387,-194
36,81,34,31,292,820,-528
36,81,34,35,194,372,-178
36,81,34,37,63,80,-17
36,81,34,39,528,1319,-791
36,81,34,41,0,67,-67
36,81,35,1,0,48,-48
36,81,36,1,304,477,-173
36,81,36,5,7882,8301,-419
36,81,36,7,129,191,-62
36,81,36,21,0,62,-62
36,81,36,25,0,88,-88
36,81,36,27,375,783,-408
36,81,36,29,246,962,-716
36,81,36,39,56,86,-30
36,81,36,45,89,79,10
36,81,36,47,34862,24986,9876
36,81,36,55,234,292,-58
36,81,36,59,12867,31561,-18694
36,81,36,61,17169,13675,3494
36,81,36,63,0,72,-72
36,81,36,65,58,160,-102
36,81,36,67,156,276,-120
36,81,36,71,478,1361,-883
36,81,36,77,0,52,-52
36,81,36,79,126,305,-179
36,81,36,83,74,112,-38
36,81,36,85,1276,1842,-566
36,81,36,87,484,988,-504
36,81,36,91,105,171,-66
36,81,36,93,143,458,-315
36,81,36,103,4960,10238,-5278
36,81,36,105,95,275,-180
36,81,36,109,55,90,-35
36,81,36,111,157,316,-159
36,81,36,119,1898,3941,-2043
36,81,37,25,0,89,-89
36,81,37,51,91,110,-19
36,81,37,63,71,114,-43
36,81,37,67,0,67,-67
36,81,37,81,64,155,-91
36,81,37,119,265,704,-439
36,81,37,133,63,102,-39
36,81,37,179,0,102,-102
36,81,37,183,186,521,-335
36,81,39,35,87,226,-139
36,81,39,49,155,225,-70
36,81,39,61,65,0,65
36,81,41,51,145,212,-67
36,81,41,67,0,59,-59
36,81,42,3,162,273,-111
36,81,42,11,115,302,-187
36,81,42,17,100,217,-117
36,81,42,29,83,79,4
36,81,42,41,0,67,-67
36,81,42,43,82,185,-103
36,81,42,45,85,305,-220
36,81,42,69,0,122,-122
36,81,42,71,0,148,-148
36,81,42,77,197,591,-394
36,81,42,79,157,359,-202
36,81,42,89,287,914,-627
36,81,42,91,151,296,-145
36,81,42,95,118,358,-240
36,81,42,101,549,1277,-728
36,81,42,103,0,215,-215
36,81,42,127,0,72,-72
36,81,42,133,0,90,-90
36,81,44,7,139,242,-103
36,81,45,19,0,101,-101
36,81,45,45,0,114,-114
36,81,45,51,0,131,-131
36,81,45,79,0,77,-77
36,81,45,91,0,80,-80
36,81,47,37,67,207,-140
36,81,47,157,0,95,-95
36,81,48,27,0,77,-77
36,81,48,29,84,208,-124
36,81,48,85,106,313,-207
36,81,48,113,245,461,-216
36,81,48,121,0,147,-147
36,81,48,141,57,111,-54
36,81,48,157,85,254,-169
36,81,48,201,417,768,-351
36,81,48,439,135,266,-131
36,81,48,453,198,375,-177
36,81,48,491,0,137,-137
36,81,49,35,66,87,-21
36,81,51,13,136,157,-21
36,81,51,41,0,101,-101
36,81,51,59,280,483,-203
36,81,51,87,75,144,-69
36,81,51,107,77,139,-62
36,81,51,153,91,233,-142
36,81,51,510,69,103,-34
36,81,51,700,0,79,-79
36,81,51,710,69,113,-44
36,81,51,760,65,99,-34
36,81,51,810,91,180,-89
36,81,53,33,193,642,-449
36,81,53,53,57,86,-29
36,81,55,25,47,51,-4
36,81,55,79,0,54,-54
36,83,6,37,0,44,-44
36,83,25,3,114,159,-45
36,83,25,17,43,101,-58
36,83,25,25,0,51,-51
36,83,36,1,4677,4387,290
36,83,36,5,68,0,68
36,83,36,21,500,304,196
36,83,36,27,75,0,75
36,83,36,29,58,0,58
36,83,36,35,55,61,-6
36,83,36,39,141,80,61
36,83,36,47,146,99,47
36,83,36,55,52,0,52
36,83,36,57,75,74,1
36,83,36,59,77,0,77
36,83,36,61,75,87,-12
36,83,36,65,73,0,73
36,83,36,67,75,45,30
36,83,36,71,67,55,12
36,83,36,81,112,74,38
36,83,36,91,1206,1711,-505
36,83,36,93,792,814,-22
36,83,36,95,67,0,67
36,83,36,103,107,0,107
36,83,36,111,99,81,18
36,83,36,113,48,98,-50
36,83,36,115,190,169,21
36,83,36,119,57,49,8
36,83,37,119,0,56,-56
36,83,50,3,166,148,18
36,85,4,13,0,114,-114
36,85,6,37,91,165,-74
36,85,6,73,0,70,-70
36,85,9,1,58,99,-41
36,85,9,3,0,71,-71
36,85,9,9,0,97,-97
36,85,10,3,0,84,-84
36,85,12,9,0,65,-65
36,85,12,11,123,324,-201
36,85,12,21,0,83,-83
36,85,12,57,0,158,-158
36,85,12,69,0,69,-69
36,85,12,71,0,142,-142
36,85,12,86,0,116,-116
36,85,12,95,0,260,-260
36,85,12,97,0,77,-77
36,85,12,99,74,338,-264
36,85,12,101,0,96,-96
36,85,12,103,0,61,-61
36,85,12,105,0,63,-63
36,85,12,111,0,66,-66
36,85,12,115,0,82,-82
36,85,12,127,0,61,-61
36,85,13,135,0,72,-72
36,85,17,31,0,74,-74
36,85,32,3,52,95,-43
36,85,34,3,172,447,-275
36,85,34,5,0,97,-97
36,85,34,7,0,72,-72
36,85,34,13,144,415,-271
36,85,34,17,348,609,-261
36,85,34,19,0,102,-102
36,85,34,21,0,138,-138
36,85,34,23,550,2370,-1820
36,85,34,25,506,3095,-2589
36,85,34,27,0,194,-194
36,85,34,29,299,915,-616
36,85,34,31,91,112,-21
36,85,34,35,61,211,-150
36,85,34,37,0,69,-69
36,85,34,39,208,681,-473
36,85,36,1,0,75,-75
36,85,36,5,970,731,239
36,85,36,27,0,85,-85
36,85,36,29,0,62,-62
36,85,36,47,13785,4267,9518
36,85,36,59,306,479,-173
36,85,36,61,1451,1360,91
36,85,36,71,99,303,-204
36,85,36,81,1842,1276,566
36,85,36,87,54,134,-80
36,85,36,103,272,287,-15
36,85,36,105,0,69,-69
36,85,36,111,0,55,-55
36,85,36,119,183,252,-69
36,85,37,119,0,78,-78
36,85,37,183,0,105,-105
36,85,42,17,0,76,-76
36,85,42,77,0,105,-105
36,85,42,79,0,84,-84
36,85,42,89,81,262,-181
36,85,42,95,0,131,-131
36,85,42,101,94,113,-19
36,85,42,103,0,101,-101
36,85,45,51,0,70,-70
36,85,48,201,0,64,-64
36,87,6,37,115,141,-26
36,87,6,73,0,51,-51
36,87,9,1,195,293,-98
36,87,9,9,0,93,-93
36,87,12,11,108,189,-81
36,87,12,57,0,80,-80
36,87,12,71,0,96,-96
36,87,12,86,66,84,-18
36,87,12,95,0,85,-85
36,87,12,99,120,382,-262
36,87,12,103,0,93,-93
36,87,24,31,0,58,-58
36,87,25,17,0,67,-67
36,87,25,25,0,49,-49
36,87,34,3,1211,1882,-671
36,87,34,13,123,203,-80
36,87,34,17,220,338,-118
36,87,34,23,91,120,-29
36,87,34,25,0,77,-77
36,87,34,27,94,161,-67
36,87,34,29,163,292,-129
36,87,34,31,185,416,-231
36,87,34,37,0,62,-62
36,87,34,39,59,97,-38
36,87,36,1,0,77,-77
36,87,36,5,1259,454,805
36,87,36,27,102,196,-94
36,87,36,47,2055,679,1376
36,87,36,59,207,197,10
36,87,36,61,921,808,113
36,87,36,71,1095,2100,-1005
36,87,36,79,79,120,-41
36,87,36,81,988,484,504
36,87,36,85,134,54,80
36,87,36,103,106,155,-49
36,87,36,105,193,179,14
36,87,36,111,80,136,-56
36,87,36,119,1514,1181,333
36,87,37,19,0,67,-67
36,87,37,119,0,67,-67
36,87,37,183,0,64,-64
36,87,42,17,0,58,-58
36,87,42,101,0,128,-128
36,87,42,103,0,68,-68
36,87,45,51,0,92,-92
36,89,36,1,54,50,4
36,89,36,19,97,116,-19
36,89,36,29,0,72,-72
36,89,36,33,375,371,4
36,89,36,45,322,322,0
36,89,36,49,101,91,10
36,89,36,55,53,54,-1
36,89,36,65,0,51,-51
36,89,36,67,98,174,-76
36,89,36,75,0,56,-56
36,91,4,13,90,159,-69
36,91,6,37,63,86,-23
36,91,6,59,0,82,-82
36,91,6,73,73,173,-100
36,91,6,85,0,117,-117
36,91,9,1,53,73,-20
36,91,9,3,60,0,60
36,91,9,11,0,215,-215
36,91,12,9,0,73,-73
36,91,12,21,0,58,-58
36,91,12,57,0,56,-56
36,91,12,71,0,63,-63
36,91,12,81,0,53,-53
36,91,12,83,0,60,-60
36,91,12,99,78,87,-9
36,91,12,103,50,77,-27
36,91,12,115,56,87,-31
36,91,12,127,0,68,-68
36,91,15,3,0,109,-109
36,91,17,31,64,0,64
36,91,25,17,100,103,-3
36,91,25,25,0,70,-70
36,91,34,17,60,0,60
36,91,36,1,3359,2268,1091
36,91,36,7,68,0,68
36,91,36,19,84,56,28
36,91,36,21,82,72,10
36,91,36,27,168,64,104
36,91,36,29,93,69,24
36,91,36,31,100,93,7
36,91,36,35,390,443,-53
36,91,36,39,50,0,50
36,91,36,47,147,96,51
36,91,36,55,86,59,27
36,91,36,57,277,238,39
36,91,36,59,237,63,174
36,91,36,61,166,130,36
36,91,36,65,88,81,7
36,91,36,67,143,110,33
36,91,36,71,110,0,110
36,91,36,77,57,0,57
36,91,36,81,171,105,66
36,91,36,83,1711,1206,505
36,91,36,93,2014,1591,423
36,91,36,95,0,85,-85
36,91,36,103,210,68,142
36,91,36,111,69,48,21
36,91,36,113,1444,1506,-62
36,91,36,115,987,1016,-29
36,91,36,119,111,0,111
36,91,37,183,0,90,-90
36,91,45,15,554,0,554
36,91,45,19,64,0,64
36,91,45,51,0,104,-104
36,91,48,453,59,114,-55
36,91,50,21,51,0,51
36,91,51,710,0,98,-98
36,91,51,810,0,84,-84
36,91,53,33,0,65,-65
36,91,53,35,0,258,-258
36,93,12,57,0,88,-88
36,93,12,99,0,57,-57
36,93,25,17,62,0,62
36,93,25,25,0,50,-50
36,93,36,1,3553,2870,683
36,93,36,5,267,61,206
36,93,36,21,85,0,85
36,93,36,27,67,53,14
36,93,36,35,190,252,-62
36,93,36,47,241,111,130
36,93,36,55,70,0,70
36,93,36,57,336,450,-114
36,93,36,59,63,0,63
36,93,36,61,90,144,-54
36,93,36,65,58,0,58
36,93,36,67,77,69,8
36,93,36,71,56,0,56
36,93,36,81,458,143,315
36,93,36,83,814,792,22
36,93,36,91,1591,2014,-423
36,93,36,95,290,215,75
36,93,36,103,96,0,96
36,93,36,111,57,0,57
36,93,36,113,95,111,-16
36,93,36,115,79,86,-7
36,93,37,119,0,73,-73
36,95,36,1,186,189,-3
36,95,36,25,106,124,-18
36,95,36,35,0,77,-77
36,95,36,39,51,0,51
36,95,36,57,163,122,41
36,95,36,77,103,139,-36
36,95,36,83,0,67,-67
36,95,36,91,85,0,85
36,95,36,93,215,290,-75
36,97,36,15,279,193,86
36,97,36,99,74,72,2
36,97,36,101,209,204,5
36,97,36,109,242,174,68
36,97,36,123,113,98,15
36,99,36,11,125,188,-63
36,99,36,55,82,131,-49
36,99,36,67,68,47,21
36,99,36,69,506,492,14
36,99,36,97,72,74,-2
36,99,36,109,145,164,-19
36,99,36,117,171,215,-44
36,101,36,3,257,269,-12
36,101,36,15,752,929,-177
36,101,36,29,56,97,-41
36,101,36,51,348,298,50
36,101,36,55,193,323,-130
36,101,36,67,0,59,-59
36,101,36,69,160,186,-26
36,101,36,97,204,209,-5
36,101,36,109,0,57,-57
36,101,36,123,178,127,51
36,101,42,117,172,246,-74
36,103,4,13,187,440,-253
36,103,4,19,0,67,-67
36,103,4,21,0,49,-49
36,103,4,25,0,53,-53
36,103,6,1,60,113,-53
36,103,6,13,0,53,-53
36,103,6,37,407,656,-249
36,103,6,59,120,180,-60
36,103,6,65,71,89,-18
36,103,6,71,0,79,-79
36,103,6,73,224,388,-164
36,103,6,75,64,114,-50
36,103,6,81,0,61,-61
36,103,6,85,0,179,-179
36,103,8,1,0,47,-47
36,103,8,5,0,93,-93
36,103,8,13,50,70,-20
36,103,8,31,60,153,-93
36,103,8,41,0,73,-73
36,103,8,59,0,76,-76
36,103,9,1,467,597,-130
36,103,9,3,125,204,-79
36,103,9,5,0,74,-74
36,103,9,9,178,328,-150
36,103,9,11,50,100,-50
36,103,10,1,0,93,-93
36,103,10,3,69,149,-80
36,103,10,5,0,139,-139
36,103,11,1,116,118,-2
36,103,12,1,0,54,-54
36,103,12,9,143,436,-293
36,103,12,11,429,915,-486
36,103,12,15,0,179,-179
36,103,12,17,0,84,-84
36,103,12,19,0,74,-74
36,103,12,21,98,350,-252
36,103,12,31,91,217,-126
36,103,12,33,0,50,-50
36,103,12,35,53,197,-144
36,103,12,53,82,239,-157
36,103,12,57,194,592,-398
36,103,12,61,72,211,-139
36,103,12,69,0,217,-217
36,103,12,71,210,538,-328
36,103,12,81,0,253,-253
36,103,12,83,84,237,-153
36,103,12,85,73,244,-171
36,103,12,86,268,315,-47
36,103,12,87,0,58,-58
36,103,12,95,208,601,-393
36,103,12,97,115,292,-177
36,103,12,99,784,1754,-970
36,103,12,101,128,415,-287
36,103,12,103,155,418,-263
36,103,12,105,56,280,-224
36,103,12,109,0,224,-224
36,103,12,111,107,458,-351
36,103,12,115,110,299,-189
36,103,12,117,72,203,-131
36,103,12,119,50,208,-158
36,103,12,127,125,289,-164
36,103,13,51,0,58,-58
36,103,13,57,0,77,-77
36,103,13,67,0,153,-153
36,103,13,89,0,128,-128
36,103,13,121,87,252,-165
36,103,13,135,70,300,-230
36,103,13,151,0,54,-54
36,103,13,223,0,73,-73
36,103,15,3,115,90,25
36,103,17,31,187,222,-35
36,103,18,97,0,54,-54
36,103,22,71,0,60,-60
36,103,23,5,0,75,-75
36,103,24,3,73,115,-42
36,103,24,5,71,88,-17
36,103,24,31,141,193,-52
36,103,24,33,197,167,30
36,103,24,510,68,99,-31
36,103,25,1,0,60,-60
36,103,25,9,47,85,-38
36,103,25,17,142,301,-159
36,103,25,21,0,160,-160
36,103,25,25,169,227,-58
36,103,25,27,51,88,-37
36,103,32,3,144,351,-207
36,103,33,11,0,79,-79
36,103,34,3,262,341,-79
36,103,34,5,0,69,-69
36,103,34,7,0,111,-111
36,103,34,13,195,255,-60
36,103,34,17,380,497,-117
36,103,34,21,67,94,-27
36,103,34,23,221,328,-107
36,103,34,25,149,160,-11
36,103,34,27,185,205,-20
36,103,34,29,105,108,-3
36,103,34,31,80,111,-31
36,103,34,35,78,112,-34
36,103,34,39,126,220,-94
36,103,35,1,0,58,-58
36,103,36,1,85,202,-117
36,103,36,5,1079,602,477
36,103,36,7,58,90,-32
36,103,36,25,0,64,-64
36,103,36,27,127,258,-131
36,103,36,29,118,195,-77
36,103,36,39,0,67,-67
36,103,36,45,0,60,-60
36,103,36,47,4034,2877,1157
36,103,36,55,106,186,-80
36,103,36,59,20213,11055,9158
36,103,36,61,2879,2814,65
36,103,36,65,0,86,-86
36,103,36,67,74,151,-77
36,103,36,71,189,278,-89
36,103,36,77,65,123,-58
36,103,36,79,68,81,-13
36,103,36,81,10238,4960,5278
36,103,36,83,0,107,-107
36,103,36,85,287,272,15
36,103,36,87,155,106,49
36,103,36,91,68,210,-142
36,103,36,93,0,96,-96
36,103,36,105,0,128,-128
36,103,36,111,87,177,-90
36,103,36,113,0,71,-71
36,103,36,119,821,744,77
36,103,37,19,0,257,-257
36,103,37,21,0,59,-59
36,103,37,25,0,88,-88
36,103,37,51,67,116,-49
36,103,37,63,0,100,-100
36,103,37,67,0,72,-72
36,103,37,81,60,164,-104
36,103,37,97,0,209,-209
36,103,37,101,0,106,-106
36,103,37,109,0,77,-77
36,103,37,119,138,711,-573
36,103,37,129,47,194,-147
36,103,37,133,82,128,-46
36,103,37,179,0,225,-225
36,103,37,183,162,674,-512
36,103,39,35,61,84,-23
36,103,39,49,55,63,-8
36,103,41,51,0,49,-49
36,103,42,3,79,98,-19
36,103,42,11,0,93,-93
36,103,42,17,73,132,-59
36,103,42,29,0,73,-73
36,103,42,41,0,60,-60
36,103,42,43,0,98,-98
36,103,42,45,0,71,-71
36,103,42,69,0,79,-79
36,103,42,71,0,110,-110
36,103,42,77,0,163,-163
36,103,42,79,0,111,-111
36,103,42,89,109,219,-110
36,103,42,91,89,128,-39
36,103,42,95,0,79,-79
36,103,42,101,120,298,-178
36,103,42,103,68,143,-75
36,103,42,127,0,74,-74
36,103,42,133,0,63,-63
36,103,44,7,95,117,-22
36,103,45,13,0,193,-193
36,103,45,15,0,151,-151
36,103,45,19,63,189,-126
36,103,45,43,0,60,-60
36,103,45,45,0,177,-177
36,103,45,51,95,531,-436
36,103,45,57,0,92,-92
36,103,45,63,0,94,-94
36,103,45,79,0,70,-70
36,103,45,83,0,65,-65
36,103,45,91,0,201,-201
36,103,47,37,67,91,-24
36,103,47,157,0,64,-64
36,103,48,29,0,102,-102
36,103,48,85,0,176,-176
36,103,48,113,93,183,-90
36,103,48,121,0,77,-77
36,103,48,201,214,399,-185
36,103,48,439,58,145,-87
36,103,48,453,80,156,-76
36,103,48,491,0,75,-75
36,103,49,35,0,55,-55
36,103,50,7,0,47,-47
36,103,51,13,0,85,-85
36,103,51,41,0,102,-102
36,103,51,59,106,212,-106
36,103,51,87,0,83,-83
36,103,51,107,0,77,-77
36,103,51,153,0,111,-111
36,103,51,510,49,0,49
36,103,51,710,0,53,-53
36,103,51,760,0,84,-84
36,103,51,810,74,143,-69
36,103,53,33,132,165,-33
36,103,53,53,0,55,-55
36,105,12,99,51,59,-8
36,105,34,3,76,0,76
36,105,36,5,190,68,122
36,105,36,25,0,66,-66
36,105,36,27,71,111,-40
36,105,36,47,459,465,-6
36,105,36,59,78,0,78
36,105,36,61,209,84,125
36,105,36,71,1545,1173,372
36,105,36,81,275,95,180
36,105,36,85,69,0,69
36,105,36,87,179,193,-14
36,105,36,103,128,0,128
36,105,36,111,407,343,64
36,105,36,119,118,97,21
36,105,42,103,0,106,-106
36,105,42,127,0,77,-77
36,107,36,7,1051,952,99
36,107,36,15,316,292,24
36,107,36,23,64,82,-18
36,107,36,109,309,305,4
36,107,42,15,371,363,8
36,109,6,1,0,58,-58
36,109,6,37,70,97,-27
36,109,6,75,0,43,-43
36,109,6,85,0,136,-136
36,109,11,1,44,56,-12
36,109,17,31,65,91,-26
36,109,24,31,0,51,-51
36,109,25,17,81,137,-56
36,109,25,25,0,77,-77
36,109,34,17,0,63,-63
36,109,34,23,0,55,-55
36,109,36,7,200,125,75
36,109,36,11,196,288,-92
36,109,36,15,149,205,-56
36,109,36,23,532,669,-137
36,109,36,29,57,67,-10
36,109,36,47,160,116,44
36,109,36,55,125,124,1
36,109,36,61,152,339,-187
36,109,36,65,58,0,58
36,109,36,67,177,197,-20
36,109,36,69,63,77,-14
36,109,36,81,90,55,35
36,109,36,97,174,242,-68
36,109,36,99,164,145,19
36,109,36,101,57,0,57
36,109,36,107,305,309,-4
36,109,37,183,0,60,-60
36,109,42,101,58,59,-1
36,109,53,33,50,136,-86
36,109,55,25,63,0,63
36,111,4,13,52,52,0
36,111,6,37,61,70,-9
36,111,6,73,0,52,-52
36,111,9,1,77,66,11
36,111,9,9,0,61,-61
36,111,12,11,0,59,-59
36,111,12,99,55,96,-41
36,111,12,115,0,82,-82
36,111,34,3,109,0,109
36,111,34,17,73,0,73
36,111,36,1,163,265,-102
36,111,36,5,184,93,91
36,111,36,21,102,106,-4
36,111,36,25,78,69,9
36,111,36,27,1616,1530,86
36,111,36,39,349,438,-89
36,111,36,47,669,293,376
36,111,36,59,162,0,162
36,111,36,61,546,287,259
36,111,36,71,2010,1540,470
36,111,36,79,99,66,33
36,111,36,81,316,157,159
36,111,36,83,81,99,-18
36,111,36,85,55,0,55
36,111,36,87,136,80,56
36,111,36,91,48,69,-21
36,111,36,93,0,57,-57
36,111,36,103,177,87,90
36,111,36,105,343,407,-64
36,111,36,119,271,220,51
36,111,37,183,0,51,-51
36,111,45,51,0,118,-118
36,113,36,1,197,146,51
36,113,36,31,151,135,16
36,113,36,59,65,0,65
36,113,36,83,98,48,50
36,113,36,91,1506,1444,62
36,113,36,93,111,95,16
36,113,36,103,71,0,71
36,113,36,115,1150,1265,-115
36,115,36,1,101,128,-27
36,115,36,31,0,105,-105
36,115,36,83,169,190,-21
36,115,36,91,1016,987,29
36,115,36,93,86,79,7
36,115,36,113,1265,1150,115
36,115,50,3,97,0,97
36,115,50,21,175,138,37
36,117,25,25,0,49,-49
36,117,36,11,234,220,14
36,117,36,29,65,61,4
36,117,36,51,57,0,57
36,117,36,55,2041,2090,-49
36,117,36,67,104,148,-44
36,117,36,69,969,891,78
36,117,36,75,63,82,-19
36,117,36,99,215,171,44
36,117,36,123,62,0,62
36,119,4,13,109,231,-122
36,119,4,19,0,58,-58
36,119,6,1,97,122,-25
36,119,6,13,0,86,-86
36,119,6,37,387,704,-317
36,119,6,59,91,180,-89
36,119,6,65,52,78,-26
36,119,6,73,192,236,-44
36,119,6,75,139,163,-24
36,119,6,81,65,85,-20
36,119,6,85,145,206,-61
36,119,6,111,0,77,-77
36,119,8,5,0,66,-66
36,119,8,13,0,73,-73
36,119,8,31,68,111,-43
36,119,9,1,2815,6664,-3849
36,119,9,3,187,297,-110
36,119,9,5,111,195,-84
36,119,9,9,388,741,-353
36,119,10,3,82,98,-16
36,119,10,5,0,78,-78
36,119,11,1,132,198,-66
36,119,12,9,0,75,-75
36,119,12,11,259,582,-323
36,119,12,21,0,166,-166
36,119,12,31,0,151,-151
36,119,12,57,115,244,-129
36,119,12,61,0,84,-84
36,119,12,69,0,62,-62
36,119,12,71,0,220,-220
36,119,12,81,0,132,-132
36,119,12,83,0,55,-55
36,119,12,85,0,55,-55
36,119,12,86,287,413,-126
36,119,12,95,145,325,-180
36,119,12,97,0,117,-117
36,119,12,99,411,990,-579
36,119,12,101,0,77,-77
36,119,12,103,70,152,-82
36,119,12,105,0,129,-129
36,119,12,111,0,137,-137
36,119,12,115,69,146,-77
36,119,12,117,0,85,-85
36,119,12,127,0,106,-106
36,119,13,67,0,85,-85
36,119,13,89,87,145,-58
36,119,13,121,110,248,-138
36,119,13,135,61,177,-116
36,119,17,31,303,317,-14
36,119,24,5,83,103,-20
36,119,24,31,133,191,-58
36,119,24,33,80,102,-22
36,119,24,510,50,74,-24
36,119,25,1,0,103,-103
36,119,25,3,0,59,-59
36,119,25,9,0,94,-94
36,119,25,13,0,69,-69
36,119,25,17,309,351,-42
36,119,25,21,101,160,-59
36,119,25,25,193,202,-9
36,119,25,27,53,72,-19
36,119,27,53,0,90,-90
36,119,32,3,66,145,-79
36,119,34,3,681,896,-215
36,119,34,5,0,70,-70
36,119,34,7,0,76,-76
36,119,34,13,315,392,-77
36,119,34,17,693,674,19
36,119,34,21,64,108,-44
36,119,34,23,198,261,-63
36,119,34,25,116,206,-90
36,119,34,27,151,200,-49
36,119,34,29,82,119,-37
36,119,34,31,157,219,-62
36,119,34,35,83,76,7
36,119,34,39,150,241,-91
36,119,36,1,108,180,-72
36,119,36,5,14142,6357,7785
36,119,36,7,0,69,-69
36,119,36,21,53,82,-29
36,119,36,27,1341,3034,-1693
36,119,36,29,96,147,-51
36,119,36,47,3652,1981,1671
36,119,36,55,73,123,-50
36,119,36,59,1208,766,442
36,119,36,61,8414,5812,2602
36,119,36,67,86,97,-11
36,119,36,71,892,1283,-391
36,119,36,79,1912,3250,-1338
36,119,36,81,3941,1898,2043
36,119,36,83,49,57,-8
36,119,36,85,252,183,69
36,119,36,87,1181,1514,-333
36,119,36,91,0,111,-111
36,119,36,103,744,821,-77
36,119,36,105,97,118,-21
36,119,36,111,220,271,-51
36,119,37,19,0,69,-69
36,119,37,21,0,55,-55
36,119,37,63,0,72,-72
36,119,37,67,0,70,-70
36,119,37,81,0,74,-74
36,119,37,119,74,302,-228
36,119,37,129,0,61,-61
36,119,37,183,75,372,-297
36,119,39,35,0,83,-83
36,119,39,49,0,129,-129
36,119,41,51,0,65,-65
36,119,42,3,70,109,-39
36,119,42,17,53,78,-25
36,119,42,29,0,69,-69
36,119,42,45,67,0,67
36,119,42,77,64,101,-37
36,119,42,79,0,87,-87
36,119,42,89,0,88,-88
36,119,42,91,83,95,-12
36,119,42,101,192,302,-110
36,119,44,7,67,105,-38
36,119,44,9,0,55,-55
36,119,45,13,0,77,-77
36,119,45,19,0,98,-98
36,119,45,45,0,54,-54
36,119,45,51,0,192,-192
36,119,47,37,0,75,-75
36,119,48,29,62,70,-8
36,119,48,85,0,155,-155
36,119,48,113,59,143,-84
36,119,48,121,0,67,-67
36,119,48,157,0,97,-97
36,119,48,201,177,312,-135
36,119,48,439,0,113,-113
36,119,48,453,103,162,-59
36,119,48,491,0,77,-77
36,119,51,13,0,81,-81
36,119,51,59,122,199,-77
36,119,51,810,0,55,-55
36,119,53,33,91,254,-163
36,121,36,3,65,61,4
36,121,36,9,252,201,51
36,121,36,29,588,482,106
36,121,36,37,343,495,-152
36,121,36,51,184,232,-48
36,121,36,55,77,130,-53
36,121,36,63,64,0,64
36,123,36,15,66,0,66
36,123,36,55,112,130,-18
36,123,36,69,372,410,-38
36,123,36,97,98,113,-15
36,123,36,101,127,178,-51
36,123,36,117,0,62,-62
37,1,37,19,58,0,58
37,1,37,33,320,328,-8
37,1,37,37,330,186,144
37,1,37,51,0,71,-71
37,1,37,57,111,76,35
37,1,37,63,1640,638,1002
37,1,37,67,196,228,-32
37,1,37,77,67,0,67
37,1,37,81,2373,2499,-126
37,1,37,101,85,0,85
37,1,37,119,173,153,20
37,1,37,129,88,76,12
37,1,37,135,1984,1053,931
37,1,37,145,115,149,-34
37,1,37,147,61,0,61
37,1,37,151,240,175,65
37,1,37,157,192,184,8
37,1,37,183,859,599,260
37,3,37,23,73,83,-10
37,3,37,27,250,179,71
37,3,37,35,765,676,89
37,3,37,97,428,348,80
37,3,37,193,73,0,73
37,5,37,9,0,57,-57
37,7,37,119,100,78,22
37,7,37,153,78,117,-39
37,7,37,167,113,118,-5
37,7,37,179,429,457,-28
37,7,45,25,0,91,-91
37,9,37,5,57,0,57
37,9,37,119,0,63,-63
37,9,37,189,307,190,117
37,9,37,193,85,138,-53
37,11,37,23,71,0,71
37,11,37,121,64,98,-34
37,11,37,189,226,269,-43
37,11,47,19,61,92,-31
37,13,37,49,101,172,-71
37,13,37,117,90,73,17
37,13,37,147,817,974,-157
37,13,37,183,158,142,16
37,13,37,187,99,0,99
37,15,37,91,269,216,53
37,15,37,117,64,107,-43
37,15,37,147,75,160,-85
37,15,37,183,0,72,-72
37,17,37,47,302,240,62
37,17,37,51,226,303,-77
37,17,37,129,0,72,-72
37,17,37,155,237,192,45
37,17,37,163,101,79,22
37,17,37,183,0,61,-61
37,19,4,13,63,0,63
37,19,6,73,81,0,81
37,19,9,1,148,0,148
37,19,9,3,73,0,73
37,19,9,9,64,0,64
37,19,12,99,60,0,60
37,19,24,3,79,0,79
37,19,24,27,70,0,70
37,19,24,31,92,0,92
37,19,25,17,76,0,76
37,19,34,3,108,0,108
37,19,34,23,69,0,69
37,19,34,25,116,0,116
37,19,34,27,95,0,95
37,19,34,29,100,0,100
37,19,34,35,76,0,76
37,19,36,27,60,0,60
37,19,36,59,97,0,97
37,19,36,87,67,0,67
37,19,36,103,257,0,257
37,19,36,119,69,0,69
37,19,37,1,0,58,-58
37,19,37,21,52,60,-8
37,19,37,25,115,0,115
37,19,37,31,49,0,49
37,19,37,35,79,0,79
37,19,37,47,303,327,-24
37,19,37,51,206,107,99
37,19,37,57,78,54,24
37,19,37,63,95,63,32
37,19,37,67,147,95,52
37,19,37,71,126,0,126
37,19,37,81,244,112,132
37,19,37,97,56,0,56
37,19,37,101,86,66,20
37,19,37,119,368,196,172
37,19,37,125,106,61,45
37,19,37,129,2714,1674,1040
37,19,37,133,128,113,15
37,19,37,141,258,291,-33
37,19,37,147,0,68,-68
37,19,37,151,81,0,81
37,19,37,155,87,0,87
37,19,37,159,79,0,79
37,19,37,167,63,0,63
37,19,37,179,139,0,139
37,19,37,183,587,341,246
37,19,42,17,81,0,81
37,19,42,91,54,0,54
37,19,45,51,488,648,-160
37,19,51,59,259,0,259
37,19,51,107,107,0,107
37,19,51,153,79,0,79
37,21,4,13,54,79,-25
37,21,6,37,157,92,65
37,21,6,59,56,0,56
37,21,6,73,80,61,19
37,21,8,13,51,0,51
37,21,8,31,84,86,-2
37,21,9,9,49,0,49
37,21,11,1,57,0,57
37,21,12,1,48,0,48
37,21,12,9,137,91,46
37,21,12,11,239,85,154
37,21,12,21,65,0,65
37,21,12,31,128,55,73
37,21,12,57,136,59,77
37,21,12,71,114,83,31
37,21,12,73,57,0,57
37,21,12,86,182,0,182
37,21,12,95,147,49,98
37,21,12,99,215,115,100
37,21,12,103,219,122,97
37,21,12,105,57,0,57
37,21,12,115,119,67,52
37,21,12,117,86,0,86
37,21,12,127,87,49,38
37,21,13,51,88,0,88
37,21,13,67,92,72,20
37,21,13,89,152,68,84
37,21,13,121,130,118,12
37,21,13,135,63,0,63
37,21,17,31,177,80,97
37,21,24,31,61,0,61
37,21,25,17,46,0,46
37,21,36,47,80,49,31
37,21,36,61,78,56,22
37,21,36,103,59,0,59
37,21,36,119,55,0,55
37,21,37,19,60,52,8
37,21,37,23,81,133,-52
37,21,37,25,56,89,-33
37,21,37,27,44,0,44
37,21,37,35,106,141,-35
37,21,37,45,84,60,24
37,21,37,51,77,0,77
37,21,37,63,146,170,-24
37,21,37,67,171,178,-7
37,21,37,71,104,66,38
37,21,37,81,227,167,60
37,21,37,87,796,1230,-434
37,21,37,89,2414,3317,-903
37,21,37,97,56,71,-15
37,21,37,99,214,152,62
37,21,37,111,304,629,-325
37,21,37,113,119,58,61
37,21,37,115,707,900,-193
37,21,37,119,589,538,51
37,21,37,121,0,67,-67
37,21,37,129,150,131,19
37,21,37,135,94,101,-7
37,21,37,147,69,0,69
37,21,37,149,97,132,-35
37,21,37,159,55,0,55
37,21,37,161,122,168,-46
37,21,37,175,265,308,-43
37,21,37,179,60,0,60
37,21,37,183,462,408,54
37,21,37,189,159,111,48
37,21,37,199,164,228,-64
37,21,39,61,61,0,61
37,21,41,51,0,59,-59
37,21,42,3,47,0,47
37,21,42,101,44,51,-7
37,21,45,13,79,60,19
37,21,45,19,199,134,65
37,21,45,45,248,412,-164
37,21,45,51,76,58,18
37,21,45,63,56,51,5
37,21,45,77,0,65,-65
37,21,45,79,107,58,49
37,21,45,83,114,224,-110
37,21,45,91,49,66,-17
37,21,47,37,91,95,-4
37,21,47,65,55,86,-31
37,21,47,93,97,95,2
37,21,47,163,0,67,-67
37,21,47,179,104,137,-33
37,21,48,113,63,0,63
37,21,48,201,130,0,130
37,21,48,439,61,0,61
37,21,48,453,117,80,37
37,21,51,59,116,0,116
37,21,53,33,68,104,-36
37,23,37,3,83,73,10
37,23,37,11,0,71,-71
37,23,37,21,133,81,52
37,23,37,27,867,873,-6
37,23,37,35,1109,1206,-97
37,23,37,45,91,0,91
37,23,37,71,88,58,30
37,23,37,81,53,84,-31
37,23,37,109,90,137,-47
37,23,37,111,454,324,130
37,23,37,119,146,110,36
37,23,37,161,0,85,-85
37,23,37,183,55,66,-11
37,23,37,189,58,0,58
37,25,4,13,0,78,-78
37,25,6,37,108,0,108
37,25,9,3,62,0,62
37,25,12,11,102,0,102
37,25,12,57,69,0,69
37,25,17,31,98,0,98
37,25,34,23,84,0,84
37,25,36,47,69,0,69
37,25,36,59,75,0,75
37,25,36,81,89,0,89
37,25,36,103,88,0,88
37,25,37,19,0,115,-115
37,25,37,21,89,56,33
37,25,37,35,127,144,-17
37,25,37,45,50,0,50
37,25,37,51,116,71,45
37,25,37,57,136,142,-6
37,25,37,63,0,72,-72
37,25,37,67,223,162,61
37,25,37,71,296,364,-68
37,25,37,81,300,176,124
37,25,37,97,553,682,-129
37,25,37,109,103,179,-76
37,25,37,119,9561,5375,4186
37,25,37,123,0,67,-67
37,25,37,129,73,60,13
37,25,37,133,74,0,74
37,25,37,147,61,0,61
37,25,37,151,66,0,66
37,25,37,159,2227,2992,-765
37,25,37,167,529,841,-312
37,25,37,179,583,564,19
37,25,37,183,274,249,25
37,25,45,45,64,60,4
37,25,45,51,0,160,-160
37,25,45,79,89,84,5
37,25,45,91,183,381,-198
37,25,48,201,78,0,78
37,27,37,3,179,250,-71
37,27,37,21,0,44,-44
37,27,37,23,873,867,6
37,27,37,35,1005,939,66
37,27,37,81,0,67,-67
37,27,37,97,72,90,-18
37,27,37,109,75,106,-31
37,27,37,119,107,106,1
37,27,37,183,0,66,-66
37,27,37,189,151,80,71
37,27,37,193,100,77,23
37,29,37,53,141,107,34
37,29,37,139,276,263,13
37,29,51,550,124,111,13
37,29,51,810,89,0,89
37,31,37,19,0,49,-49
37,31,37,49,826,774,52
37,31,37,63,63,53,10
37,31,37,81,58,56,2
37,31,37,101,146,52,94
37,31,37,107,64,0,64
37,31,37,119,70,51,19
37,31,37,127,66,0,66
37,31,37,129,91,127,-36
37,31,37,133,729,674,55
37,31,37,147,153,118,35
37,31,37,183,404,249,155
37,31,37,191,107,0,107
37,31,51,59,66,0,66
37,33,37,1,328,320,8
37,33,37,81,116,138,-22
37,33,37,135,70,0,70
37,33,37,145,93,71,22
37,33,37,157,229,203,26
37,33,51,143,92,77,15
37,33,51,590,218,155,63
37,35,37,3,676,765,-89
37,35,37,19,0,79,-79
37,35,37,21,141,106,35
37,35,37,23,1206,1109,97
37,35,37,25,144,127,17
37,35,37,27,939,1005,-66
37,35,37,45,134,140,-6
37,35,37,67,119,146,-27
37,35,37,71,396,337,59
37,35,37,81,110,147,-37
37,35,37,97,837,648,189
37,35,37,109,1277,1224,53
37,35,37,119,749,711,38
37,35,37,129,74,51,23
37,35,37,159,93,96,-3
37,35,37,179,66,0,66
37,35,37,183,129,165,-36
37,35,37,189,93,68,25
37,35,37,193,66,80,-14
37,35,45,45,57,63,-6
37,35,45,51,0,77,-77
37,35,45,91,63,69,-6
37,37,6,37,55,0,55
37,37,37,1,186,330,-144
37,37,37,63,869,518,351
37,37,37,81,141,169,-28
37,37,37,85,118,91,27
37,37,37,101,88,0,88
37,37,37,105,364,551,-187
37,37,37,119,82,93,-11
37,37,37,125,67,74,-7
37,37,37,135,1090,616,474
37,37,37,151,232,342,-110
37,37,37,183,1850,929,921
37,39,12,57,56,0,56
37,39,12,71,55,0,55
37,39,13,291,80,92,-12
37,39,37,43,241,172,69
37,39,37,75,56,0,56
37,41,37,139,75,88,-13
37,41,37,143,107,156,-49
37,41,37,183,0,61,-61
37,43,13,281,89,74,15
37,43,37,39,172,241,-69
37,45,37,21,60,84,-24
37,45,37,23,0,91,-91
37,45,37,25,0,50,-50
37,45,37,35,140,134,6
37,45,37,71,2024,1504,520
37,45,37,97,64,0,64
37,45,37,109,295,223,72
37,45,37,119,480,357,123
37,45,37,161,492,434,58
37,45,37,179,60,0,60
37,45,45,21,213,209,4
37,45,45,83,88,164,-76
37,45,45,91,167,129,38
37,47,37,17,240,302,-62
37,47,37,19,327,303,24
37,47,37,51,116,134,-18
37,47,37,119,0,68,-68
37,47,37,129,167,132,35
37,47,37,155,109,73,36
37,47,37,183,0,83,-83
37,47,45,51,359,431,-72
37,49,4,13,0,89,-89
37,49,4,27,0,178,-178
37,49,6,37,62,0,62
37,49,6,65,78,0,78
37,49,6,71,119,75,44
37,49,6,73,250,279,-29
37,49,12,31,0,59,-59
37,49,12,33,0,55,-55
37,49,15,3,98,70,28
37,49,37,13,172,101,71
37,49,37,31,774,826,-52
37,49,37,51,0,105,-105
37,49,37,63,0,94,-94
37,49,37,67,50,0,50
37,49,37,81,65,71,-6
37,49,37,101,57,0,57
37,49,37,103,227,234,-7
37,49,37,107,169,156,13
37,49,37,119,95,156,-61
37,49,37,129,84,122,-38
37,49,37,133,588,697,-109
37,49,37,137,276,332,-56
37,49,37,147,290,355,-65
37,49,37,183,327,315,12
37,49,37,191,66,68,-2
37,49,45,13,92,117,-25
37,49,48,439,0,103,-103
37,49,51,59,62,67,-5
37,49,51,153,0,85,-85
37,49,51,179,0,66,-66
37,51,1,31,0,66,-66
37,51,1,45,0,114,-114
37,51,1,89,87,92,-5
37,51,1,113,63,111,-48
37,51,2,20,234,314,-80
37,51,2,90,77,102,-25
37,51,4,3,83,127,-44
37,51,4,13,247,214,33
37,51,4,19,73,53,20
37,51,6,37,279,195,84
37,51,6,53,103,79,24
37,51,6,59,107,0,107
37,51,6,65,129,56,73
37,51,6,67,75,65,10
37,51,6,71,171,165,6
37,51,6,73,224,140,84
37,51,8,41,665,610,55
37,51,9,3,58,0,58
37,51,11,1,74,97,-23
37,51,12,9,84,132,-48
37,51,12,11,202,126,76
37,51,12,31,145,169,-24
37,51,12,57,231,385,-154
37,51,12,71,0,68,-68
37,51,12,83,0,62,-62
37,51,12,86,229,131,98
37,51,12,91,249,403,-154
37,51,12,95,208,150,58
37,51,12,97,79,0,79
37,51,12,99,170,97,73
37,51,12,101,96,75,21
37,51,12,103,72,118,-46
37,51,12,105,62,95,-33
37,51,12,117,0,65,-65
37,51,12,127,77,61,16
37,51,13,29,0,85,-85
37,51,13,51,185,221,-36
37,51,13,53,80,0,80
37,51,13,63,67,66,1
37,51,13,67,0,91,-91
37,51,13,73,123,223,-100
37,51,13,89,93,59,34
37,51,13,121,103,117,-14
37,51,13,135,86,84,2
37,51,13,179,237,182,55
37,51,13,215,256,333,-77
37,51,13,245,228,181,47
37,51,15,3,660,641,19
37,51,17,31,155,112,43
37,51,18,97,78,0,78
37,51,20,61,132,117,15
37,51,20,103,149,95,54
37,51,20,161,71,0,71
37,51,21,47,152,170,-18
37,51,21,93,71,117,-46
37,51,22,115,214,160,54
37,51,24,3,183,184,-1
37,51,24,5,60,0,60
37,51,24,25,91,85,6
37,51,24,27,0,68,-68
37,51,24,31,77,113,-36
37,51,24,33,180,137,43
37,51,25,17,0,75,-75
37,51,25,27,58,0,58
37,51,26,163,90,0,90
37,51,29,169,154,209,-55
37,51,32,3,122,129,-7
37,51,34,5,69,62,7
37,51,34,13,79,0,79
37,51,36,5,135,0,135
37,51,36,45,340,156,184
37,51,36,47,195,153,42
37,51,36,59,61,0,61
37,51,36,61,66,0,66
37,51,36,71,98,0,98
37,51,36,81,110,91,19
37,51,36,103,116,67,49
37,51,37,1,71,0,71
37,51,37,17,303,226,77
37,51,37,19,107,206,-99
37,51,37,21,0,77,-77
37,51,37,25,71,116,-45
37,51,37,47,134,116,18
37,51,37,49,105,0,105
37,51,37,57,0,71,-71
37,51,37,61,69,64,5
37,51,37,63,177,303,-126
37,51,37,67,115,150,-35
37,51,37,71,0,105,-105
37,51,37,81,280,352,-72
37,51,37,85,2168,2793,-625
37,51,37,93,2288,2782,-494
37,51,37,101,281,359,-78
37,51,37,105,237,269,-32
37,51,37,119,417,702,-285
37,51,37,125,426,657,-231
37,51,37,129,220,328,-108
37,51,37,133,240,221,19
37,51,37,135,0,99,-99
37,51,37,141,71,0,71
37,51,37,147,150,134,16
37,51,37,153,86,70,16
37,51,37,155,1532,1022,510
37,51,37,163,578,464,114
37,51,37,165,182,135,47
37,51,37,179,0,84,-84
37,51,37,183,917,1489,-572
37,51,37,191,133,113,20
37,51,37,195,59,83,-24
37,51,39,35,81,0,81
37,51,39,49,64,95,-31
37,51,40,31,243,129,114
37,51,42,3,51,61,-10
37,51,42,41,0,105,-105
37,51,42,101,135,94,41
37,51,45,15,0,90,-90
37,51,45,19,0,97,-97
37,51,45,35,74,0,74
37,51,45,41,64,72,-8
37,51,45,45,0,83,-83
37,51,45,51,163,215,-52
37,51,45,63,0,74,-74
37,51,45,79,334,373,-39
37,51,45,85,87,87,0
37,51,45,91,56,0,56
37,51,47,125,526,579,-53
37,51,48,27,515,506,9
37,51,48,29,382,446,-64
37,51,48,99,158,108,50
37,51,48,113,90,99,-9
37,51,48,141,465,506,-41
37,51,48,201,198,222,-24
37,51,48,439,85,148,-63
37,51,48,453,68,62,6
37,51,51,13,0,62,-62
37,51,51,41,78,86,-8
37,51,51,59,263,351,-88
37,51,51,149,100,130,-30
37,51,51,153,164,123,41
37,51,51,179,75,83,-8
37,51,51,510,0,72,-72
37,51,51,550,0,74,-74
37,51,51,650,79,70,9
37,51,51,700,172,151,21
37,51,51,710,61,0,61
37,51,51,730,0,64,-64
37,51,51,760,55,0,55
37,51,51,810,148,170,-22
37,51,53,33,59,69,-10
37,51,53,53,515,394,121
37,51,53,67,195,228,-33
37,53,37,29,107,141,-34
37,53,37,55,381,239,142
37,53,37,139,161,170,-9
37,53,51,550,575,307,268
37,53,51,710,140,60,80
37,53,51,810,537,245,292
37,55,37,53,239,381,-142
37,55,37,129,0,59,-59
37,55,37,139,75,0,75
37,55,37,147,0,52,-52
37,55,37,183,93,138,-45
37,55,51,41,62,0,62
37,55,51,59,76,0,76
37,55,51,550,125,76,49
37,55,51,810,110,98,12
37,57,37,1,76,111,-35
37,57,37,19,54,78,-24
37,57,37,25,142,136,6
37,57,37,51,71,0,71
37,57,37,59,190,179,11
37,57,37,67,2789,1954,835
37,57,37,71,55,0,55
37,57,37,81,2720,2288,432
37,57,37,97,138,99,39
37,57,37,119,207,293,-86
37,57,37,151,1422,1289,133
37,57,37,157,0,97,-97
37,57,37,159,654,369,285
37,57,37,167,92,0,92
37,57,37,169,107,95,12
37,57,37,183,108,131,-23
37,57,37,197,84,0,84
37,57,45,51,0,117,-117
37,59,37,57,179,190,-11
37,59,37,67,1104,874,230
37,59,37,81,86,70,16
37,59,37,97,262,244,18
37,59,37,119,64,45,19
37,59,37,159,275,248,27
37,59,37,197,135,161,-26
37,61,37,51,64,69,-5
37,61,37,81,0,59,-59
37,61,37,107,252,220,32
37,61,37,129,168,148,20
37,61,37,133,324,309,15
37,61,37,141,221,188,33
37,61,37,147,0,62,-62
37,61,37,163,346,418,-72
37,61,37,183,70,117,-47
37,61,37,191,411,527,-116
37,63,1,73,0,58,-58
37,63,4,13,119,131,-12
37,63,6,1,132,81,51
37,63,6,37,302,172,130
37,63,6,59,86,67,19
37,63,6,73,174,122,52
37,63,6,75,93,147,-54
37,63,6,81,51,100,-49
37,63,6,85,102,206,-104
37,63,8,31,54,98,-44
37,63,9,1,77,0,77
37,63,9,3,45,0,45
37,63,9,9,114,73,41
37,63,10,3,74,0,74
37,63,11,1,333,260,73
37,63,12,1,67,0,67
37,63,12,11,112,80,32
37,63,12,31,80,72,8
37,63,12,57,93,113,-20
37,63,12,86,148,87,61
37,63,12,95,129,79,50
37,63,12,99,92,95,-3
37,63,12,103,56,0,56
37,63,13,51,56,0,56
37,63,13,67,0,68,-68
37,63,13,89,117,112,5
37,63,13,121,193,147,46
37,63,13,135,90,98,-8
37,63,17,31,295,187,108
37,63,18,97,65,0,65
37,63,21,111,0,59,-59
37,63,24,5,68,0,68
37,63,24,31,219,116,103
37,63,24,33,127,143,-16
37,63,24,510,119,63,56
37,63,25,17,223,211,12
37,63,25,21,0,57,-57
37,63,25,25,149,120,29
37,63,25,27,54,0,54
37,63,26,125,57,0,57
37,63,26,161,0,48,-48
37,63,27,53,63,54,9
37,63,32,3,73,0,73
37,63,34,3,65,0,65
37,63,34,13,88,0,88
37,63,34,17,69,69,0
37,63,34,21,55,0,55
37,63,34,23,64,61,3
37,63,36,5,101,0,101
37,63,36,29,50,0,50
37,63,36,47,208,110,98
37,63,36,55,48,0,48
37,63,36,59,118,0,118
37,63,36,61,298,279,19
37,63,36,81,114,71,43
37,63,36,103,100,0,100
37,63,36,119,72,0,72
37,63,37,1,638,1640,-1002
37,63,37,19,63,95,-32
37,63,37,21,170,146,24
37,63,37,25,72,0,72
37,63,37,31,53,63,-10
37,63,37,37,518,869,-351
37,63,37,49,94,0,94
37,63,37,51,303,177,126
37,63,37,67,271,240,31
37,63,37,69,94,244,-150
37,63,37,77,631,1112,-481
37,63,37,81,714,673,41
37,63,37,83,54,60,-6
37,63,37,85,105,132,-27
37,63,37,97,44,0,44
37,63,37,101,219,415,-196
37,63,37,105,117,145,-28
37,63,37,119,603,891,-288
37,63,37,125,72,79,-7
37,63,37,127,102,84,18
37,63,37,129,262,243,19
37,63,37,133,83,90,-7
37,63,37,135,3513,3951,-438
37,63,37,141,0,55,-55
37,63,37,145,380,612,-232
37,63,37,147,236,158,78
37,63,37,159,53,0,53
37,63,37,181,140,203,-63
37,63,37,183,8486,8167,319
37,63,37,185,0,73,-73
37,63,37,189,75,0,75
37,63,37,191,81,0,81
37,63,37,195,56,55,1
37,63,39,35,76,61,15
37,63,39,49,99,74,25
37,63,39,61,62,0,62
37,63,41,51,0,68,-68
37,63,42,3,119,74,45
37,63,42,29,52,0,52
37,63,42,91,62,0,62
37,63,42,101,133,128,5
37,63,44,7,50,0,50
37,63,45,19,88,59,29
37,63,45,45,68,73,-5
37,63,45,51,61,85,-24
37,63,45,79,87,0,87
37,63,47,37,109,118,-9
37,63,47,93,58,0,58
37,63,48,85,55,0,55
37,63,48,113,73,109,-36
37,63,48,201,168,148,20
37,63,48,439,71,78,-7
37,63,48,453,142,121,21
37,63,49,35,54,0,54
37,63,51,13,80,105,-25
37,63,51,41,0,51,-51
37,63,51,59,206,146,60
37,63,51,87,0,88,-88
37,63,51,153,72,0,72
37,63,51,510,66,0,66
37,63,51,760,92,68,24
37,63,53,33,96,280,-184
37,63,55,25,69,0,69
37,65,37,83,164,148,16
37,65,37,127,1730,2083,-353
37,65,37,147,310,471,-161
37,65,37,183,141,229,-88
37,65,37,195,249,247,2
37,67,4,13,102,80,22
37,67,4,19,148,0,148
37,67,6,37,143,126,17
37,67,6,59,90,0,90
37,67,6,73,127,91,36
37,67,8,31,0,54,-54
37,67,11,1,60,75,-15
37,67,12,11,130,83,47
37,67,12,31,72,0,72
37,67,12,57,71,84,-13
37,67,12,71,83,0,83
37,67,12,86,127,57,70
37,67,12,95,82,82,0
37,67,12,99,82,47,35
37,67,12,103,82,59,23
37,67,12,105,57,0,57
37,67,12,117,66,0,66
37,67,13,51,55,0,55
37,67,13,67,0,87,-87
37,67,13,89,65,86,-21
37,67,13,121,81,138,-57
37,67,13,135,69,77,-8
37,67,17,31,84,91,-7
37,67,21,111,55,0,55
37,67,24,31,67,0,67
37,67,24,33,82,0,82
37,67,25,17,47,0,47
37,67,32,3,62,0,62
37,67,34,39,64,0,64
37,67,36,5,72,0,72
37,67,36,47,152,79,73
37,67,36,55,54,0,54
37,67,36,61,77,101,-24
37,67,36,81,67,0,67
37,67,36,103,72,0,72
37,67,36,119,70,0,70
37,67,37,1,228,196,32
37,67,37,19,95,147,-52
37,67,37,21,178,171,7
37,67,37,25,162,223,-61
37,67,37,35,146,119,27
37,67,37,49,0,50,-50
37,67,37,51,150,115,35
37,67,37,57,1954,2789,-835
37,67,37,59,874,1104,-230
37,67,37,63,240,271,-31
37,67,37,71,106,102,4
37,67,37,81,4185,3617,568
37,67,37,97,306,258,48
37,67,37,101,58,61,-3
37,67,37,119,895,1275,-380
37,67,37,129,155,191,-36
37,67,37,133,107,97,10
37,67,37,135,100,120,-20
37,67,37,147,125,69,56
37,67,37,151,295,317,-22
37,67,37,157,306,330,-24
37,67,37,159,232,194,38
37,67,37,169,1228,1219,9
37,67,37,171,528,401,127
37,67,37,179,103,0,103
37,67,37,183,692,770,-78
37,67,37,189,108,90,18
37,67,37,193,133,96,37
37,67,37,197,529,585,-56
37,67,39,35,62,0,62
37,67,39,49,86,56,30
37,67,42,3,59,0,59
37,67,42,101,72,0,72
37,67,45,13,0,73,-73
37,67,45,19,100,114,-14
37,67,45,45,76,131,-55
37,67,45,51,72,166,-94
37,67,45,79,83,62,21
37,67,45,91,94,80,14
37,67,47,37,85,82,3
37,67,47,93,67,61,6
37,67,48,29,62,63,-1
37,67,48,113,69,74,-5
37,67,48,201,77,91,-14
37,67,48,453,0,64,-64
37,67,51,59,101,0,101
37,67,51,87,0,62,-62
37,67,51,760,0,54,-54
37,67,51,810,70,56,14
37,69,37,63,244,94,150
37,69,37,77,372,430,-58
37,69,37,101,191,182,9
37,69,37,127,257,286,-29
37,69,37,181,333,252,81
37,69,37,183,3661,1968,1693
37,69,37,185,85,0,85
37,69,37,195,0,60,-60
37,71,12,11,70,0,70
37,71,13,135,72,0,72
37,71,37,19,0,126,-126
37,71,37,21,66,104,-38
37,71,37,23,58,88,-30
37,71,37,25,364,296,68
37,71,37,35,337,396,-59
37,71,37,45,1504,2024,-520
37,71,37,51,105,0,105
37,71,37,57,0,55,-55
37,71,37,67,102,106,-4
37,71,37,81,94,122,-28
37,71,37,97,178,173,5
37,71,37,109,1029,1438,-409
37,71,37,119,6164,3365,2799
37,71,37,129,77,58,19
37,71,37,133,61,72,-11
37,71,37,159,114,131,-17
37,71,37,161,63,113,-50
37,71,37,179,234,255,-21
37,71,37,183,172,177,-5
37,71,45,19,65,59,6
37,71,45,21,115,164,-49
37,71,45,45,132,115,17
37,71,45,51,71,174,-103
37,71,45,57,69,74,-5
37,71,45,79,115,73,42
37,71,45,83,88,125,-37
37,71,45,91,859,1099,-240
37,73,51,800,125,85,40
37,75,37,39,0,56,-56
37,75,37,173,49,0,49
37,77,37,1,0,67,-67
37,77,37,63,1112,631,481
37,77,37,69,430,372,58
37,77,37,101,0,60,-60
37,77,37,119,0,49,-49
37,77,37,135,76,90,-14
37,77,37,145,114,148,-34
37,77,37,181,523,510,13
37,77,37,183,1094,858,236
37,77,37,185,80,64,16
37,79,37,107,359,237,122
37,79,37,147,437,282,155
37,79,37,191,202,157,45
37,79,37,195,91,118,-27
37,81,4,13,167,170,-3
37,81,6,1,64,0,64
37,81,6,37,216,174,42
37,81,6,59,76,69,7
37,81,6,71,64,0,64
37,81,6,73,155,141,14
37,81,6,85,0,57,-57
37,81,8,31,57,51,6
37,81,9,1,70,0,70
37,81,9,3,55,0,55
37,81,10,3,98,0,98
37,81,11,1,87,112,-25
37,81,12,9,78,75,3
37,81,12,11,200,99,101
37,81,12,31,138,117,21
37,81,12,57,143,153,-10
37,81,12,71,98,70,28
37,81,12,86,175,75,100
37,81,12,95,126,96,30
37,81,12,99,113,64,49
37,81,12,103,104,53,51
37,81,12,105,66,0,66
37,81,12,117,55,0,55
37,81,12,127,55,0,55
37,81,13,51,93,99,-6
37,81,13,63,0,62,-62
37,81,13,67,81,128,-47
37,81,13,89,141,125,16
37,81,13,121,83,280,-197
37,81,13,135,73,184,-111
37,81,15,3,74,0,74
37,81,17,31,138,108,30
37,81,18,97,66,0,66
37,81,24,5,88,0,88
37,81,24,31,87,113,-26
37,81,24,33,151,125,26
37,81,24,510,91,63,28
37,81,25,17,79,50,29
37,81,26,125,76,59,17
37,81,32,3,111,69,42
37,81,34,13,149,53,96
37,81,34,17,57,0,57
37,81,34,23,127,0,127
37,81,34,39,103,0,103
37,81,36,5,153,0,153
37,81,36,29,72,0,72
37,81,36,47,230,111,119
37,81,36,55,78,0,78
37,81,36,59,140,0,140
37,81,36,61,115,92,23
37,81,36,81,155,64,91
37,81,36,103,164,60,104
37,81,36,119,74,0,74
37,81,37,1,2499,2373,126
37,81,37,19,112,244,-132
37,81,37,21,167,227,-60
37,81,37,23,84,53,31
37,81,37,25,176,300,-124
37,81,37,27,67,0,67
37,81,37,31,56,58,-2
37,81,37,33,138,116,22
37,81,37,35,147,110,37
37,81,37,37,169,141,28
37,81,37,49,71,65,6
37,81,37,51,352,280,72
37,81,37,57,2288,2720,-432
37,81,37,59,70,86,-16
37,81,37,61,59,0,59
37,81,37,63,673,714,-41
37,81,37,67,3617,4185,-568
37,81,37,71,122,94,28
37,81,37,83,0,53,-53
37,81,37,85,86,108,-22
37,81,37,89,50,0,50
37,81,37,93,66,0,66
37,81,37,97,167,137,30
37,81,37,101,155,138,17
37,81,37,105,71,52,19
37,81,37,119,1295,1682,-387
37,81,37,123,110,88,22
37,81,37,125,146,109,37
37,81,37,127,78,48,30
37,81,37,129,292,367,-75
37,81,37,133,143,121,22
37,81,37,135,340,306,34
37,81,37,145,71,0,71
37,81,37,147,146,139,7
37,81,37,151,2394,2620,-226
37,81,37,153,104,0,104
37,81,37,155,62,62,0
37,81,37,157,1442,1568,-126
37,81,37,159,185,151,34
37,81,37,167,53,0,53
37,81,37,169,177,143,34
37,81,37,171,67,76,-9
37,81,37,179,113,110,3
37,81,37,183,1766,1837,-71
37,81,37,189,99,100,-1
37,81,37,191,109,70,39
37,81,37,193,73,58,15
37,81,37,195,62,0,62
37,81,39,35,67,0,67
37,81,39,49,70,76,-6
37,81,39,61,63,0,63
37,81,42,3,89,92,-3
37,81,42,101,112,74,38
37,81,45,19,99,121,-22
37,81,45,45,82,151,-69
37,81,45,51,185,215,-30
37,81,45,79,120,102,18
37,81,45,83,54,0,54
37,81,45,91,120,119,1
37,81,47,37,56,71,-15
37,81,47,93,0,53,-53
37,81,47,157,62,0,62
37,81,48,29,0,75,-75
37,81,48,85,0,79,-79
37,81,48,113,73,105,-32
37,81,48,201,166,128,38
37,81,48,439,77,82,-5
37,81,48,453,98,76,22
37,81,51,41,67,63,4
37,81,51,59,116,118,-2
37,81,51,87,74,78,-4
37,81,51,89,122,67,55
37,81,51,121,69,0,69
37,81,51,143,86,54,32
37,81,51,590,195,92,103
37,81,51,690,62,0,62
37,81,51,700,69,0,69
37,81,51,760,0,74,-74
37,81,51,770,72,59,13
37,81,51,810,83,0,83
37,81,53,33,84,99,-15
37,83,37,63,60,54,6
37,83,37,65,148,164,-16
37,83,37,81,53,0,53
37,83,37,127,325,519,-194
37,83,37,131,425,383,42
37,83,37,147,62,106,-44
37,83,37,183,146,239,-93
37,83,37,185,91,152,-61
37,85,2,20,90,0,90
37,85,8,41,259,207,52
37,85,12,57,86,132,-46
37,85,12,91,144,146,-2
37,85,13,73,89,0,89
37,85,13,179,153,0,153
37,85,13,215,79,0,79
37,85,15,3,196,146,50
37,85,20,61,88,0,88
37,85,36,45,186,0,186
37,85,37,37,91,118,-27
37,85,37,51,2793,2168,625
37,85,37,63,132,105,27
37,85,37,81,108,86,22
37,85,37,93,255,170,85
37,85,37,101,1049,1077,-28
37,85,37,105,1188,948,240
37,85,37,119,65,118,-53
37,85,37,125,316,622,-306
37,85,37,129,60,133,-73
37,85,37,133,95,96,-1
37,85,37,135,0,52,-52
37,85,37,155,86,66,20
37,85,37,163,374,455,-81
37,85,37,183,2951,1720,1231
37,85,37,191,59,0,59
37,85,40,31,0,78,-78
37,85,45,79,106,0,106
37,85,47,125,243,118,125
37,85,48,27,201,113,88
37,85,48,29,126,124,2
37,85,48,141,190,144,46
37,85,51,59,95,154,-59
37,85,53,53,162,125,37
37,87,12,99,60,0,60
37,87,12,103,56,0,56
37,87,37,21,1230,796,434
37,87,37,89,125,152,-27
37,87,37,99,298,232,66
37,87,37,113,75,0,75
37,87,37,173,69,0,69
37,87,37,183,66,59,7
37,89,6,37,61,0,61
37,89,12,11,97,0,97
37,89,12,57,55,0,55
37,89,12,71,78,0,78
37,89,12,86,72,0,72
37,89,12,95,67,0,67
37,89,12,99,117,0,117
37,89,12,103,87,0,87
37,89,12,105,64,0,64
37,89,12,127,63,0,63
37,89,37,21,3317,2414,903
37,89,37,81,0,50,-50
37,89,37,87,152,125,27
37,89,37,111,0,71,-71
37,89,37,119,154,125,29
37,89,37,149,280,303,-23
37,89,37,161,93,177,-84
37,89,37,175,420,405,15
37,89,37,183,118,104,14
37,89,45,13,62,0,62
37,89,45,19,66,0,66
37,89,45,45,148,326,-178
37,89,45,83,89,320,-231
37,91,37,15,216,269,-53
37,91,37,131,132,160,-28
37,91,37,147,0,73,-73
37,93,8,41,82,127,-45
37,93,15,3,79,88,-9
37,93,37,51,2782,2288,494
37,93,37,81,0,66,-66
37,93,37,85,170,255,-85
37,93,37,119,0,90,-90
37,93,37,125,356,466,-110
37,93,37,153,61,0,61
37,93,37,155,519,381,138
37,93,37,165,138,101,37
37,93,37,183,78,96,-18
37,93,47,125,121,99,22
37,93,48,141,121,0,121
37,93,53,53,131,0,131
37,97,4,13,73,0,73
37,97,6,37,86,0,86
37,97,6,73,69,0,69
37,97,12,11,103,0,103
37,97,12,86,100,0,100
37,97,12,95,52,0,52
37,97,12,99,102,0,102
37,97,12,127,54,0,54
37,97,17,31,64,0,64
37,97,26,125,65,0,65
37,97,36,59,116,0,116
37,97,36,103,209,0,209
37,97,37,3,348,428,-80
37,97,37,19,0,56,-56
37,97,37,21,71,56,15
37,97,37,25,682,553,129
37,97,37,27,90,72,18
37,97,37,35,648,837,-189
37,97,37,45,0,64,-64
37,97,37,57,99,138,-39
37,97,37,59,244,262,-18
37,97,37,63,0,44,-44
37,97,37,67,258,306,-48
37,97,37,71,173,178,-5
37,97,37,81,137,167,-30
37,97,37,109,241,406,-165
37,97,37,119,3396,2220,1176
37,97,37,129,73,85,-12
37,97,37,133,82,0,82
37,97,37,147,62,0,62
37,97,37,159,818,827,-9
37,97,37,171,0,80,-80
37,97,37,179,135,135,0
37,97,37,183,172,179,-7
37,97,37,193,159,142,17
37,97,37,197,91,104,-13
37,97,45,19,0,91,-91
37,97,45,51,0,118,-118
37,97,45,91,83,144,-61
37,99,37,21,152,214,-62
37,99,37,87,232,298,-66
37,99,37,113,150,255,-105
37,99,37,173,385,427,-42
37,99,37,175,0,62,-62
37,101,12,11,63,0,63
37,101,12,86,86,0,86
37,101,36,47,66,0,66
37,101,36,59,87,0,87
37,101,36,103,106,0,106
37,101,37,1,0,85,-85
37,101,37,19,66,86,-20
37,101,37,31,52,146,-94
37,101,37,37,0,88,-88
37,101,37,49,0,57,-57
37,101,37,51,359,281,78
37,101,37,63,415,219,196
37,101,37,67,61,58,3
37,101,37,69,182,191,-9
37,101,37,77,60,0,60
37,101,37,81,138,155,-17
37,101,37,85,1077,1049,28
37,101,37,105,0,74,-74
37,101,37,107,83,0,83
37,101,37,119,137,112,25
37,101,37,127,345,265,80
37,101,37,129,177,191,-14
37,101,37,133,188,174,14
37,101,37,135,91,80,11
37,101,37,147,258,137,121
37,101,37,163,269,209,60
37,101,37,183,9068,4851,4217
37,101,37,191,701,727,-26
37,101,37,195,310,411,-101
37,101,45,51,64,78,-14
37,103,37,49,234,227,7
37,103,37,107,209,118,91
37,103,37,133,199,199,0
37,105,37,37,551,364,187
37,105,37,51,269,237,32
37,105,37,63,145,117,28
37,105,37,81,52,71,-19
37,105,37,85,948,1188,-240
37,105,37,101,74,0,74
37,105,37,119,0,92,-92
37,105,37,125,256,287,-31
37,105,37,135,56,0,56
37,105,37,183,974,541,433
37,107,37,31,0,64,-64
37,107,37,49,156,169,-13
37,107,37,61,220,252,-32
37,107,37,79,237,359,-122
37,107,37,101,0,83,-83
37,107,37,103,118,209,-91
37,107,37,127,0,116,-116
37,107,37,133,84,149,-65
37,107,37,147,519,710,-191
37,107,37,163,0,180,-180
37,107,37,183,58,135,-77
37,107,37,191,456,528,-72
37,107,37,195,0,182,-182
37,109,36,103,77,0,77
37,109,37,23,137,90,47
37,109,37,25,179,103,76
37,109,37,27,106,75,31
37,109,37,35,1224,1277,-53
37,109,37,45,223,295,-72
37,109,37,71,1438,1029,409
37,109,37,97,406,241,165
37,109,37,119,1828,725,1103
37,109,37,179,87,74,13
37,109,45,91,86,88,-2
37,111,37,21,629,304,325
37,111,37,23,324,454,-130
37,111,37,89,71,0,71
37,111,37,121,65,0,65
37,111,37,161,91,124,-33
37,111,37,199,0,93,-93
37,113,12,103,59,0,59
37,113,13,241,121,108,13
37,113,37,21,58,119,-61
37,113,37,87,0,75,-75
37,113,37,99,255,150,105
37,113,37,173,57,0,57
37,115,37,21,900,707,193
37,115,37,199,0,85,-85
37,117,37,13,73,90,-17
37,117,37,15,107,64,43
37,117,37,147,275,373,-98
37,117,37,183,0,77,-77
37,117,37,187,98,65,33
37,119,1,73,156,86,70
37,119,1,89,79,89,-10
37,119,1,117,0,54,-54
37,119,4,13,660,530,130
37,119,4,19,72,91,-19
37,119,5,7,73,0,73
37,119,6,1,316,198,118
37,119,6,13,175,90,85
37,119,6,37,859,642,217
37,119,6,59,364,231,133
37,119,6,65,140,105,35
37,119,6,67,120,107,13
37,119,6,71,124,81,43
37,119,6,73,402,304,98
37,119,6,75,153,192,-39
37,119,6,81,97,50,47
37,119,6,85,235,252,-17
37,119,6,111,101,0,101
37,119,8,5,178,119,59
37,119,8,13,0,63,-63
37,119,8,31,212,282,-70
37,119,8,35,95,98,-3
37,119,8,41,107,109,-2
37,119,8,59,74,86,-12
37,119,9,1,408,144,264
37,119,9,3,429,215,214
37,119,9,9,244,90,154
37,119,10,3,160,181,-21
37,119,11,1,361,271,90
37,119,12,1,120,61,59
37,119,12,9,121,115,6
37,119,12,11,905,416,489
37,119,12,17,50,0,50
37,119,12,19,64,0,64
37,119,12,21,121,77,44
37,119,12,31,486,386,100
37,119,12,33,77,57,20
37,119,12,57,516,464,52
37,119,12,61,0,71,-71
37,119,12,69,72,67,5
37,119,12,71,226,150,76
37,119,12,73,118,0,118
37,119,12,81,100,76,24
37,119,12,83,0,71,-71
37,119,12,86,818,346,472
37,119,12,91,0,47,-47
37,119,12,95,608,397,211
37,119,12,97,79,78,1
37,119,12,99,506,395,111
37,119,12,101,112,106,6
37,119,12,103,294,243,51
37,119,12,105,145,114,31
37,119,12,109,79,130,-51
37,119,12,111,55,0,55
37,119,12,115,116,99,17
37,119,12,117,170,146,24
37,119,12,127,120,132,-12
37,119,13,51,228,118,110
37,119,13,57,90,79,11
37,119,13,59,78,0,78
37,119,13,63,88,107,-19
37,119,13,67,400,431,-31
37,119,13,73,117,0,117
37,119,13,89,486,450,36
37,119,13,117,95,80,15
37,119,13,121,794,941,-147
37,119,13,135,347,369,-22
37,119,13,151,0,81,-81
37,119,13,215,51,0,51
37,119,13,245,167,97,70
37,119,15,3,159,72,87
37,119,17,31,1011,593,418
37,119,17,43,219,124,95
37,119,17,89,93,0,93
37,119,17,97,144,58,86
37,119,17,197,123,61,62
37,119,18,57,87,0,87
37,119,18,97,195,156,39
37,119,19,153,56,0,56
37,119,20,91,82,98,-16
37,119,21,67,94,98,-4
37,119,21,111,148,128,20
37,119,22,33,112,0,112
37,119,22,51,89,0,89
37,119,22,71,74,51,23
37,119,23,5,68,72,-4
37,119,24,3,184,76,108
37,119,24,5,226,148,78
37,119,24,21,87,0,87
37,119,24,25,72,0,72
37,119,24,27,150,130,20
37,119,24,31,387,307,80
37,119,24,33,373,244,129
37,119,24,510,243,109,134
37,119,25,5,82,0,82
37,119,25,9,132,65,67
37,119,25,13,122,0,122
37,119,25,17,321,174,147
37,119,25,21,196,82,114
37,119,25,23,71,0,71
37,119,25,25,275,157,118
37,119,25,27,166,78,88
37,119,26,77,79,0,79
37,119,26,81,112,86,26
37,119,26,99,71,0,71
37,119,26,125,341,181,160
37,119,26,161,56,59,-3
37,119,26,163,176,128,48
37,119,27,37,0,58,-58
37,119,27,53,370,190,180
37,119,27,123,48,0,48
37,119,29,95,49,61,-12
37,119,29,189,224,134,90
37,119,29,510,75,0,75
37,119,31,55,98,78,20
37,119,32,3,216,305,-89
37,119,33,11,84,0,84
37,119,34,3,308,103,205
37,119,34,5,147,81,66
37,119,34,7,117,0,117
37,119,34,13,362,98,264
37,119,34,17,441,228,213
37,119,34,21,127,0,127
37,119,34,23,482,201,281
37,119,34,25,190,60,130
37,119,34,27,260,71,189
37,119,34,29,69,0,69
37,119,34,31,164,0,164
37,119,34,35,147,59,88
37,119,34,39,186,94,92
37,119,35,1,0,51,-51
37,119,36,1,128,0,128
37,119,36,5,481,148,333
37,119,36,7,67,0,67
37,119,36,27,86,0,86
37,119,36,29,361,183,178
37,119,36,47,839,404,435
37,119,36,55,369,161,208
37,119,36,59,609,173,436
37,119,36,61,679,580,99
37,119,36,63,54,0,54
37,119,36,65,73,0,73
37,119,36,67,304,117,187
37,119,36,71,164,0,164
37,119,36,81,704,265,439
37,119,36,83,56,0,56
37,119,36,85,78,0,78
37,119,36,87,67,0,67
37,119,36,93,73,0,73
37,119,36,103,711,138,573
37,119,36,119,302,74,228
37,119,37,1,153,173,-20
37,119,37,7,78,100,-22
37,119,37,9,63,0,63
37,119,37,19,196,368,-172
37,119,37,21,538,589,-51
37,119,37,23,110,146,-36
37,119,37,25,5375,9561,-4186
37,119,37,27,106,107,-1
37,119,37,31,51,70,-19
37,119,37,35,711,749,-38
37,119,37,37,93,82,11
37,119,37,45,357,480,-123
37,119,37,47,68,0,68
37,119,37,49,156,95,61
37,119,37,51,702,417,285
37,119,37,57,293,207,86
37,119,37,59,45,64,-19
37,119,37,63,891,603,288
37,119,37,67,1275,895,380
37,119,37,71,3365,6164,-2799
37,119,37,77,49,0,49
37,119,37,81,1682,1295,387
37,119,37,85,118,65,53
37,119,37,89,125,154,-29
37,119,37,93,90,0,90
37,119,37,97,2220,3396,-1176
37,119,37,101,112,137,-25
37,119,37,105,92,0,92
37,119,37,109,725,1828,-1103
37,119,37,123,58,76,-18
37,119,37,125,199,138,61
37,119,37,127,91,0,91
37,119,37,129,560,514,46
37,119,37,133,282,136,146
37,119,37,135,318,260,58
37,119,37,141,0,66,-66
37,119,37,147,334,161,173
37,119,37,151,124,115,9
37,119,37,153,73,83,-10
37,119,37,155,149,78,71
37,119,37,157,49,0,49
37,119,37,159,764,1145,-381
37,119,37,161,130,150,-20
37,119,37,167,380,643,-263
37,119,37,171,63,109,-46
37,119,37,175,0,56,-56
37,119,37,179,5414,8767,-3353
37,119,37,183,2382,2300,82
37,119,37,189,183,177,6
37,119,37,191,94,76,18
37,119,37,193,76,64,12
37,119,37,195,85,0,85
37,119,39,35,398,222,176
37,119,39,41,87,0,87
37,119,39,49,491,380,111
37,119,39,61,259,205,54
37,119,39,95,63,0,63
37,119,39,113,131,60,71
37,119,39,151,77,0,77
37,119,39,153,110,101,9
37,119,40,109,91,0,91
37,119,41,51,95,126,-31
37,119,41,67,68,114,-46
37,119,42,3,468,339,129
37,119,42,17,103,0,103
37,119,42,29,172,88,84
37,119,42,43,73,0,73
37,119,42,45,79,0,79
37,119,42,49,90,0,90
37,119,42,71,62,0,62
37,119,42,77,113,0,113
37,119,42,89,71,0,71
37,119,42,91,179,160,19
37,119,42,95,72,0,72
37,119,42,101,345,208,137
37,119,42,133,88,0,88
37,119,44,7,150,98,52
37,119,45,3,92,102,-10
37,119,45,7,125,84,41
37,119,45,13,205,242,-37
37,119,45,15,200,236,-36
37,119,45,19,688,807,-119
37,119,45,21,52,125,-73
37,119,45,23,90,142,-52
37,119,45,25,88,114,-26
37,119,45,31,102,76,26
37,119,45,35,173,134,39
37,119,45,41,205,130,75
37,119,45,43,74,132,-58
37,119,45,45,675,760,-85
37,119,45,51,401,561,-160
37,119,45,55,68,67,1
37,119,45,57,1092,2446,-1354
37,119,45,63,369,258,111
37,119,45,75,89,0,89
37,119,45,77,95,61,34
37,119,45,79,1103,776,327
37,119,45,83,356,343,13
37,119,45,85,118,85,33
37,119,45,91,3176,7141,-3965
37,119,47,37,291,386,-95
37,119,47,65,91,64,27
37,119,47,93,199,160,39
37,119,47,149,69,69,0
37,119,47,157,189,148,41
37,119,47,179,95,0,95
37,119,47,187,105,142,-37
37,119,48,27,69,0,69
37,119,48,29,254,183,71
37,119,48,85,276,270,6
37,119,48,113,477,583,-106
37,119,48,121,112,156,-44
37,119,48,141,81,0,81
37,119,48,157,121,95,26
37,119,48,201,610,444,166
37,119,48,339,0,63,-63
37,119,48,439,241,227,14
37,119,48,453,266,317,-51
37,119,48,491,104,100,4
37,119,49,35,129,107,22
37,119,49,49,0,84,-84
37,119,51,3,83,50,33
37,119,51,13,234,135,99
37,119,51,41,159,102,57
37,119,51,59,631,407,224
37,119,51,87,237,153,84
37,119,51,95,54,0,54
37,119,51,107,209,130,79
37,119,51,121,61,53,8
37,119,51,153,135,106,29
37,119,51,161,78,0,78
37,119,51,510,158,84,74
37,119,51,550,103,82,21
37,119,51,650,110,104,6
37,119,51,680,74,0,74
37,119,51,700,122,56,66
37,119,51,710,148,74,74
37,119,51,760,174,123,51
37,119,51,770,158,100,58
37,119,51,800,60,0,60
37,119,51,810,231,167,64
37,119,53,33,305,439,-134
37,119,53,53,0,61,-61
37,119,53,61,117,71,46
37,119,54,39,92,0,92
37,119,54,61,57,0,57
37,119,55,25,85,84,1
37,119,55,79,221,70,151
37,119,55,133,62,0,62
37,121,37,11,98,64,34
37,121,37,21,67,0,67
37,121,37,111,0,65,-65
37,121,37,199,175,138,37
37,123,37,25,67,0,67
37,123,37,81,88,110,-22
37,123,37,119,76,58,18
37,123,37,125,156,215,-59
37,123,37,151,183,256,-73
37,123,37,153,137,121,16
37,123,37,167,267,182,85
37,125,8,41,181,128,53
37,125,12,91,142,0,142
37,125,13,215,105,0,105
37,125,15,3,111,0,111
37,125,37,19,61,106,-45
37,125,37,37,74,67,7
37,125,37,51,657,426,231
37,125,37,63,79,72,7
37,125,37,81,109,146,-37
37,125,37,85,622,316,306
37,125,37,93,466,356,110
37,125,37,105,287,256,31
37,125,37,119,138,199,-61
37,125,37,123,215,156,59
37,125,37,129,63,74,-11
37,125,37,151,141,149,-8
37,125,37,153,297,218,79
37,125,37,155,85,0,85
37,125,37,165,140,71,69
37,125,37,183,351,391,-40
37,125,47,125,155,70,85
37,125,51,59,89,90,-1
37,125,53,53,130,0,130
37,127,37,31,0,66,-66
37,127,37,63,84,102,-18
37,127,37,65,2083,1730,353
37,127,37,69,286,257,29
37,127,37,81,48,78,-30
37,127,37,83,519,325,194
37,127,37,101,265,345,-80
37,127,37,107,116,0,116
37,127,37,119,0,91,-91
37,127,37,147,255,209,46
37,127,37,183,901,1045,-144
37,127,37,191,77,0,77
37,127,37,195,843,889,-46
37,129,4,13,67,84,-17
37,129,6,37,77,85,-8
37,129,6,59,84,0,84
37,129,6,73,128,106,22
37,129,8,31,0,44,-44
37,129,9,1,87,0,87
37,129,12,11,85,0,85
37,129,12,31,0,47,-47
37,129,12,57,68,0,68
37,129,12,71,0,55,-55
37,129,12,95,0,70,-70
37,129,12,99,67,0,67
37,129,12,103,0,88,-88
37,129,13,51,0,55,-55
37,129,13,89,0,62,-62
37,129,13,121,58,65,-7
37,129,17,31,56,51,5
37,129,24,3,82,0,82
37,129,24,31,91,0,91
37,129,25,17,54,0,54
37,129,34,27,56,0,56
37,129,34,29,56,0,56
37,129,36,47,72,0,72
37,129,36,55,55,0,55
37,129,36,59,80,0,80
37,129,36,61,65,51,14
37,129,36,103,194,47,147
37,129,36,119,61,0,61
37,129,37,1,76,88,-12
37,129,37,17,72,0,72
37,129,37,19,1674,2714,-1040
37,129,37,21,131,150,-19
37,129,37,25,60,73,-13
37,129,37,31,127,91,36
37,129,37,35,51,74,-23
37,129,37,47,132,167,-35
37,129,37,49,122,84,38
37,129,37,51,328,220,108
37,129,37,55,59,0,59
37,129,37,61,148,168,-20
37,129,37,63,243,262,-19
37,129,37,67,191,155,36
37,129,37,71,58,77,-19
37,129,37,81,367,292,75
37,129,37,85,133,60,73
37,129,37,97,85,73,12
37,129,37,101,191,177,14
37,129,37,119,514,560,-46
37,129,37,125,74,63,11
37,129,37,133,758,686,72
37,129,37,135,140,92,48
37,129,37,141,1457,2143,-686
37,129,37,147,236,166,70
37,129,37,151,53,0,53
37,129,37,155,71,64,7
37,129,37,159,58,0,58
37,129,37,163,134,84,50
37,129,37,179,94,83,11
37,129,37,183,1212,1277,-65
37,129,37,189,48,56,-8
37,129,37,191,90,75,15
37,129,39,49,95,0,95
37,129,42,3,80,0,80
37,129,45,13,57,0,57
37,129,45,19,79,118,-39
37,129,45,45,62,60,2
37,129,45,51,158,175,-17
37,129,47,37,62,0,62
37,129,48,453,0,49,-49
37,129,51,59,241,58,183
37,129,51,107,69,0,69
37,129,51,153,78,0,78
37,129,51,810,72,56,16
37,129,53,33,0,51,-51
37,131,37,83,383,425,-42
37,131,37,91,160,132,28
37,131,37,183,0,55,-55
37,133,4,13,165,253,-88
37,133,4,27,95,164,-69
37,133,6,37,217,216,1
37,133,6,53,65,75,-10
37,133,6,59,167,124,43
37,133,6,65,281,281,0
37,133,6,67,63,0,63
37,133,6,71,625,399,226
37,133,6,73,1510,1618,-108
37,133,6,85,61,0,61
37,133,8,41,65,97,-32
37,133,9,1,72,0,72
37,133,9,9,85,0,85
37,133,11,1,67,0,67
37,133,12,9,0,86,-86
37,133,12,11,135,120,15
37,133,12,19,82,0,82
37,133,12,31,203,252,-49
37,133,12,33,234,123,111
37,133,12,57,213,286,-73
37,133,12,71,0,66,-66
37,133,12,86,129,98,31
37,133,12,91,71,0,71
37,133,12,95,108,153,-45
37,133,12,99,96,85,11
37,133,12,101,0,57,-57
37,133,12,103,83,85,-2
37,133,12,105,0,90,-90
37,133,12,113,121,94,27
37,133,12,117,0,66,-66
37,133,13,39,105,0,105
37,133,13,51,0,72,-72
37,133,13,67,0,66,-66
37,133,13,89,0,63,-63
37,133,13,121,0,62,-62
37,133,13,135,79,74,5
37,133,15,3,427,451,-24
37,133,17,31,131,157,-26
37,133,17,97,84,82,2
37,133,24,3,129,206,-77
37,133,24,5,60,0,60
37,133,24,31,95,86,9
37,133,24,33,91,65,26
37,133,25,17,70,69,1
37,133,25,27,63,0,63
37,133,26,99,67,0,67
37,133,26,125,54,0,54
37,133,26,163,68,102,-34
37,133,29,169,90,0,90
37,133,32,3,86,126,-40
37,133,34,5,69,87,-18
37,133,34,29,58,0,58
37,133,36,5,64,0,64
37,133,36,29,0,71,-71
37,133,36,47,129,0,129
37,133,36,59,108,0,108
37,133,36,67,64,0,64
37,133,36,71,62,0,62
37,133,36,81,102,63,39
37,133,36,103,128,82,46
37,133,37,19,113,128,-15
37,133,37,25,0,74,-74
37,133,37,31,674,729,-55
37,133,37,49,697,588,109
37,133,37,51,221,240,-19
37,133,37,61,309,324,-15
37,133,37,63,90,83,7
37,133,37,67,97,107,-10
37,133,37,71,72,61,11
37,133,37,81,121,143,-22
37,133,37,85,96,95,1
37,133,37,97,0,82,-82
37,133,37,101,174,188,-14
37,133,37,103,199,199,0
37,133,37,107,149,84,65
37,133,37,119,136,282,-146
37,133,37,129,686,758,-72
37,133,37,141,629,676,-47
37,133,37,147,129,170,-41
37,133,37,163,65,0,65
37,133,37,183,448,568,-120
37,133,37,191,76,135,-59
37,133,39,35,66,74,-8
37,133,39,49,75,91,-16
37,133,39,113,68,0,68
37,133,40,31,86,0,86
37,133,42,3,51,73,-22
37,133,42,71,53,0,53
37,133,45,13,448,415,33
37,133,45,15,0,81,-81
37,133,45,19,0,81,-81
37,133,45,45,0,64,-64
37,133,45,51,116,111,5
37,133,45,63,70,0,70
37,133,48,29,181,210,-29
37,133,48,113,0,92,-92
37,133,48,141,0,86,-86
37,133,48,201,145,152,-7
37,133,48,355,104,0,104
37,133,48,439,69,163,-94
37,133,48,451,60,0,60
37,133,48,453,0,47,-47
37,133,51,59,159,276,-117
37,133,51,107,71,0,71
37,133,51,153,460,465,-5
37,133,51,177,0,84,-84
37,133,51,179,370,437,-67
37,133,51,510,0,70,-70
37,133,51,550,124,137,-13
37,133,51,700,0,78,-78
37,133,51,710,188,118,70
37,133,51,740,83,61,22
37,133,51,810,264,270,-6
37,133,53,33,0,71,-71
37,133,53,35,131,62,69
37,133,53,53,64,0,64
37,135,6,1,77,0,77
37,135,6,37,186,129,57
37,135,6,73,79,54,25
37,135,6,75,59,54,5
37,135,6,85,64,59,5
37,135,8,31,0,50,-50
37,135,11,1,110,115,-5
37,135,12,86,75,0,75
37,135,12,99,59,0,59
37,135,13,121,0,90,-90
37,135,17,31,109,84,25
37,135,24,31,103,72,31
37,135,25,17,121,85,36
37,135,25,25,67,84,-17
37,135,36,47,76,61,15
37,135,36,61,137,135,2
37,135,37,1,1053,1984,-931
37,135,37,21,101,94,7
37,135,37,33,0,70,-70
37,135,37,37,616,1090,-474
37,135,37,51,99,0,99
37,135,37,63,3951,3513,438
37,135,37,67,120,100,20
37,135,37,77,90,76,14
37,135,37,81,306,340,-34
37,135,37,85,52,0,52
37,135,37,101,80,91,-11
37,135,37,105,0,56,-56
37,135,37,119,260,318,-58
37,135,37,129,92,140,-48
37,135,37,145,138,187,-49
37,135,37,147,58,65,-7
37,135,37,183,1517,1646,-129
37,135,39,49,84,0,84
37,135,42,3,0,52,-52
37,135,42,101,55,77,-22
37,135,45,19,0,51,-51
37,135,48,201,83,0,83
37,135,48,453,0,60,-60
37,135,51,59,84,55,29
37,135,53,33,72,109,-37
37,137,37,49,332,276,56
37,137,37,183,56,0,56
37,139,2,150,0,73,-73
37,139,37,29,263,276,-13
37,139,37,41,88,75,13
37,139,37,53,170,161,9
37,139,37,55,0,75,-75
37,139,37,143,358,368,-10
37,139,37,147,0,71,-71
37,139,37,183,61,107,-46
37,139,51,550,250,209,41
37,139,51,710,117,0,117
37,139,51,810,241,138,103
37,141,6,73,77,0,77
37,141,37,19,291,258,33
37,141,37,51,0,71,-71
37,141,37,61,188,221,-33
37,141,37,63,55,0,55
37,141,37,119,66,0,66
37,141,37,129,2143,1457,686
37,141,37,133,676,629,47
37,141,37,183,211,187,24
37,143,37,41,156,107,49
37,143,37,139,368,358,10
37,145,37,1,149,115,34
37,145,37,33,71,93,-22
37,145,37,63,612,380,232
37,145,37,77,148,114,34
37,145,37,81,0,71,-71
37,145,37,135,187,138,49
37,145,37,183,148,126,22
37,145,51,83,59,0,59
37,147,9,9,56,0,56
37,147,36,47,66,0,66
37,147,37,1,0,61,-61
37,147,37,13,974,817,157
37,147,37,15,160,75,85
37,147,37,19,68,0,68
37,147,37,21,0,69,-69
37,147,37,25,0,61,-61
37,147,37,31,118,153,-35
37,147,37,49,355,290,65
37,147,37,51,134,150,-16
37,147,37,55,52,0,52
37,147,37,61,62,0,62
37,147,37,63,158,236,-78
37,147,37,65,471,310,161
37,147,37,67,69,125,-56
37,147,37,79,282,437,-155
37,147,37,81,139,146,-7
37,147,37,83,106,62,44
37,147,37,91,73,0,73
37,147,37,97,0,62,-62
37,147,37,101,137,258,-121
37,147,37,107,710,519,191
37,147,37,117,373,275,98
37,147,37,119,161,334,-173
37,147,37,127,209,255,-46
37,147,37,129,166,236,-70
37,147,37,133,170,129,41
37,147,37,135,65,58,7
37,147,37,139,71,0,71
37,147,37,183,682,1367,-685
37,147,37,187,112,0,112
37,147,37,191,299,220,79
37,147,37,195,276,273,3
37,147,45,51,0,71,-71
37,149,37,21,132,97,35
37,149,37,89,303,280,23
37,149,37,161,124,172,-48
37,149,45,45,74,70,4
37,149,45,83,181,264,-83
37,151,37,1,175,240,-65
37,151,37,19,0,81,-81
37,151,37,25,0,66,-66
37,151,37,37,342,232,110
37,151,37,57,1289,1422,-133
37,151,37,67,317,295,22
37,151,37,81,2620,2394,226
37,151,37,119,115,124,-9
37,151,37,123,256,183,73
37,151,37,125,149,141,8
37,151,37,129,0,53,-53
37,151,37,157,111,121,-10
37,151,37,159,69,0,69
37,151,37,183,186,171,15
37,151,45,51,64,107,-43
37,153,37,7,117,78,39
37,153,37,51,70,86,-16
37,153,37,81,0,104,-104
37,153,37,93,0,61,-61
37,153,37,119,83,73,10
37,153,37,123,121,137,-16
37,153,37,125,218,297,-79
37,153,37,165,217,189,28
37,153,37,183,0,54,-54
37,155,37,17,192,237,-45
37,155,37,19,0,87,-87
37,155,37,47,73,109,-36
37,155,37,51,1022,1532,-510
37,155,37,81,62,62,0
37,155,37,85,66,86,-20
37,155,37,93,381,519,-138
37,155,37,119,78,149,-71
37,155,37,125,0,85,-85
37,155,37,129,64,71,-7
37,155,37,165,311,405,-94
37,155,37,183,119,172,-53
37,155,45,33,132,101,31
37,155,45,51,0,100,-100
37,157,37,1,184,192,-8
37,157,37,33,203,229,-26
37,157,37,57,97,0,97
37,157,37,67,330,306,24
37,157,37,81,1568,1442,126
37,157,37,119,0,49,-49
37,157,37,151,121,111,10
37,157,37,169,256,180,76
37,157,37,183,54,82,-28
37,157,51,89,170,166,4
37,157,51,143,111,0,111
37,157,51,590,80,80,0
37,159,37,19,0,79,-79
37,159,37,21,0,55,-55
37,159,37,25,2992,2227,765
37,159,37,35,96,93,3
37,159,37,57,369,654,-285
37,159,37,59,248,275,-27
37,159,37,63,0,53,-53
37,159,37,67,194,232,-38
37,159,37,71,131,114,17
37,159,37,81,151,185,-34
37,159,37,97,827,818,9
37,159,37,119,1145,764,381
37,159,37,129,0,58,-58
37,159,37,151,0,69,-69
37,159,37,167,187,215,-28
37,159,37,179,121,85,36
37,159,37,183,90,84,6
37,159,45,51,70,70,0
37,161,37,21,168,122,46
37,161,37,23,85,0,85
37,161,37,45,434,492,-58
37,161,37,71,113,63,50
37,161,37,89,177,93,84
37,161,37,111,124,91,33
37,161,37,119,150,130,20
37,161,37,149,172,124,48
37,161,45,21,58,87,-29
37,161,45,83,168,185,-17
37,163,37,17,79,101,-22
37,163,37,51,464,578,-114
37,163,37,61,418,346,72
37,163,37,85,455,374,81
37,163,37,101,209,269,-60
37,163,37,107,180,0,180
37,163,37,129,84,134,-50
37,163,37,133,0,65,-65
37,163,37,183,170,149,21
37,163,37,191,185,176,9
37,165,37,51,135,182,-47
37,165,37,93,101,138,-37
37,165,37,125,71,140,-69
37,165,37,153,189,217,-28
37,165,37,155,405,311,94
37,165,37,183,0,53,-53
37,165,45,69,166,131,35
37,167,37,7,118,113,5
37,167,37,19,0,63,-63
37,167,37,25,841,529,312
37,167,37,57,0,92,-92
37,167,37,81,0,53,-53
37,167,37,119,643,380,263
37,167,37,123,182,267,-85
37,167,37,159,215,187,28
37,167,37,179,410,194,216
37,169,37,57,95,107,-12
37,169,37,67,1219,1228,-9
37,169,37,81,143,177,-34
37,169,37,157,180,256,-76
37,169,37,171,457,351,106
37,169,37,197,86,64,22
37,171,37,67,401,528,-127
37,171,37,81,76,67,9
37,171,37,97,80,0,80
37,171,37,119,109,63,46
37,171,37,169,351,457,-106
37,171,37,183,61,0,61
37,171,37,193,327,305,22
37,171,37,197,342,305,37
37,171,51,35,158,127,31
37,171,51,141,80,123,-43
37,173,37,75,0,49,-49
37,173,37,87,0,69,-69
37,173,37,99,427,385,42
37,173,37,113,0,57,-57
37,175,37,21,308,265,43
37,175,37,89,405,420,-15
37,175,37,99,62,0,62
37,175,37,119,56,0,56
37,179,4,13,60,0,60
37,179,6,37,92,53,39
37,179,9,1,103,0,103
37,179,9,3,77,0,77
37,179,12,11,173,0,173
37,179,12,86,114,0,114
37,179,12,99,91,0,91
37,179,34,3,83,0,83
37,179,34,23,83,0,83
37,179,34,27,66,0,66
37,179,36,29,74,0,74
37,179,36,59,125,0,125
37,179,36,81,102,0,102
37,179,36,103,225,0,225
37,179,37,7,457,429,28
37,179,37,19,0,139,-139
37,179,37,21,0,60,-60
37,179,37,25,564,583,-19
37,179,37,35,0,66,-66
37,179,37,45,0,60,-60
37,179,37,51,84,0,84
37,179,37,67,0,103,-103
37,179,37,71,255,234,21
37,179,37,81,110,113,-3
37,179,37,97,135,135,0
37,179,37,109,74,87,-13
37,179,37,119,8767,5414,3353
37,179,37,129,83,94,-11
37,179,37,159,85,121,-36
37,179,37,167,194,410,-216
37,179,37,183,178,278,-100
37,179,45,19,69,88,-19
37,179,45,25,204,236,-32
37,179,45,45,0,107,-107
37,179,45,51,86,123,-37
37,179,45,57,548,953,-405
37,179,45,79,69,0,69
37,179,45,91,366,518,-152
37,179,48,439,0,62,-62
37,181,37,63,203,140,63
37,181,37,69,252,333,-81
37,181,37,77,510,523,-13
37,181,37,183,376,353,23
37,181,37,185,381,304,77
37,183,1,89,79,0,79
37,183,4,13,536,395,141
37,183,4,19,71,86,-15
37,183,5,119,68,0,68
37,183,6,1,308,210,98
37,183,6,13,189,88,101
37,183,6,37,666,470,196
37,183,6,59,338,199,139
37,183,6,65,134,72,62
37,183,6,67,116,115,1
37,183,6,71,122,75,47
37,183,6,73,473,317,156
37,183,6,75,111,197,-86
37,183,6,81,148,113,35
37,183,6,85,546,564,-18
37,183,6,111,72,0,72
37,183,8,1,0,55,-55
37,183,8,5,172,73,99
37,183,8,13,86,89,-3
37,183,8,31,155,227,-72
37,183,8,35,89,90,-1
37,183,8,41,99,161,-62
37,183,8,59,87,103,-16
37,183,8,69,83,58,25
37,183,9,1,400,125,275
37,183,9,3,209,115,94
37,183,9,9,203,105,98
37,183,10,3,141,134,7
37,183,11,1,337,308,29
37,183,12,1,110,0,110
37,183,12,9,184,114,70
37,183,12,11,665,266,399
37,183,12,19,0,75,-75
37,183,12,21,61,90,-29
37,183,12,31,252,282,-30
37,183,12,33,0,51,-51
37,183,12,57,365,364,1
37,183,12,69,51,84,-33
37,183,12,71,198,104,94
37,183,12,73,103,0,103
37,183,12,81,88,76,12
37,183,12,83,92,84,8
37,183,12,85,51,0,51
37,183,12,86,690,261,429
37,183,12,95,425,339,86
37,183,12,97,81,86,-5
37,183,12,99,505,299,206
37,183,12,101,96,122,-26
37,183,12,103,212,202,10
37,183,12,105,99,122,-23
37,183,12,109,85,141,-56
37,183,12,111,63,70,-7
37,183,12,115,120,93,27
37,183,12,117,186,141,45
37,183,12,127,99,66,33
37,183,13,51,128,92,36
37,183,13,59,54,0,54
37,183,13,63,0,71,-71
37,183,13,67,273,298,-25
37,183,13,89,246,221,25
37,183,13,117,79,80,-1
37,183,13,121,412,584,-172
37,183,13,135,248,229,19
37,183,13,215,68,0,68
37,183,15,3,132,75,57
37,183,17,31,649,374,275
37,183,17,43,235,68,167
37,183,17,89,58,0,58
37,183,17,97,104,0,104
37,183,17,143,74,0,74
37,183,17,197,83,0,83
37,183,18,57,109,0,109
37,183,18,97,114,76,38
37,183,20,91,156,102,54
37,183,21,67,90,59,31
37,183,21,111,105,74,31
37,183,22,33,69,0,69
37,183,23,5,59,0,59
37,183,24,3,263,121,142
37,183,24,5,222,150,72
37,183,24,17,83,0,83
37,183,24,21,101,0,101
37,183,24,27,148,105,43
37,183,24,31,495,287,208
37,183,24,33,312,225,87
37,183,24,510,186,138,48
37,183,25,5,60,0,60
37,183,25,9,147,65,82
37,183,25,17,558,328,230
37,183,25,21,188,108,80
37,183,25,23,84,0,84
37,183,25,25,195,149,46
37,183,25,27,168,74,94
37,183,26,81,85,0,85
37,183,26,125,193,128,65
37,183,26,161,105,72,33
37,183,26,163,135,83,52
37,183,27,53,172,107,65
37,183,27,123,65,0,65
37,183,29,189,152,80,72
37,183,31,55,54,0,54
37,183,32,3,195,232,-37
37,183,32,31,0,64,-64
37,183,33,11,147,50,97
37,183,33,15,98,0,98
37,183,34,3,364,67,297
37,183,34,5,110,0,110
37,183,34,7,70,0,70
37,183,34,13,329,120,209
37,183,34,17,374,161,213
37,183,34,19,80,0,80
37,183,34,21,156,0,156
37,183,34,23,449,193,256
37,183,34,25,115,0,115
37,183,34,27,256,65,191
37,183,34,29,91,0,91
37,183,34,31,138,0,138
37,183,34,35,173,0,173
37,183,34,39,200,0,200
37,183,36,1,94,0,94
37,183,36,5,344,75,269
37,183,36,7,79,0,79
37,183,36,27,145,0,145
37,183,36,29,205,124,81
37,183,36,47,523,284,239
37,183,36,55,298,71,227
37,183,36,59,583,73,510
37,183,36,61,424,331,93
37,183,36,65,73,0,73
37,183,36,67,204,0,204
37,183,36,71,166,0,166
37,183,36,81,521,186,335
37,183,36,85,105,0,105
37,183,36,87,64,0,64
37,183,36,91,90,0,90
37,183,36,103,674,162,512
37,183,36,109,60,0,60
37,183,36,111,51,0,51
37,183,36,119,372,75,297
37,183,37,1,599,859,-260
37,183,37,13,142,158,-16
37,183,37,15,72,0,72
37,183,37,17,61,0,61
37,183,37,19,341,587,-246
37,183,37,21,408,462,-54
37,183,37,23,66,55,11
37,183,37,25,249,274,-25
37,183,37,27,66,0,66
37,183,37,31,249,404,-155
37,183,37,35,165,129,36
37,183,37,37,929,1850,-921
37,183,37,41,61,0,61
37,183,37,47,83,0,83
37,183,37,49,315,327,-12
37,183,37,51,1489,917,572
37,183,37,55,138,93,45
37,183,37,57,131,108,23
37,183,37,61,117,70,47
37,183,37,63,8167,8486,-319
37,183,37,65,229,141,88
37,183,37,67,770,692,78
37,183,37,69,1968,3661,-1693
37,183,37,71,177,172,5
37,183,37,77,858,1094,-236
37,183,37,81,1837,1766,71
37,183,37,83,239,146,93
37,183,37,85,1720,2951,-1231
37,183,37,87,59,66,-7
37,183,37,89,104,118,-14
37,183,37,93,96,78,18
37,183,37,97,179,172,7
37,183,37,101,4851,9068,-4217
37,183,37,105,541,974,-433
37,183,37,107,135,58,77
37,183,37,117,77,0,77
37,183,37,119,2300,2382,-82
37,183,37,125,391,351,40
37,183,37,127,1045,901,144
37,183,37,129,1277,1212,65
37,183,37,131,55,0,55
37,183,37,133,568,448,120
37,183,37,135,1646,1517,129
37,183,37,137,0,56,-56
37,183,37,139,107,61,46
37,183,37,141,187,211,-24
37,183,37,145,126,148,-22
37,183,37,147,1367,682,685
37,183,37,151,171,186,-15
37,183,37,153,54,0,54
37,183,37,155,172,119,53
37,183,37,157,82,54,28
37,183,37,159,84,90,-6
37,183,37,163,149,170,-21
37,183,37,165,53,0,53
37,183,37,171,0,61,-61
37,183,37,179,278,178,100
37,183,37,181,353,376,-23
37,183,37,185,152,133,19
37,183,37,189,226,154,72
37,183,37,191,594,394,200
37,183,37,195,566,538,28
37,183,39,17,88,0,88
37,183,39,35,178,152,26
37,183,39,49,324,246,78
37,183,39,61,113,114,-1
37,183,39,95,55,0,55
37,183,39,113,187,0,187
37,183,39,153,123,91,32
37,183,40,109,86,0,86
37,183,41,51,54,88,-34
37,183,41,67,65,107,-42
37,183,42,3,291,228,63
37,183,42,11,77,0,77
37,183,42,17,87,80,7
37,183,42,29,116,0,116
37,183,42,41,70,0,70
37,183,42,43,58,0,58
37,183,42,45,70,84,-14
37,183,42,49,60,0,60
37,183,42,69,80,0,80
37,183,42,71,74,0,74
37,183,42,77,108,0,108
37,183,42,89,63,0,63
37,183,42,91,235,127,108
37,183,42,95,59,0,59
37,183,42,101,269,205,64
37,183,42,133,92,0,92
37,183,44,7,143,54,89
37,183,45,13,97,111,-14
37,183,45,15,68,115,-47
37,183,45,19,244,311,-67
37,183,45,35,78,53,25
37,183,45,41,80,0,80
37,183,45,45,260,246,14
37,183,45,51,234,290,-56
37,183,45,63,89,132,-43
37,183,45,77,51,0,51
37,183,45,79,296,162,134
37,183,45,83,0,101,-101
37,183,45,91,154,159,-5
37,183,47,37,209,276,-67
37,183,47,65,75,67,8
37,183,47,93,109,128,-19
37,183,47,125,70,0,70
37,183,47,157,159,108,51
37,183,47,187,95,87,8
37,183,48,27,82,63,19
37,183,48,29,140,199,-59
37,183,48,85,192,302,-110
37,183,48,113,279,292,-13
37,183,48,121,158,119,39
37,183,48,141,108,0,108
37,183,48,157,94,80,14
37,183,48,201,431,311,120
37,183,48,439,168,141,27
37,183,48,453,292,411,-119
37,183,48,491,127,100,27
37,183,49,35,103,130,-27
37,183,49,49,92,87,5
37,183,50,7,58,0,58
37,183,51,3,0,92,-92
37,183,51,13,302,156,146
37,183,51,41,219,205,14
37,183,51,59,804,426,378
37,183,51,87,261,231,30
37,183,51,107,265,157,108
37,183,51,117,61,72,-11
37,183,51,121,103,58,45
37,183,51,153,246,146,100
37,183,51,161,77,0,77
37,183,51,179,60,61,-1
37,183,51,510,103,94,9
37,183,51,550,190,98,92
37,183,51,590,68,0,68
37,183,51,650,65,89,-24
37,183,51,680,80,0,80
37,183,51,700,106,66,40
37,183,51,710,103,93,10
37,183,51,760,161,130,31
37,183,51,770,71,56,15
37,183,51,810,240,218,22
37,183,53,33,338,546,-208
37,183,53,53,100,75,25
37,183,53,61,89,0,89
37,183,54,39,58,0,58
37,183,55,25,142,89,53
37,183,55,79,113,62,51
37,183,55,133,65,0,65
37,185,37,63,73,0,73
37,185,37,69,0,85,-85
37,185,37,77,64,80,-16
37,185,37,83,152,91,61
37,185,37,181,304,381,-77
37,185,37,183,133,152,-19
37,187,37,13,0,99,-99
37,187,37,117,65,98,-33
37,187,37,147,0,112,-112
37,189,37,9,190,307,-117
37,189,37,11,269,226,43
37,189,37,21,111,159,-48
37,189,37,23,0,58,-58
37,189,37,27,80,151,-71
37,189,37,35,68,93,-25
37,189,37,63,0,75,-75
37,189,37,67,90,108,-18
37,189,37,81,100,99,1
37,189,37,119,177,183,-6
37,189,37,129,56,48,8
37,189,37,183,154,226,-72
37,189,37,193,80,70,10
37,189,47,91,0,85,-85
37,191,12,33,70,0,70
37,191,12,57,0,69,-69
37,191,12,91,0,89,-89
37,191,32,3,0,70,-70
37,191,37,31,0,107,-107
37,191,37,49,68,66,2
37,191,37,51,113,133,-20
37,191,37,61,527,411,116
37,191,37,63,0,81,-81
37,191,37,79,157,202,-45
37,191,37,81,70,109,-39
37,191,37,85,0,59,-59
37,191,37,101,727,701,26
37,191,37,107,528,456,72
37,191,37,119,76,94,-18
37,191,37,127,0,77,-77
37,191,37,129,75,90,-15
37,191,37,133,135,76,59
37,191,37,147,220,299,-79
37,191,37,163,176,185,-9
37,191,37,183,394,594,-200
37,191,37,195,320,210,110
37,191,48,29,0,84,-84
37,191,48,485,69,0,69
37,193,37,3,0,73,-73
37,193,37,9,138,85,53
37,193,37,27,77,100,-23
37,193,37,35,80,66,14
37,193,37,67,96,133,-37
37,193,37,81,58,73,-15
37,193,37,97,142,159,-17
37,193,37,119,64,76,-12
37,193,37,171,305,327,-22
37,193,37,189,70,80,-10
37,193,37,197,206,256,-50
37,195,37,51,83,59,24
37,195,37,63,55,56,-1
37,195,37,65,247,249,-2
37,195,37,69,60,0,60
37,195,37,79,118,91,27
37,195,37,81,0,62,-62
37,195,37,101,411,310,101
37,195,37,107,182,0,182
37,195,37,119,0,85,-85
37,195,37,127,889,843,46
37,195,37,147,273,276,-3
37,195,37,183,538,566,-28
37,195,37,191,210,320,-110
37,197,37,57,0,84,-84
37,197,37,59,161,135,26
37,197,37,67,585,529,56
37,197,37,97,104,91,13
37,197,37,169,64,86,-22
37,197,37,171,305,342,-37
37,197,37,193,256,206,50
37,199,37,21,228,164,64
37,199,37,111,93,0,93
37,199,37,115,85,0,85
37,199,37,121,138,175,-37
38,3,38,17,163,242,-79
38,3,38,93,50,77,-27
38,5,38,71,85,203,-118
38,9,38,101,80,82,-2
38,15,4,13,86,164,-78
38,15,27,3,0,61,-61
38,15,27,27,0,53,-53
38,15,27,53,78,144,-66
38,15,32,3,0,78,-78
38,15,38,17,352,432,-80
38,15,38,29,64,0,64
38,15,38,35,153,104,49
38,15,38,43,0,83,-83
38,15,38,53,0,55,-55
38,15,38,55,180,149,31
38,15,38,57,142,104,38
38,15,38,59,1829,1783,46
38,15,38,79,59,0,59
38,15,38,85,69,0,69
38,15,38,89,239,167,72
38,15,38,93,118,59,59
38,15,38,101,250,201,49
38,15,38,105,132,114,18
38,17,4,13,160,289,-129
38,17,4,21,0,63,-63
38,17,6,37,0,61,-61
38,17,6,73,0,65,-65
38,17,8,5,0,49,-49
38,17,8,31,0,55,-55
38,17,8,41,0,59,-59
38,17,17,31,73,117,-44
38,17,19,153,65,0,65
38,17,27,3,81,147,-66
38,17,27,5,287,372,-85
38,17,27,7,72,0,72
38,17,27,27,2326,2699,-373
38,17,27,35,0,69,-69
38,17,27,37,116,165,-49
38,17,27,41,75,85,-10
38,17,27,53,423,623,-200
38,17,27,57,50,0,50
38,17,27,107,123,73,50
38,17,27,109,0,125,-125
38,17,27,111,310,409,-99
38,17,27,113,57,0,57
38,17,27,119,106,98,8
38,17,27,123,106,244,-138
38,17,27,135,60,0,60
38,17,27,137,0,121,-121
38,17,27,139,0,91,-91
38,17,27,145,102,130,-28
38,17,27,163,0,74,-74
38,17,27,167,72,0,72
38,17,27,171,69,54,15
38,17,32,3,0,64,-64
38,17,38,3,242,163,79
38,17,38,15,432,352,80
38,17,38,35,707,376,331
38,17,38,59,137,118,19
38,17,38,67,57,0,57
38,17,38,71,74,0,74
38,17,38,73,95,83,12
38,17,38,77,290,373,-83
38,17,38,79,97,0,97
38,17,38,81,66,70,-4
38,17,38,89,124,68,56
38,17,38,93,238,169,69
38,17,38,97,144,78,66
38,17,38,99,88,0,88
38,17,38,101,218,121,97
38,17,38,105,103,127,-24
38,17,39,49,0,89,-89
38,17,42,45,72,0,72
38,17,46,13,68,0,68
38,17,46,99,135,125,10
38,17,48,113,0,65,-65
38,17,53,33,63,100,-37
38,25,38,89,149,188,-39
38,29,38,15,0,64,-64
38,35,4,13,72,144,-72
38,35,27,3,0,51,-51
38,35,27,7,50,66,-16
38,35,27,27,0,61,-61
38,35,27,37,0,100,-100
38,35,27,53,121,333,-212
38,35,27,89,74,64,10
38,35,27,113,46,74,-28
38,35,27,119,577,659,-82
38,35,27,123,70,89,-19
38,35,27,135,69,0,69
38,35,27,137,0,55,-55
38,35,27,145,0,53,-53
38,35,32,3,80,0,80
38,35,38,15,104,153,-49
38,35,38,17,376,707,-331
38,35,38,67,73,75,-2
38,35,38,71,80,72,8
38,35,38,79,77,0,77
38,35,38,97,100,163,-63
38,35,38,99,170,134,36
38,35,38,101,86,72,14
38,35,38,105,63,52,11
38,35,46,99,0,60,-60
38,35,48,29,50,68,-18
38,43,38,15,83,0,83
38,49,38,101,107,144,-37
38,53,30,83,76,0,76
38,53,38,15,55,0,55
38,53,38,89,87,99,-12
38,53,38,101,64,0,64
38,53,38,105,183,209,-26
38,55,38,15,149,180,-31
38,55,38,101,63,81,-18
38,57,38,15,104,142,-38
38,57,38,59,56,0,56
38,59,38,15,1783,1829,-46
38,59,38,17,118,137,-19
38,59,38,57,0,56,-56
38,59,38,89,101,110,-9
38,59,38,101,75,61,14
38,61,38,101,100,178,-78
38,61,38,105,68,87,-19
38,67,38,17,0,57,-57
38,67,38,35,75,73,2
38,71,38,5,203,85,118
38,71,38,17,0,74,-74
38,71,38,35,72,80,-8
38,73,38,17,83,95,-12
38,75,38,101,94,93,1
38,77,27,167,139,174,-35
38,77,38,17,373,290,83
38,79,38,15,0,59,-59
38,79,38,17,0,97,-97
38,79,38,35,0,77,-77
38,79,38,101,0,75,-75
38,81,38,17,70,66,4
38,85,38,15,0,69,-69
38,89,38,15,167,239,-72
38,89,38,17,68,124,-56
38,89,38,25,188,149,39
38,89,38,53,99,87,12
38,89,38,59,110,101,9
38,89,38,105,117,122,-5
38,93,38,3,77,50,27
38,93,38,15,59,118,-59
38,93,38,17,169,238,-69
38,97,38,17,78,144,-66
38,97,38,35,163,100,63
38,99,38,17,0,88,-88
38,99,38,35,134,170,-36
38,101,2,20,75,0,75
38,101,4,13,79,175,-96
38,101,6,37,57,80,-23
38,101,6,83,60,0,60
38,101,8,41,68,99,-31
38,101,22,15,170,92,78
38,101,27,53,0,73,-73
38,101,30,13,70,0,70
38,101,32,3,111,152,-41
38,101,38,9,82,80,2
38,101,38,15,201,250,-49
38,101,38,17,121,218,-97
38,101,38,35,72,86,-14
38,101,38,49,144,107,37
38,101,38,53,0,64,-64
38,101,38,55,81,63,18
38,101,38,59,61,75,-14
38,101,38,61,178,100,78
38,101,38,75,93,94,-1
38,101,38,79,75,0,75
38,101,38,105,172,241,-69
38,101,48,29,0,112,-112
38,101,48,201,0,83,-83
38,101,56,21,0,103,-103
38,105,4,13,142,85,57
38,105,6,29,94,0,94
38,105,16,55,58,0,58
38,105,30,29,61,0,61
38,105,30,83,98,0,98
38,105,30,111,76,0,76
38,105,32,3,95,74,21
38,105,38,15,114,132,-18
38,105,38,17,127,103,24
38,105,38,35,52,63,-11
38,105,38,53,209,183,26
38,105,38,61,87,68,19
38,105,38,89,122,117,5
38,105,38,101,241,172,69
38,105,48,201,81,0,81
38,105,48,329,0,81,-81
38,105,53,63,81,0,81
39,1,39,15,291,297,-6
39,1,39,25,122,158,-36
39,1,39,61,66,50,16
39,1,39,71,161,202,-41
39,1,39,145,96,123,-27
39,3,18,3,97,76,21
39,3,39,11,694,711,-17
39,3,39,17,0,60,-60
39,3,39,41,0,79,-79
39,3,39,49,265,440,-175
39,3,39,61,63,69,-6
39,3,39,63,267,373,-106
39,3,39,65,270,271,-1
39,3,39,91,119,136,-17
39,3,39,95,94,97,-3
39,3,39,107,86,67,19
39,3,39,109,0,69,-69
39,3,39,113,74,81,-7
39,3,39,137,310,279,31
39,3,39,149,116,68,48
39,3,39,161,398,507,-109
39,3,39,173,63,53,10
39,5,39,33,0,58,-58
39,5,39,35,132,124,8
39,5,39,49,86,116,-30
39,5,39,75,166,68,98
39,5,39,77,142,125,17
39,5,39,83,80,93,-13
39,5,39,93,166,136,30
39,5,39,103,212,147,65
39,5,39,139,601,820,-219
39,5,39,151,71,0,71
39,5,39,153,0,56,-56
39,5,39,169,456,369,87
39,7,39,35,305,350,-45
39,7,39,49,57,77,-20
39,7,39,55,377,379,-2
39,7,39,85,1003,1192,-189
39,7,39,93,0,62,-62
39,7,39,99,106,0,106
39,7,39,133,67,66,1
39,7,39,151,0,67,-67
39,7,39,153,89,71,18
39,7,39,155,351,385,-34
39,7,42,39,77,60,17
39,7,42,49,210,112,98
39,9,39,35,0,75,-75
39,9,39,45,84,170,-86
39,9,39,49,271,463,-192
39,9,39,61,0,60,-60
39,9,39,73,222,215,7
39,9,39,105,243,265,-22
39,9,39,113,0,55,-55
39,9,39,115,87,58,29
39,9,39,127,66,77,-11
39,9,39,163,0,55,-55
39,9,39,167,173,177,-4
39,9,54,107,55,67,-12
39,11,39,3,711,694,17
39,11,39,37,46,0,46
39,11,39,49,80,126,-46
39,11,39,65,82,0,82
39,11,39,91,117,94,23
39,11,39,107,435,405,30
39,11,39,109,66,77,-11
39,11,39,113,69,52,17
39,11,39,149,302,392,-90
39,13,39,49,81,174,-93
39,13,39,59,111,91,20
39,13,39,67,139,95,44
39,13,39,81,311,362,-51
39,13,39,111,152,124,28
39,13,42,125,0,65,-65
39,13,54,51,241,228,13
39,13,54,69,496,445,51
39,15,21,161,107,110,-3
39,15,39,1,297,291,6
39,15,39,17,69,70,-1
39,15,39,25,1418,1324,94
39,15,39,27,102,96,6
39,15,39,61,264,226,38
39,15,39,71,229,256,-27
39,15,39,165,75,94,-19
39,17,4,13,93,112,-19
39,17,6,37,74,69,5
39,17,6,73,70,64,6
39,17,12,9,0,68,-68
39,17,12,11,47,0,47
39,17,12,57,0,119,-119
39,17,12,71,63,112,-49
39,17,12,81,0,71,-71
39,17,12,95,0,74,-74
39,17,12,101,0,66,-66
39,17,12,103,66,87,-21
39,17,13,89,66,0,66
39,17,17,31,132,143,-11
39,17,18,29,89,131,-42
39,17,18,47,90,104,-14
39,17,18,57,0,71,-71
39,17,18,97,101,140,-39
39,17,18,161,78,130,-52
39,17,18,177,67,52,15
39,17,21,15,218,225,-7
39,17,21,37,150,152,-2
39,17,21,67,71,64,7
39,17,21,111,114,80,34
39,17,21,117,236,217,19
39,17,26,125,62,66,-4
39,17,36,5,66,0,66
39,17,37,183,0,88,-88
39,17,39,3,60,0,60
39,17,39,15,70,69,1
39,17,39,23,79,68,11
39,17,39,25,802,915,-113
39,17,39,27,69,122,-53
39,17,39,35,134,88,46
39,17,39,41,61,73,-12
39,17,39,49,450,489,-39
39,17,39,57,284,227,57
39,17,39,61,9836,8461,1375
39,17,39,95,61,0,61
39,17,39,109,58,80,-22
39,17,39,113,1559,1519,40
39,17,39,135,410,460,-50
39,17,39,153,64,54,10
39,17,39,165,3739,4503,-764
39,17,42,3,58,0,58
39,17,45,51,0,55,-55
39,17,47,37,0,55,-55
39,17,48,113,0,58,-58
39,17,48,201,63,72,-9
39,17,48,439,73,0,73
39,19,39,29,174,128,46
39,19,39,67,61,0,61
39,19,39,81,119,0,119
39,19,39,151,736,817,-81
39,19,39,153,68,72,-4
39,19,39,157,247,175,72
39,21,39,23,675,888,-213
39,21,39,49,314,220,94
39,21,39,57,0,65,-65
39,21,39,91,359,388,-29
39,21,39,97,97,90,7
39,21,39,109,166,160,6
39,21,39,113,91,148,-57
39,21,39,149,0,71,-71
39,21,39,159,257,195,62
39,23,39,17,68,79,-11
39,23,39,21,888,675,213
39,23,39,49,742,627,115
39,23,39,57,989,965,24
39,23,39,61,72,96,-24
39,23,39,91,107,94,13
39,23,39,97,331,269,62
39,23,39,109,291,367,-76
39,23,39,113,1224,1332,-108
39,23,39,159,70,0,70
39,23,39,165,66,108,-42
39,25,4,13,72,74,-2
39,25,12,57,0,52,-52
39,25,12,71,0,74,-74
39,25,12,103,0,63,-63
39,25,17,31,82,49,33
39,25,21,15,202,233,-31
39,25,21,37,352,327,25
39,25,21,67,72,0,72
39,25,21,111,54,62,-8
39,25,21,117,446,458,-12
39,25,39,1,158,122,36
39,25,39,15,1324,1418,-94
39,25,39,17,915,802,113
39,25,39,27,251,320,-69
39,25,39,49,186,244,-58
39,25,39,57,71,0,71
39,25,39,61,6158,4638,1520
39,25,39,71,241,220,21
39,25,39,113,209,199,10
39,25,39,165,1103,1278,-175
39,27,39,15,96,102,-6
39,27,39,17,122,69,53
39,27,39,25,320,251,69
39,27,39,47,189,160,29
39,27,39,49,59,92,-33
39,27,39,57,160,247,-87
39,27,39,61,150,124,26
39,27,39,71,473,486,-13
39,27,39,113,142,199,-57
39,27,39,165,539,537,2
39,29,39,19,128,174,-46
39,29,39,35,0,53,-53
39,29,39,49,0,91,-91
39,29,39,81,200,140,60
39,29,39,99,1179,1353,-174
39,29,39,133,94,95,-1
39,29,39,151,549,625,-76
39,29,39,153,112,95,17
39,29,39,155,92,180,-88
39,29,42,3,112,89,23
39,29,42,7,340,172,168
39,29,54,29,202,149,53
39,31,39,49,138,131,7
39,31,39,59,0,54,-54
39,31,39,75,200,140,60
39,31,39,83,0,111,-111
39,31,39,89,139,151,-12
39,31,39,119,235,176,59
39,31,39,157,337,296,41
39,33,39,5,58,0,58
39,33,39,41,0,50,-50
39,33,39,49,152,170,-18
39,33,39,77,57,75,-18
39,33,39,101,243,229,14
39,33,39,117,259,260,-1
39,33,39,139,703,857,-154
39,33,39,147,53,102,-49
39,33,39,175,175,167,8
39,35,1,73,0,55,-55
39,35,4,13,404,740,-336
39,35,4,19,72,95,-23
39,35,6,1,103,126,-23
39,35,6,13,0,70,-70
39,35,6,37,596,625,-29
39,35,6,59,127,212,-85
39,35,6,65,77,80,-3
39,35,6,67,74,75,-1
39,35,6,71,88,79,9
39,35,6,73,293,368,-75
39,35,6,75,95,94,1
39,35,6,81,0,44,-44
39,35,6,85,99,189,-90
39,35,8,1,0,71,-71
39,35,8,5,61,83,-22
39,35,8,31,127,198,-71
39,35,8,41,109,111,-2
39,35,8,59,0,75,-75
39,35,9,1,67,59,8
39,35,9,3,71,83,-12
39,35,9,9,72,66,6
39,35,11,1,163,231,-68
39,35,12,9,81,100,-19
39,35,12,11,222,285,-63
39,35,12,21,74,166,-92
39,35,12,31,137,176,-39
39,35,12,57,206,359,-153
39,35,12,71,214,299,-85
39,35,12,81,79,79,0
39,35,12,86,173,189,-16
39,35,12,95,220,233,-13
39,35,12,97,84,64,20
39,35,12,99,203,250,-47
39,35,12,101,62,108,-46
39,35,12,103,162,227,-65
39,35,12,105,68,137,-69
39,35,12,111,0,68,-68
39,35,12,115,87,159,-72
39,35,12,117,65,92,-27
39,35,12,119,0,51,-51
39,35,12,127,67,79,-12
39,35,13,63,0,76,-76
39,35,13,67,131,174,-43
39,35,13,89,171,129,42
39,35,13,121,189,284,-95
39,35,13,135,125,165,-40
39,35,15,3,81,82,-1
39,35,17,31,947,814,133
39,35,17,43,134,100,34
39,35,17,97,0,107,-107
39,35,18,3,0,63,-63
39,35,18,57,72,74,-2
39,35,18,97,179,142,37
39,35,18,157,47,0,47
39,35,20,91,70,0,70
39,35,21,67,81,54,27
39,35,21,111,153,83,70
39,35,24,3,0,61,-61
39,35,24,5,88,52,36
39,35,24,31,145,103,42
39,35,24,33,84,80,4
39,35,24,510,102,77,25
39,35,25,9,54,0,54
39,35,25,17,135,130,5
39,35,25,21,57,95,-38
39,35,25,25,115,138,-23
39,35,26,65,51,0,51
39,35,26,81,94,75,19
39,35,26,99,83,93,-10
39,35,26,125,213,266,-53
39,35,26,161,158,150,8
39,35,26,163,284,276,8
39,35,27,53,115,129,-14
39,35,29,189,94,105,-11
39,35,29,510,54,58,-4
39,35,32,3,245,419,-174
39,35,34,3,71,0,71
39,35,34,5,60,0,60
39,35,34,13,54,0,54
39,35,34,17,66,78,-12
39,35,34,23,103,79,24
39,35,34,29,85,0,85
39,35,36,5,155,96,59
39,35,36,29,167,168,-1
39,35,36,47,258,226,32
39,35,36,55,100,88,12
39,35,36,59,61,0,61
39,35,36,61,360,395,-35
39,35,36,67,73,0,73
39,35,36,81,226,87,139
39,35,36,103,84,61,23
39,35,36,119,83,0,83
39,35,37,51,0,81,-81
39,35,37,63,61,76,-15
39,35,37,67,0,62,-62
39,35,37,81,0,67,-67
39,35,37,119,222,398,-176
39,35,37,133,74,66,8
39,35,37,183,152,178,-26
39,35,39,5,124,132,-8
39,35,39,7,350,305,45
39,35,39,9,75,0,75
39,35,39,17,88,134,-46
39,35,39,29,53,0,53
39,35,39,41,143,288,-145
39,35,39,43,351,295,56
39,35,39,45,81,55,26
39,35,39,49,1780,2123,-343
39,35,39,55,1277,1895,-618
39,35,39,57,84,85,-1
39,35,39,61,338,446,-108
39,35,39,63,49,0,49
39,35,39,77,99,113,-14
39,35,39,85,4081,5587,-1506
39,35,39,89,55,86,-31
39,35,39,93,5402,7749,-2347
39,35,39,95,496,276,220
39,35,39,99,504,374,130
39,35,39,103,3004,4799,-1795
39,35,39,113,294,162,132
39,35,39,123,100,224,-124
39,35,39,133,1407,2036,-629
39,35,39,139,113,161,-48
39,35,39,143,56,0,56
39,35,39,147,44,0,44
39,35,39,151,759,634,125
39,35,39,153,4891,6066,-1175
39,35,39,155,456,417,39
39,35,39,157,75,74,1
39,35,39,165,77,81,-4
39,35,39,169,228,205,23
39,35,39,173,212,134,78
39,35,41,51,90,76,14
39,35,42,3,483,506,-23
39,35,42,19,60,0,60
39,35,42,45,0,57,-57
39,35,42,49,190,111,79
39,35,42,85,55,0,55
39,35,42,91,82,81,1
39,35,42,101,178,188,-10
39,35,42,129,56,0,56
39,35,45,13,0,56,-56
39,35,45,19,69,78,-9
39,35,45,45,0,97,-97
39,35,45,51,56,67,-11
39,35,45,79,0,55,-55
39,35,47,37,121,211,-90
39,35,47,157,62,83,-21
39,35,48,27,0,77,-77
39,35,48,29,94,124,-30
39,35,48,85,70,128,-58
39,35,48,113,185,245,-60
39,35,48,121,58,0,58
39,35,48,201,288,327,-39
39,35,48,439,112,131,-19
39,35,48,453,197,180,17
39,35,49,35,83,86,-3
39,35,51,13,79,93,-14
39,35,51,59,167,139,28
39,35,51,810,0,92,-92
39,35,53,33,193,325,-132
39,35,53,53,0,59,-59
39,35,55,25,60,65,-5
39,35,55,79,87,91,-4
39,37,18,135,262,208,54
39,37,18,177,76,63,13
39,37,39,11,0,46,-46
39,37,39,57,0,56,-56
39,37,39,107,151,152,-1
39,37,39,109,451,557,-106
39,37,39,113,381,333,48
39,37,39,135,175,150,25
39,37,39,149,119,107,12
39,39,18,3,116,167,-51
39,39,18,33,61,0,61
39,39,39,51,116,121,-5
39,39,39,69,304,247,57
39,39,39,95,83,116,-33
39,39,39,125,325,347,-22
39,39,39,137,88,95,-7
39,39,39,171,394,371,23
39,39,39,173,51,76,-25
39,41,4,13,108,128,-20
39,41,6,37,74,70,4
39,41,12,57,0,92,-92
39,41,12,71,0,96,-96
39,41,12,95,57,0,57
39,41,12,99,0,69,-69
39,41,12,103,0,58,-58
39,41,12,115,0,68,-68
39,41,17,31,154,102,52
39,41,37,119,0,87,-87
39,41,39,3,79,0,79
39,41,39,17,73,61,12
39,41,39,33,50,0,50
39,41,39,35,288,143,145
39,41,39,45,239,214,25
39,41,39,49,11327,6906,4421
39,41,39,57,81,0,81
39,41,39,61,115,116,-1
39,41,39,63,57,0,57
39,41,39,83,272,321,-49
39,41,39,89,440,466,-26
39,41,39,91,0,90,-90
39,41,39,93,73,72,1
39,41,39,95,122,0,122
39,41,39,97,101,92,9
39,41,39,101,372,532,-160
39,41,39,103,123,0,123
39,41,39,113,150,59,91
39,41,39,117,323,584,-261
39,41,39,139,150,140,10
39,41,39,151,105,0,105
39,41,39,153,107,68,39
39,41,39,159,515,562,-47
39,41,39,165,107,0,107
39,41,39,173,0,58,-58
39,41,42,3,70,0,70
39,41,48,113,49,0,49
39,43,26,163,61,0,61
39,43,39,35,295,351,-56
39,43,39,49,157,192,-35
39,43,39,77,873,895,-22
39,43,39,93,1020,1062,-42
39,43,39,95,136,164,-28
39,43,39,123,192,203,-11
39,43,39,139,58,0,58
39,43,39,143,387,337,50
39,43,39,147,93,0,93
39,43,39,153,64,52,12
39,43,39,173,55,63,-8
39,45,4,13,0,77,-77
39,45,39,9,170,84,86
39,45,39,35,55,81,-26
39,45,39,41,214,239,-25
39,45,39,49,7219,4911,2308
39,45,39,61,76,55,21
39,45,39,73,461,436,25
39,45,39,89,1042,1131,-89
39,45,39,113,87,70,17
39,45,39,119,144,193,-49
39,45,39,127,554,583,-29
39,45,39,129,502,447,55
39,45,39,141,94,127,-33
39,45,39,153,67,0,67
39,47,39,27,160,189,-29
39,47,39,49,319,317,2
39,47,39,57,99,96,3
39,47,39,71,287,229,58
39,47,39,97,165,97,68
39,47,39,129,161,97,64
39,47,39,141,162,146,16
39,49,1,73,92,57,35
39,49,4,13,547,900,-353
39,49,4,19,133,138,-5
39,49,6,1,174,216,-42
39,49,6,13,87,85,2
39,49,6,37,628,664,-36
39,49,6,59,201,217,-16
39,49,6,65,85,157,-72
39,49,6,67,109,102,7
39,49,6,71,124,88,36
39,49,6,73,422,374,48
39,49,6,75,86,186,-100
39,49,6,81,55,73,-18
39,49,6,85,123,281,-158
39,49,6,111,0,54,-54
39,49,8,1,55,53,2
39,49,8,5,193,111,82
39,49,8,13,0,72,-72
39,49,8,31,188,328,-140
39,49,8,35,0,75,-75
39,49,8,41,90,104,-14
39,49,8,59,0,64,-64
39,49,9,1,83,0,83
39,49,9,3,123,83,40
39,49,9,9,111,60,51
39,49,10,3,70,89,-19
39,49,11,1,165,200,-35
39,49,12,1,69,66,3
39,49,12,9,92,92,0
39,49,12,11,238,252,-14
39,49,12,15,0,71,-71
39,49,12,21,95,176,-81
39,49,12,31,200,223,-23
39,49,12,33,57,60,-3
39,49,12,57,211,407,-196
39,49,12,69,0,74,-74
39,49,12,71,240,337,-97
39,49,12,81,86,168,-82
39,49,12,83,0,68,-68
39,49,12,86,232,111,121
39,49,12,95,236,325,-89
39,49,12,99,203,213,-10
39,49,12,101,117,184,-67
39,49,12,103,160,419,-259
39,49,12,105,79,138,-59
39,49,12,109,0,58,-58
39,49,12,115,101,238,-137
39,49,12,117,0,154,-154
39,49,12,119,0,65,-65
39,49,12,127,84,111,-27
39,49,13,51,65,55,10
39,49,13,63,67,94,-27
39,49,13,67,156,136,20
39,49,13,89,298,276,22
39,49,13,121,193,253,-60
39,49,13,135,125,203,-78
39,49,15,3,100,86,14
39,49,17,19,87,0,87
39,49,17,31,1179,1074,105
39,49,17,43,141,111,30
39,49,17,89,78,0,78
39,49,17,97,115,116,-1
39,49,17,197,0,57,-57
39,49,18,3,95,110,-15
39,49,18,57,135,174,-39
39,49,18,97,381,330,51
39,49,18,105,85,55,30
39,49,18,141,78,69,9
39,49,18,157,51,0,51
39,49,19,153,86,85,1
39,49,20,91,65,66,-1
39,49,21,15,100,147,-47
39,49,21,37,48,0,48
39,49,21,67,184,134,50
39,49,21,111,316,217,99
39,49,21,117,75,109,-34
39,49,21,227,61,0,61
39,49,24,3,46,84,-38
39,49,24,5,152,74,78
39,49,24,27,62,69,-7
39,49,24,31,235,181,54
39,49,24,33,150,105,45
39,49,24,510,100,85,15
39,49,25,9,60,0,60
39,49,25,13,51,0,51
39,49,25,17,192,215,-23
39,49,25,21,50,51,-1
39,49,25,25,168,113,55
39,49,25,27,134,0,134
39,49,26,49,63,59,4
39,49,26,65,154,116,38
39,49,26,77,73,0,73
39,49,26,81,153,146,7
39,49,26,99,103,90,13
39,49,26,125,368,360,8
39,49,26,145,66,0,66
39,49,26,161,218,194,24
39,49,26,163,328,323,5
39,49,27,37,0,94,-94
39,49,27,53,218,321,-103
39,49,27,123,71,129,-58
39,49,29,95,70,0,70
39,49,29,189,190,122,68
39,49,29,510,104,69,35
39,49,31,55,84,89,-5
39,49,32,3,271,338,-67
39,49,32,31,0,52,-52
39,49,34,3,75,56,19
39,49,34,13,118,66,52
39,49,34,17,217,107,110
39,49,34,23,178,133,45
39,49,34,27,65,0,65
39,49,34,35,60,0,60
39,49,35,1,60,78,-18
39,49,36,1,69,0,69
39,49,36,5,436,136,300
39,49,36,29,169,102,67
39,49,36,47,434,275,159
39,49,36,55,165,105,60
39,49,36,59,158,0,158
39,49,36,61,310,352,-42
39,49,36,67,115,63,52
39,49,36,81,225,155,70
39,49,36,103,63,55,8
39,49,36,119,129,0,129
39,49,37,51,95,64,31
39,49,37,63,74,99,-25
39,49,37,67,56,86,-30
39,49,37,81,76,70,6
39,49,37,119,380,491,-111
39,49,37,129,0,95,-95
39,49,37,133,91,75,16
39,49,37,135,0,84,-84
39,49,37,183,246,324,-78
39,49,38,17,89,0,89
39,49,39,3,440,265,175
39,49,39,5,116,86,30
39,49,39,7,77,57,20
39,49,39,9,463,271,192
39,49,39,11,126,80,46
39,49,39,13,174,81,93
39,49,39,17,489,450,39
39,49,39,21,220,314,-94
39,49,39,23,627,742,-115
39,49,39,25,244,186,58
39,49,39,27,92,59,33
39,49,39,29,91,0,91
39,49,39,31,131,138,-7
39,49,39,33,170,152,18
39,49,39,35,2123,1780,343
39,49,39,41,6906,11327,-4421
39,49,39,43,192,157,35
39,49,39,45,4911,7219,-2308
39,49,39,47,317,319,-2
39,49,39,53,85,70,15
39,49,39,55,90,87,3
39,49,39,57,562,508,54
39,49,39,59,121,114,7
39,49,39,61,1373,1274,99
39,49,39,63,230,170,60
39,49,39,65,89,79,10
39,49,39,71,67,89,-22
39,49,39,73,195,304,-109
39,49,39,77,76,76,0
39,49,39,79,115,128,-13
39,49,39,81,187,94,93
39,49,39,83,440,776,-336
39,49,39,85,226,173,53
39,49,39,87,104,63,41
39,49,39,89,3985,6185,-2200
39,49,39,91,274,388,-114
39,49,39,93,411,280,131
39,49,39,95,869,567,302
39,49,39,97,1230,1986,-756
39,49,39,99,593,370,223
39,49,39,101,380,397,-17
39,49,39,103,298,222,76
39,49,39,105,69,0,69
39,49,39,107,107,82,25
39,49,39,109,217,239,-22
39,49,39,113,1511,1078,433
39,49,39,115,0,59,-59
39,49,39,117,291,575,-284
39,49,39,119,500,429,71
39,49,39,123,72,74,-2
39,49,39,127,208,305,-97
39,49,39,129,1523,2590,-1067
39,49,39,131,95,85,10
39,49,39,133,214,92,122
39,49,39,137,73,0,73
39,49,39,139,665,541,124
39,49,39,141,517,427,90
39,49,39,143,90,55,35
39,49,39,145,251,199,52
39,49,39,147,105,50,55
39,49,39,149,118,87,31
39,49,39,151,703,492,211
39,49,39,153,1087,718,369
39,49,39,155,313,134,179
39,49,39,157,147,87,60
39,49,39,159,1342,2400,-1058
39,49,39,165,402,440,-38
39,49,39,167,152,109,43
39,49,39,169,191,145,46
39,49,39,173,345,204,141
39,49,39,175,55,76,-21
39,49,40,109,67,0,67
39,49,41,51,144,183,-39
39,49,41,67,74,100,-26
39,49,42,3,608,451,157
39,49,42,7,59,0,59
39,49,42,17,57,0,57
39,49,42,29,57,67,-10
39,49,42,43,81,82,-1
39,49,42,45,71,0,71
39,49,42,49,182,73,109
39,49,42,71,66,0,66
39,49,42,91,65,89,-24
39,49,42,101,193,184,9
39,49,42,133,54,0,54
39,49,44,7,65,69,-4
39,49,45,13,49,114,-65
39,49,45,19,80,156,-76
39,49,45,45,119,107,12
39,49,45,51,75,120,-45
39,49,45,79,70,108,-38
39,49,45,91,0,72,-72
39,49,47,37,354,321,33
39,49,47,93,92,126,-34
39,49,47,149,63,79,-16
39,49,47,157,166,111,55
39,49,48,27,71,0,71
39,49,48,29,241,246,-5
39,49,48,85,161,229,-68
39,49,48,113,286,366,-80
39,49,48,121,111,176,-65
39,49,48,141,61,58,3
39,49,48,157,0,116,-116
39,49,48,201,549,449,100
39,49,48,339,0,64,-64
39,49,48,439,326,207,119
39,49,48,453,257,294,-37
39,49,48,491,0,105,-105
39,49,49,35,157,139,18
39,49,49,49,71,0,71
39,49,50,7,127,0,127
39,49,51,13,103,85,18
39,49,51,41,0,63,-63
39,49,51,59,291,238,53
39,49,51,87,69,76,-7
39,49,51,107,64,77,-13
39,49,51,153,66,90,-24
39,49,51,510,72,68,4
39,49,51,700,72,0,72
39,49,51,810,105,58,47
39,49,53,33,377,522,-145
39,49,53,53,76,0,76
39,49,53,61,0,73,-73
39,49,54,11,111,0,111
39,49,54,39,134,62,72
39,49,54,107,119,0,119
39,49,55,25,127,97,30
39,49,55,79,163,116,47
39,51,26,91,150,113,37
39,51,39,39,121,116,5
39,51,39,69,366,308,58
39,51,39,95,893,905,-12
39,51,39,171,217,270,-53
39,51,39,173,150,118,32
39,53,39,49,70,85,-15
39,53,39,79,117,197,-80
39,53,39,87,122,142,-20
39,53,39,105,148,116,32
39,53,54,53,152,139,13
39,55,39,7,379,377,2
39,55,39,35,1895,1277,618
39,55,39,49,87,90,-3
39,55,39,85,1324,1203,121
39,55,39,93,0,77,-77
39,55,39,103,0,55,-55
39,55,39,133,384,544,-160
39,55,39,153,293,244,49
39,55,39,155,283,403,-120
39,57,4,13,58,86,-28
39,57,6,37,113,90,23
39,57,8,41,112,109,3
39,57,12,57,0,85,-85
39,57,12,91,145,74,71
39,57,15,3,78,0,78
39,57,17,31,93,84,9
39,57,17,163,79,0,79
39,57,26,163,64,70,-6
39,57,32,3,75,85,-10
39,57,35,1,72,65,7
39,57,39,17,227,284,-57
39,57,39,21,65,0,65
39,57,39,23,965,989,-24
39,57,39,25,0,71,-71
39,57,39,27,247,160,87
39,57,39,35,85,84,1
39,57,39,37,56,0,56
39,57,39,41,0,81,-81
39,57,39,47,96,99,-3
39,57,39,49,508,562,-54
39,57,39,61,189,309,-120
39,57,39,71,90,0,90
39,57,39,109,285,324,-39
39,57,39,113,5921,6019,-98
39,57,39,165,470,651,-181
39,57,48,29,209,104,105
39,57,51,59,121,150,-29
39,59,39,13,91,111,-20
39,59,39,31,54,0,54
39,59,39,49,114,121,-7
39,59,39,119,370,389,-19
39,59,39,121,233,170,63
39,59,39,157,96,132,-36
39,61,1,73,0,70,-70
39,61,4,13,219,300,-81
39,61,4,19,0,71,-71
39,61,6,1,84,124,-40
39,61,6,37,308,477,-169
39,61,6,59,88,118,-30
39,61,6,73,244,184,60
39,61,6,75,71,87,-16
39,61,6,85,74,133,-59
39,61,8,5,0,61,-61
39,61,8,13,0,64,-64
39,61,8,31,102,190,-88
39,61,8,41,80,56,24
39,61,8,59,0,67,-67
39,61,9,1,108,430,-322
39,61,11,1,74,123,-49
39,61,12,11,99,136,-37
39,61,12,21,75,113,-38
39,61,12,31,88,131,-43
39,61,12,57,100,177,-77
39,61,12,71,130,175,-45
39,61,12,81,0,75,-75
39,61,12,86,111,73,38
39,61,12,95,86,111,-25
39,61,12,99,93,138,-45
39,61,12,101,58,79,-21
39,61,12,103,124,227,-103
39,61,12,115,86,165,-79
39,61,12,127,0,77,-77
39,61,13,67,101,99,2
39,61,13,89,169,181,-12
39,61,13,121,153,214,-61
39,61,13,135,71,92,-21
39,61,17,31,708,805,-97
39,61,17,43,101,100,1
39,61,17,97,56,0,56
39,61,18,3,68,0,68
39,61,18,29,854,1217,-363
39,61,18,47,150,200,-50
39,61,18,57,95,109,-14
39,61,18,97,282,322,-40
39,61,18,105,55,0,55
39,61,18,115,0,71,-71
39,61,18,137,124,196,-72
39,61,18,155,0,66,-66
39,61,18,157,56,0,56
39,61,21,15,1019,1267,-248
39,61,21,37,1411,1602,-191
39,61,21,67,285,157,128
39,61,21,81,61,70,-9
39,61,21,111,356,295,61
39,61,21,117,2370,2460,-90
39,61,24,5,56,0,56
39,61,24,31,110,74,36
39,61,24,510,52,64,-12
39,61,25,17,92,114,-22
39,61,25,25,107,87,20
39,61,26,65,74,0,74
39,61,26,81,84,65,19
39,61,26,125,108,126,-18
39,61,26,161,108,80,28
39,61,26,163,142,144,-2
39,61,27,53,153,121,32
39,61,29,95,46,0,46
39,61,29,189,80,111,-31
39,61,29,510,84,52,32
39,61,32,3,107,180,-73
39,61,34,17,0,89,-89
39,61,36,5,75,48,27
39,61,36,29,0,52,-52
39,61,36,47,187,151,36
39,61,36,61,184,245,-61
39,61,36,81,0,65,-65
39,61,37,21,0,61,-61
39,61,37,63,0,62,-62
39,61,37,81,0,63,-63
39,61,37,119,205,259,-54
39,61,37,183,114,113,1
39,61,39,1,50,66,-16
39,61,39,3,69,63,6
39,61,39,9,60,0,60
39,61,39,15,226,264,-38
39,61,39,17,8461,9836,-1375
39,61,39,23,96,72,24
39,61,39,25,4638,6158,-1520
39,61,39,27,124,150,-26
39,61,39,35,446,338,108
39,61,39,41,116,115,1
39,61,39,45,55,76,-21
39,61,39,49,1274,1373,-99
39,61,39,57,309,189,120
39,61,39,63,47,0,47
39,61,39,71,64,115,-51
39,61,39,85,49,0,49
39,61,39,89,63,51,12
39,61,39,93,68,0,68
39,61,39,95,197,111,86
39,61,39,109,106,78,28
39,61,39,113,1078,965,113
39,61,39,133,50,0,50
39,61,39,145,54,0,54
39,61,39,149,50,0,50
39,61,39,151,76,0,76
39,61,39,153,181,113,68
39,61,39,165,3154,4256,-1102
39,61,39,173,68,56,12
39,61,41,51,58,94,-36
39,61,42,3,147,156,-9
39,61,42,91,0,55,-55
39,61,42,101,132,137,-5
39,61,45,19,0,97,-97
39,61,45,45,0,105,-105
39,61,45,79,57,57,0
39,61,47,37,192,185,7
39,61,47,93,62,50,12
39,61,47,157,105,91,14
39,61,48,29,102,104,-2
39,61,48,85,0,112,-112
39,61,48,113,187,163,24
39,61,48,121,0,76,-76
39,61,48,201,376,213,163
39,61,48,439,162,88,74
39,61,48,453,147,142,5
39,61,49,35,0,79,-79
39,61,51,13,46,0,46
39,61,51,59,98,107,-9
39,61,53,33,180,321,-141
39,61,55,25,87,73,14
39,61,55,79,62,49,13
39,63,26,163,58,0,58
39,63,39,3,373,267,106
39,63,39,35,0,49,-49
39,63,39,41,0,57,-57
39,63,39,49,170,230,-60
39,63,39,61,0,47,-47
39,63,39,65,175,171,4
39,63,39,95,215,215,0
39,63,39,137,194,162,32
39,63,39,143,97,59,38
39,63,39,147,690,660,30
39,63,39,173,647,567,80
39,63,39,175,281,234,47
39,65,39,3,271,270,1
39,65,39,11,0,82,-82
39,65,39,49,79,89,-10
39,65,39,63,171,175,-4
39,65,39,91,238,250,-12
39,65,39,101,71,59,12
39,65,39,159,88,69,19
39,65,39,175,136,134,2
39,67,39,13,95,139,-44
39,67,39,19,0,61,-61
39,67,39,81,169,168,1
39,67,39,157,174,196,-22
39,69,39,39,247,304,-57
39,69,39,51,308,366,-58
39,69,39,95,170,238,-68
39,69,39,137,0,58,-58
39,69,39,171,62,80,-18
39,69,39,173,221,243,-22
39,71,39,1,202,161,41
39,71,39,15,256,229,27
39,71,39,25,220,241,-21
39,71,39,27,486,473,13
39,71,39,47,229,287,-58
39,71,39,49,89,67,22
39,71,39,57,0,90,-90
39,71,39,61,115,64,51
39,71,39,113,83,80,3
39,71,39,131,0,47,-47
39,71,39,141,228,274,-46
39,71,39,165,93,63,30
39,73,39,9,215,222,-7
39,73,39,45,436,461,-25
39,73,39,49,304,195,109
39,73,39,89,78,0,78
39,73,39,127,108,92,16
39,73,39,129,140,124,16
39,73,39,141,81,109,-28
39,75,39,5,68,166,-98
39,75,39,31,140,200,-60
39,75,39,151,90,122,-32
39,75,39,157,411,357,54
39,75,39,169,554,569,-15
39,77,39,5,125,142,-17
39,77,39,33,75,57,18
39,77,39,35,113,99,14
39,77,39,43,895,873,22
39,77,39,49,76,76,0
39,77,39,93,526,396,130
39,77,39,95,0,58,-58
39,77,39,103,0,67,-67
39,77,39,123,49,87,-38
39,77,39,139,372,459,-87
39,77,39,143,417,482,-65
39,77,39,147,144,123,21
39,79,39,49,128,115,13
39,79,39,53,197,117,80
39,79,39,131,134,131,3
39,79,39,141,141,197,-56
39,79,39,145,91,101,-10
39,79,39,163,244,199,45
39,81,39,13,362,311,51
39,81,39,19,0,119,-119
39,81,39,29,140,200,-60
39,81,39,49,94,187,-93
39,81,39,67,168,169,-1
39,81,39,151,0,71,-71
39,81,42,3,120,158,-38
39,81,42,125,67,49,18
39,81,54,9,178,146,32
39,81,54,29,236,206,30
39,81,54,69,76,60,16
39,83,39,5,93,80,13
39,83,39,31,111,0,111
39,83,39,41,321,272,49
39,83,39,49,776,440,336
39,83,39,89,536,498,38
39,83,39,117,277,236,41
39,83,39,139,247,298,-51
39,85,4,13,67,119,-52
39,85,6,37,63,70,-7
39,85,12,71,66,68,-2
39,85,12,103,0,52,-52
39,85,12,115,0,56,-56
39,85,17,31,65,0,65
39,85,32,3,54,54,0
39,85,39,7,1192,1003,189
39,85,39,35,5587,4081,1506
39,85,39,49,173,226,-53
39,85,39,55,1203,1324,-121
39,85,39,61,0,49,-49
39,85,39,93,158,173,-15
39,85,39,95,0,66,-66
39,85,39,99,103,0,103
39,85,39,103,94,155,-61
39,85,39,133,172,188,-16
39,85,39,151,111,72,39
39,85,39,153,399,523,-124
39,85,39,155,134,109,25
39,85,42,3,74,59,15
39,85,42,49,102,0,102
39,87,21,19,313,285,28
39,87,21,89,236,148,88
39,87,39,49,63,104,-41
39,87,39,53,142,122,20
39,87,39,145,214,190,24
39,87,54,11,690,551,139
39,87,54,99,192,195,-3
39,89,4,13,83,0,83
39,89,39,31,151,139,12
39,89,39,35,86,55,31
39,89,39,41,466,440,26
39,89,39,45,1131,1042,89
39,89,39,49,6185,3985,2200
39,89,39,61,51,63,-12
39,89,39,73,0,78,-78
39,89,39,83,498,536,-38
39,89,39,97,0,73,-73
39,89,39,113,0,61,-61
39,89,39,117,0,77,-77
39,89,39,119,612,677,-65
39,89,39,127,367,426,-59
39,89,39,129,0,77,-77
39,89,39,139,0,87,-87
39,89,39,153,66,55,11
39,91,39,3,136,119,17
39,91,39,11,94,117,-23
39,91,39,21,388,359,29
39,91,39,23,94,107,-13
39,91,39,41,90,0,90
39,91,39,49,388,274,114
39,91,39,65,250,238,12
39,91,39,101,77,58,19
39,91,39,109,75,60,15
39,91,39,113,89,0,89
39,91,39,149,149,202,-53
39,91,39,159,448,285,163
39,93,4,13,67,125,-58
39,93,6,37,81,48,33
39,93,12,57,64,99,-35
39,93,12,71,67,75,-8
39,93,12,95,74,0,74
39,93,12,103,0,69,-69
39,93,17,31,101,75,26
39,93,32,3,90,0,90
39,93,39,5,136,166,-30
39,93,39,7,62,0,62
39,93,39,35,7749,5402,2347
39,93,39,41,72,73,-1
39,93,39,43,1062,1020,42
39,93,39,49,280,411,-131
39,93,39,55,77,0,77
39,93,39,61,0,68,-68
39,93,39,77,396,526,-130
39,93,39,85,173,158,15
39,93,39,95,103,99,4
39,93,39,99,66,0,66
39,93,39,103,901,811,90
39,93,39,123,63,71,-8
39,93,39,133,112,116,-4
39,93,39,139,88,70,18
39,93,39,151,94,110,-16
39,93,39,153,355,347,8
39,93,39,155,58,61,-3
39,93,39,169,86,84,2
39,93,42,3,58,56,2
39,95,4,13,154,211,-57
39,95,6,37,115,104,11
39,95,6,73,99,100,-1
39,95,8,31,0,43,-43
39,95,12,11,0,50,-50
39,95,12,31,0,72,-72
39,95,12,57,78,75,3
39,95,12,71,82,166,-84
39,95,12,81,0,53,-53
39,95,12,99,0,78,-78
39,95,12,103,80,75,5
39,95,12,115,0,53,-53
39,95,17,31,167,226,-59
39,95,18,3,106,72,34
39,95,18,97,50,74,-24
39,95,26,49,91,0,91
39,95,26,59,0,69,-69
39,95,26,75,0,71,-71
39,95,26,81,0,63,-63
39,95,26,91,295,251,44
39,95,26,93,54,0,54
39,95,26,99,154,132,22
39,95,26,115,1839,1992,-153
39,95,26,125,224,263,-39
39,95,26,161,238,277,-39
39,95,26,163,759,592,167
39,95,32,3,79,89,-10
39,95,37,119,0,63,-63
39,95,37,183,0,55,-55
39,95,39,3,97,94,3
39,95,39,17,0,61,-61
39,95,39,35,276,496,-220
39,95,39,39,116,83,33
39,95,39,41,0,122,-122
39,95,39,43,164,136,28
39,95,39,49,567,869,-302
39,95,39,51,905,893,12
39,95,39,61,111,197,-86
39,95,39,63,215,215,0
39,95,39,69,238,170,68
39,95,39,77,58,0,58
39,95,39,85,66,0,66
39,95,39,93,99,103,-4
39,95,39,113,105,122,-17
39,95,39,123,462,495,-33
39,95,39,143,317,278,39
39,95,39,147,159,116,43
39,95,39,151,63,57,6
39,95,39,153,114,128,-14
39,95,39,165,0,83,-83
39,95,39,171,85,72,13
39,95,39,173,4048,4246,-198
39,95,42,3,52,68,-16
39,95,47,37,0,51,-51
39,95,48,113,0,71,-71
39,95,48,201,102,93,9
39,95,48,439,0,74,-74
39,95,55,79,57,0,57
39,97,39,21,90,97,-7
39,97,39,23,269,331,-62
39,97,39,41,92,101,-9
39,97,39,47,97,165,-68
39,97,39,49,1986,1230,756
39,97,39,89,73,0,73
39,97,39,113,0,71,-71
39,97,39,129,186,140,46
39,97,39,159,210,301,-91
39,99,4,13,59,59,0
39,99,6,37,62,0,62
39,99,12,71,0,61,-61
39,99,12,95,0,69,-69
39,99,17,31,0,57,-57
39,99,18,3,0,65,-65
39,99,32,3,0,83,-83
39,99,39,7,0,106,-106
39,99,39,29,1353,1179,174
39,99,39,35,374,504,-130
39,99,39,49,370,593,-223
39,99,39,85,0,103,-103
39,99,39,93,0,66,-66
39,99,39,133,398,333,65
39,99,39,151,586,648,-62
39,99,39,153,350,359,-9
39,99,39,155,2697,2848,-151
39,99,42,3,192,229,-37
39,99,42,7,169,65,104
39,99,42,19,0,49,-49
39,99,42,73,265,157,108
39,99,42,85,280,105,175
39,99,47,119,0,120,-120
39,101,39,33,229,243,-14
39,101,39,41,532,372,160
39,101,39,49,397,380,17
39,101,39,65,59,71,-12
39,101,39,91,58,77,-19
39,101,39,117,326,310,16
39,101,39,139,55,77,-22
39,101,39,159,226,144,82
39,101,39,175,95,125,-30
39,103,4,13,0,94,-94
39,103,12,71,0,83,-83
39,103,17,31,0,54,-54
39,103,32,3,0,51,-51
39,103,39,5,147,212,-65
39,103,39,35,4799,3004,1795
39,103,39,41,0,123,-123
39,103,39,49,222,298,-76
39,103,39,55,55,0,55
39,103,39,77,67,0,67
39,103,39,85,155,94,61
39,103,39,93,811,901,-90
39,103,39,133,196,221,-25
39,103,39,139,70,66,4
39,103,39,151,297,350,-53
39,103,39,153,2180,1917,263
39,103,39,155,56,66,-10
39,103,39,169,821,844,-23
39,103,42,3,63,0,63
39,105,39,9,265,243,22
39,105,39,49,0,69,-69
39,105,39,53,116,148,-32
39,105,54,53,87,101,-14
39,107,39,3,67,86,-19
39,107,39,11,405,435,-30
39,107,39,37,152,151,1
39,107,39,49,82,107,-25
39,107,39,109,56,0,56
39,107,39,113,82,69,13
39,107,39,149,72,78,-6
39,107,39,161,131,158,-27
39,109,39,3,69,0,69
39,109,39,11,77,66,11
39,109,39,17,80,58,22
39,109,39,21,160,166,-6
39,109,39,23,367,291,76
39,109,39,37,557,451,106
39,109,39,49,239,217,22
39,109,39,57,324,285,39
39,109,39,61,78,106,-28
39,109,39,91,60,75,-15
39,109,39,107,0,56,-56
39,109,39,113,2617,1871,746
39,109,39,135,56,84,-28
39,109,39,149,770,598,172
39,109,39,165,82,118,-36
39,111,39,13,124,152,-28
39,111,39,167,0,62,-62
39,111,54,103,0,58,-58
39,113,4,13,170,184,-14
39,113,4,19,120,73,47
39,113,6,37,172,147,25
39,113,6,59,59,60,-1
39,113,6,71,65,0,65
39,113,6,73,142,114,28
39,113,6,85,59,0,59
39,113,8,31,0,56,-56
39,113,8,41,152,133,19
39,113,12,9,79,95,-16
39,113,12,11,66,61,5
39,113,12,31,0,67,-67
39,113,12,57,77,149,-72
39,113,12,71,0,126,-126
39,113,12,91,122,86,36
39,113,12,95,86,82,4
39,113,12,101,0,75,-75
39,113,12,103,98,124,-26
39,113,12,105,0,61,-61
39,113,12,115,73,89,-16
39,113,12,127,0,80,-80
39,113,13,89,67,67,0
39,113,13,121,0,90,-90
39,113,13,135,0,72,-72
39,113,15,3,59,102,-43
39,113,17,31,277,214,63
39,113,17,43,63,0,63
39,113,18,3,67,69,-2
39,113,18,57,0,74,-74
39,113,18,97,127,163,-36
39,113,18,177,131,78,53
39,113,21,15,70,0,70
39,113,21,67,96,91,5
39,113,21,111,137,88,49
39,113,21,117,106,64,42
39,113,26,125,93,100,-7
39,113,26,163,145,146,-1
39,113,29,189,0,90,-90
39,113,32,3,116,146,-30
39,113,35,1,0,81,-81
39,113,36,47,58,55,3
39,113,37,119,60,131,-71
39,113,37,133,0,68,-68
39,113,37,183,0,187,-187
39,113,39,3,81,74,7
39,113,39,9,55,0,55
39,113,39,11,52,69,-17
39,113,39,17,1519,1559,-40
39,113,39,21,148,91,57
39,113,39,23,1332,1224,108
39,113,39,25,199,209,-10
39,113,39,27,199,142,57
39,113,39,35,162,294,-132
39,113,39,37,333,381,-48
39,113,39,41,59,150,-91
39,113,39,45,70,87,-17
39,113,39,49,1078,1511,-433
39,113,39,57,6019,5921,98
39,113,39,61,965,1078,-113
39,113,39,71,80,83,-3
39,113,39,89,61,0,61
39,113,39,91,0,89,-89
39,113,39,95,122,105,17
39,113,39,97,71,0,71
39,113,39,107,69,82,-13
39,113,39,109,1871,2617,-746
39,113,39,135,658,651,7
39,113,39,149,170,163,7
39,113,39,153,93,80,13
39,113,39,165,2701,3509,-808
39,113,39,173,65,70,-5
39,113,42,3,62,79,-17
39,113,45,19,0,78,-78
39,113,47,37,91,103,-12
39,113,48,29,180,174,6
39,113,48,113,71,83,-12
39,113,48,201,113,93,20
39,113,48,439,101,75,26
39,113,48,453,91,66,25
39,113,51,59,84,105,-21
39,113,53,33,80,79,1
39,115,39,9,58,87,-29
39,115,39,49,59,0,59
39,115,39,119,161,158,3
39,115,39,127,104,82,22
39,115,39,167,109,134,-25
39,117,39,33,260,259,1
39,117,39,41,584,323,261
39,117,39,49,575,291,284
39,117,39,83,236,277,-41
39,117,39,89,77,0,77
39,117,39,101,310,326,-16
39,117,39,139,284,372,-88
39,119,39,31,176,235,-59
39,119,39,45,193,144,49
39,119,39,49,429,500,-71
39,119,39,59,389,370,19
39,119,39,89,677,612,65
39,119,39,115,158,161,-3
39,119,39,127,435,430,5
39,121,39,59,170,233,-63
39,121,39,167,90,104,-14
39,123,39,35,224,100,124
39,123,39,43,203,192,11
39,123,39,49,74,72,2
39,123,39,77,87,49,38
39,123,39,93,71,63,8
39,123,39,95,495,462,33
39,123,39,143,432,433,-1
39,123,39,147,58,0,58
39,123,39,173,417,357,60
39,125,18,3,117,181,-64
39,125,39,39,347,325,22
39,125,39,137,59,68,-9
39,125,39,161,164,109,55
39,125,39,171,55,62,-7
39,127,39,9,77,66,11
39,127,39,45,583,554,29
39,127,39,49,305,208,97
39,127,39,73,92,108,-16
39,127,39,89,426,367,59
39,127,39,115,82,104,-22
39,127,39,119,430,435,-5
39,129,39,45,447,502,-55
39,129,39,47,97,161,-64
39,129,39,49,2590,1523,1067
39,129,39,73,124,140,-16
39,129,39,89,77,0,77
39,129,39,97,140,186,-46
39,129,39,131,67,0,67
39,129,39,141,438,507,-69
39,131,39,49,85,95,-10
39,131,39,71,47,0,47
39,131,39,79,131,134,-3
39,131,39,129,0,67,-67
39,131,39,141,375,492,-117
39,131,39,145,255,278,-23
39,133,4,13,0,99,-99
39,133,6,37,0,57,-57
39,133,12,71,0,57,-57
39,133,17,31,0,52,-52
39,133,39,7,66,67,-1
39,133,39,29,95,94,1
39,133,39,35,2036,1407,629
39,133,39,49,92,214,-122
39,133,39,55,544,384,160
39,133,39,61,0,50,-50
39,133,39,85,188,172,16
39,133,39,93,116,112,4
39,133,39,99,333,398,-65
39,133,39,103,221,196,25
39,133,39,151,739,842,-103
39,133,39,153,4053,4058,-5
39,133,39,155,575,613,-38
39,133,39,169,57,0,57
39,133,42,3,0,96,-96
39,135,18,177,163,249,-86
39,135,39,17,460,410,50
39,135,39,37,150,175,-25
39,135,39,109,84,56,28
39,135,39,113,651,658,-7
39,135,39,165,86,67,19
39,137,39,3,279,310,-31
39,137,39,39,95,88,7
39,137,39,49,0,73,-73
39,137,39,63,162,194,-32
39,137,39,69,58,0,58
39,137,39,125,68,59,9
39,137,39,161,98,67,31
39,137,39,173,0,49,-49
39,139,39,5,820,601,219
39,139,39,33,857,703,154
39,139,39,35,161,113,48
39,139,39,41,140,150,-10
39,139,39,43,0,58,-58
39,139,39,49,541,665,-124
39,139,39,77,459,372,87
39,139,39,83,298,247,51
39,139,39,89,87,0,87
39,139,39,93,70,88,-18
39,139,39,101,77,55,22
39,139,39,103,66,70,-4
39,139,39,117,372,284,88
39,139,39,151,61,64,-3
39,139,39,153,96,106,-10
39,139,39,169,113,103,10
39,141,39,45,127,94,33
39,141,39,47,146,162,-16
39,141,39,49,427,517,-90
39,141,39,71,274,228,46
39,141,39,73,109,81,28
39,141,39,79,197,141,56
39,141,39,129,507,438,69
39,141,39,131,492,375,117
39,141,39,145,92,90,2
39,141,39,163,154,117,37
39,143,39,35,0,56,-56
39,143,39,43,337,387,-50
39,143,39,49,55,90,-35
39,143,39,63,59,97,-38
39,143,39,77,482,417,65
39,143,39,95,278,317,-39
39,143,39,123,433,432,1
39,143,39,147,469,538,-69
39,143,39,173,346,352,-6
39,145,21,19,74,0,74
39,145,21,89,208,156,52
39,145,21,135,64,0,64
39,145,39,1,123,96,27
39,145,39,49,199,251,-52
39,145,39,61,0,54,-54
39,145,39,79,101,91,10
39,145,39,87,190,214,-24
39,145,39,131,278,255,23
39,145,39,141,90,92,-2
39,147,39,33,102,53,49
39,147,39,35,0,44,-44
39,147,39,43,0,93,-93
39,147,39,49,50,105,-55
39,147,39,63,660,690,-30
39,147,39,77,123,144,-21
39,147,39,95,116,159,-43
39,147,39,123,0,58,-58
39,147,39,143,538,469,69
39,147,39,173,324,356,-32
39,147,39,175,221,212,9
39,149,39,3,68,116,-48
39,149,39,11,392,302,90
39,149,39,21,71,0,71
39,149,39,37,107,119,-12
39,149,39,49,87,118,-31
39,149,39,61,0,50,-50
39,149,39,91,202,149,53
39,149,39,107,78,72,6
39,149,39,109,598,770,-172
39,149,39,113,163,170,-7
39,151,4,13,77,133,-56
39,151,6,37,65,52,13
39,151,12,57,0,65,-65
39,151,12,71,77,99,-22
39,151,12,95,0,69,-69
39,151,12,103,65,96,-31
39,151,12,115,0,87,-87
39,151,17,31,84,74,10
39,151,32,3,72,89,-17
39,151,37,119,0,77,-77
39,151,39,5,0,71,-71
39,151,39,7,67,0,67
39,151,39,19,817,736,81
39,151,39,29,625,549,76
39,151,39,35,634,759,-125
39,151,39,41,0,105,-105
39,151,39,49,492,703,-211
39,151,39,61,0,76,-76
39,151,39,75,122,90,32
39,151,39,81,71,0,71
39,151,39,85,72,111,-39
39,151,39,93,110,94,16
39,151,39,95,57,63,-6
39,151,39,99,648,586,62
39,151,39,103,350,297,53
39,151,39,133,842,739,103
39,151,39,139,64,61,3
39,151,39,153,4300,3735,565
39,151,39,155,134,126,8
39,151,39,157,1164,1028,136
39,151,39,169,728,603,125
39,151,42,3,120,113,7
39,151,45,51,0,79,-79
39,153,4,13,175,287,-112
39,153,6,37,211,111,100
39,153,6,59,54,63,-9
39,153,6,73,118,131,-13
39,153,8,31,46,54,-8
39,153,8,41,60,0,60
39,153,11,1,0,46,-46
39,153,12,9,0,71,-71
39,153,12,11,79,110,-31
39,153,12,21,0,112,-112
39,153,12,31,67,0,67
39,153,12,57,58,98,-40
39,153,12,71,66,194,-128
39,153,12,81,0,68,-68
39,153,12,95,51,0,51
39,153,12,99,65,93,-28
39,153,12,103,86,131,-45
39,153,12,105,0,53,-53
39,153,12,115,62,72,-10
39,153,12,127,45,73,-28
39,153,13,89,97,0,97
39,153,13,121,0,100,-100
39,153,17,31,228,174,54
39,153,17,43,74,0,74
39,153,26,125,99,103,-4
39,153,26,163,78,101,-23
39,153,32,3,115,129,-14
39,153,36,29,66,0,66
39,153,36,47,58,49,9
39,153,36,61,69,59,10
39,153,37,119,101,110,-9
39,153,37,183,91,123,-32
39,153,39,5,56,0,56
39,153,39,7,71,89,-18
39,153,39,17,54,64,-10
39,153,39,19,72,68,4
39,153,39,29,95,112,-17
39,153,39,35,6066,4891,1175
39,153,39,41,68,107,-39
39,153,39,43,52,64,-12
39,153,39,45,0,67,-67
39,153,39,49,718,1087,-369
39,153,39,55,244,293,-49
39,153,39,61,113,181,-68
39,153,39,85,523,399,124
39,153,39,89,55,66,-11
39,153,39,93,347,355,-8
39,153,39,95,128,114,14
39,153,39,99,359,350,9
39,153,39,103,1917,2180,-263
39,153,39,113,80,93,-13
39,153,39,133,4058,4053,5
39,153,39,139,106,96,10
39,153,39,151,3735,4300,-565
39,153,39,155,316,191,125
39,153,39,157,131,150,-19
39,153,39,165,0,74,-74
39,153,39,169,784,688,96
39,153,39,173,0,49,-49
39,153,42,3,169,213,-44
39,153,42,49,79,0,79
39,153,42,101,0,50,-50
39,153,45,19,0,60,-60
39,153,45,51,0,65,-65
39,153,47,37,58,55,3
39,153,48,113,63,61,2
39,153,48,201,158,92,66
39,153,48,439,113,0,113
39,153,48,453,0,64,-64
39,153,49,35,0,57,-57
39,153,51,59,61,61,0
39,153,53,33,57,75,-18
39,155,39,7,385,351,34
39,155,39,29,180,92,88
39,155,39,35,417,456,-39
39,155,39,49,134,313,-179
39,155,39,55,403,283,120
39,155,39,85,109,134,-25
39,155,39,93,61,58,3
39,155,39,99,2848,2697,151
39,155,39,103,66,56,10
39,155,39,133,613,575,38
39,155,39,151,126,134,-8
39,155,39,153,191,316,-125
39,155,42,3,97,123,-26
39,155,42,39,60,0,60
39,155,42,73,105,59,46
39,155,42,85,666,477,189
39,155,47,119,0,74,-74
39,157,39,19,175,247,-72
39,157,39,31,296,337,-41
39,157,39,35,74,75,-1
39,157,39,49,87,147,-60
39,157,39,59,132,96,36
39,157,39,67,196,174,22
39,157,39,75,357,411,-54
39,157,39,151,1028,1164,-136
39,157,39,153,150,131,19
39,157,39,169,112,115,-3
39,159,39,21,195,257,-62
39,159,39,23,0,70,-70
39,159,39,41,562,515,47
39,159,39,49,2400,1342,1058
39,159,39,65,69,88,-19
39,159,39,91,285,448,-163
39,159,39,97,301,210,91
39,159,39,101,144,226,-82
39,161,18,1,75,81,-6
39,161,18,3,95,133,-38
39,161,39,3,507,398,109
39,161,39,107,158,131,27
39,161,39,125,109,164,-55
39,161,39,137,67,98,-31
39,163,39,9,55,0,55
39,163,39,79,199,244,-45
39,163,39,141,117,154,-37
39,165,4,13,74,93,-19
39,165,6,37,141,66,75
39,165,6,73,65,66,-1
39,165,12,57,0,66,-66
39,165,12,71,0,87,-87
39,165,12,103,0,100,-100
39,165,13,121,0,85,-85
39,165,17,31,150,126,24
39,165,18,57,81,0,81
39,165,18,97,67,0,67
39,165,21,15,122,131,-9
39,165,21,37,132,97,35
39,165,21,67,55,0,55
39,165,21,111,60,0,60
39,165,21,117,137,125,12
39,165,26,125,101,0,101
39,165,36,47,62,0,62
39,165,39,15,94,75,19
39,165,39,17,4503,3739,764
39,165,39,23,108,66,42
39,165,39,25,1278,1103,175
39,165,39,27,537,539,-2
39,165,39,35,81,77,4
39,165,39,41,0,107,-107
39,165,39,49,440,402,38
39,165,39,57,651,470,181
39,165,39,61,4256,3154,1102
39,165,39,71,63,93,-30
39,165,39,95,83,0,83
39,165,39,109,118,82,36
39,165,39,113,3509,2701,808
39,165,39,135,67,86,-19
39,165,39,153,74,0,74
39,165,53,33,0,72,-72
39,167,39,9,177,173,4
39,167,39,49,109,152,-43
39,167,39,111,62,0,62
39,167,39,115,134,109,25
39,167,39,121,104,90,14
39,167,54,73,0,80,-80
39,167,54,107,901,769,132
39,169,39,5,369,456,-87
39,169,39,35,205,228,-23
39,169,39,49,145,191,-46
39,169,39,75,569,554,15
39,169,39,93,84,86,-2
39,169,39,103,844,821,23
39,169,39,133,0,57,-57
39,169,39,139,103,113,-10
39,169,39,151,603,728,-125
39,169,39,153,688,784,-96
39,169,39,157,115,112,3
39,171,18,3,58,93,-35
39,171,18,33,67,78,-11
39,171,18,151,60,74,-14
39,171,26,59,118,72,46
39,171,39,39,371,394,-23
39,171,39,51,270,217,53
39,171,39,69,80,62,18
39,171,39,95,72,85,-13
39,171,39,125,62,55,7
39,171,39,173,0,57,-57
39,173,4,13,0,65,-65
39,173,17,31,97,61,36
39,173,26,91,0,50,-50
39,173,26,115,194,130,64
39,173,26,125,73,103,-30
39,173,26,161,0,71,-71
39,173,26,163,99,124,-25
39,173,39,3,53,63,-10
39,173,39,35,134,212,-78
39,173,39,39,76,51,25
39,173,39,41,58,0,58
39,173,39,43,63,55,8
39,173,39,49,204,345,-141
39,173,39,51,118,150,-32
39,173,39,61,56,68,-12
39,173,39,63,567,647,-80
39,173,39,69,243,221,22
39,173,39,95,4246,4048,198
39,173,39,113,70,65,5
39,173,39,123,357,417,-60
39,173,39,137,49,0,49
39,173,39,143,352,346,6
39,173,39,147,356,324,32
39,173,39,153,49,0,49
39,173,39,171,57,0,57
39,175,39,33,167,175,-8
39,175,39,49,76,55,21
39,175,39,63,234,281,-47
39,175,39,65,134,136,-2
39,175,39,101,125,95,30
39,175,39,147,212,221,-9
40,1,5,7,205,169,36
40,1,5,143,116,118,-2
40,1,40,21,259,264,-5
40,1,40,41,113,150,-37
40,1,40,135,0,96,-96
40,1,40,143,53,68,-15
40,3,40,47,0,69,-69
40,3,40,151,0,77,-77
40,5,40,13,177,196,-19
40,5,40,29,140,93,47
40,7,20,175,166,92,74
40,9,40,17,0,116,-116
40,9,40,39,104,87,17
40,9,40,109,88,214,-126
40,9,40,129,89,0,89
40,9,40,149,235,183,52
40,11,40,17,0,136,-136
40,11,40,93,83,0,83
40,11,40,109,0,73,-73
40,13,40,5,196,177,19
40,13,40,19,61,71,-10
40,13,40,23,110,110,0
40,13,40,69,156,131,25
40,13,40,89,71,0,71
40,13,40,95,148,239,-91
40,13,40,109,116,93,23
40,13,40,143,0,57,-57
40,13,48,85,86,112,-26
40,13,48,113,98,68,30
40,13,48,121,0,58,-58
40,13,48,181,648,450,198
40,13,48,439,84,0,84
40,15,40,17,183,207,-24
40,15,40,27,78,88,-10
40,15,40,31,202,254,-52
40,15,40,39,153,167,-14
40,15,40,51,188,255,-67
40,15,40,109,129,200,-71
40,17,4,13,74,0,74
40,17,6,37,60,0,60
40,17,8,1,67,0,67
40,17,40,9,116,0,116
40,17,40,11,136,0,136
40,17,40,15,207,183,24
40,17,40,19,70,0,70
40,17,40,27,1233,960,273
40,17,40,31,117,77,40
40,17,40,39,257,158,99
40,17,40,47,180,0,180
40,17,40,51,438,548,-110
40,17,40,65,68,0,68
40,17,40,73,216,129,87
40,17,40,81,0,108,-108
40,17,40,83,133,141,-8
40,17,40,87,176,220,-44
40,17,40,109,7200,5370,1830
40,17,40,119,114,83,31
40,17,40,125,129,134,-5
40,17,40,137,102,68,34
40,17,40,143,260,231,29
40,17,40,149,96,0,96
40,17,40,153,115,0,115
40,17,48,85,0,82,-82
40,17,48,113,57,84,-27
40,17,48,121,75,100,-25
40,17,48,201,94,71,23
40,17,48,439,125,146,-21
40,19,40,13,71,61,10
40,19,40,17,0,70,-70
40,19,40,27,72,144,-72
40,19,40,49,90,106,-16
40,19,40,67,130,0,130
40,19,40,69,166,143,23
40,19,40,85,294,273,21
40,19,40,95,178,170,8
40,19,40,99,119,103,16
40,19,40,109,174,230,-56
40,19,40,123,0,85,-85
40,19,40,137,111,97,14
40,19,48,97,89,0,89
40,19,48,113,83,0,83
40,19,48,121,81,0,81
40,19,48,181,79,0,79
40,19,48,439,58,77,-19
40,21,40,1,264,259,5
40,21,40,41,118,95,23
40,21,40,97,183,142,41
40,21,40,101,557,366,191
40,21,40,109,88,114,-26
40,21,40,131,61,108,-47
40,21,40,135,107,116,-9
40,21,40,143,301,407,-106
40,21,40,145,147,188,-41
40,23,40,13,110,110,0
40,23,40,89,105,89,16
40,23,40,127,86,174,-88
40,23,48,277,98,93,5
40,27,4,13,117,138,-21
40,27,6,37,148,104,44
40,27,6,59,0,74,-74
40,27,6,65,73,0,73
40,27,6,73,135,87,48
40,27,8,5,0,61,-61
40,27,8,31,0,78,-78
40,27,8,41,81,129,-48
40,27,12,9,0,59,-59
40,27,17,31,61,0,61
40,27,20,91,0,60,-60
40,27,20,173,106,121,-15
40,27,32,3,0,101,-101
40,27,40,15,88,78,10
40,27,40,17,960,1233,-273
40,27,40,19,144,72,72
40,27,40,31,298,150,148
40,27,40,39,105,0,105
40,27,40,47,112,83,29
40,27,40,49,299,135,164
40,27,40,51,622,610,12
40,27,40,65,100,0,100
40,27,40,81,186,159,27
40,27,40,83,220,255,-35
40,27,40,87,1354,1480,-126
40,27,40,91,0,83,-83
40,27,40,99,0,82,-82
40,27,40,101,69,0,69
40,27,40,109,11182,9521,1661
40,27,40,119,172,153,19
40,27,40,121,86,63,23
40,27,40,123,194,104,90
40,27,40,125,598,639,-41
40,27,40,131,0,53,-53
40,27,40,133,50,71,-21
40,27,40,137,110,89,21
40,27,40,143,601,519,82
40,27,40,145,68,0,68
40,27,48,29,73,148,-75
40,27,48,85,148,178,-30
40,27,48,113,190,273,-83
40,27,48,121,136,151,-15
40,27,48,201,194,215,-21
40,27,48,339,0,67,-67
40,27,48,439,279,261,18
40,27,48,453,70,123,-53
40,27,53,33,0,82,-82
40,29,40,5,93,140,-47
40,29,40,123,97,91,6
40,31,2,20,95,0,95
40,31,2,90,106,0,106
40,31,4,13,56,79,-23
40,31,6,37,73,66,7
40,31,6,71,90,71,19
40,31,6,73,70,107,-37
40,31,8,41,281,325,-44
40,31,13,179,106,111,-5
40,31,15,3,255,322,-67
40,31,20,61,0,81,-81
40,31,20,103,0,92,-92
40,31,21,47,84,103,-19
40,31,32,3,85,90,-5
40,31,36,45,129,116,13
40,31,37,51,129,243,-114
40,31,37,85,78,0,78
40,31,37,133,0,86,-86
40,31,40,15,254,202,52
40,31,40,17,77,117,-40
40,31,40,27,150,298,-148
40,31,40,33,104,98,6
40,31,40,51,141,119,22
40,31,40,65,149,133,16
40,31,40,75,71,67,4
40,31,40,109,385,840,-455
40,31,40,137,254,301,-47
40,31,40,141,79,97,-18
40,31,40,143,132,155,-23
40,31,45,79,70,64,6
40,31,47,125,217,160,57
40,31,48,27,381,380,1
40,31,48,29,114,183,-69
40,31,48,85,0,64,-64
40,31,48,113,129,205,-76
40,31,48,121,72,80,-8
40,31,48,141,385,381,4
40,31,48,201,0,103,-103
40,31,48,439,142,198,-56
40,31,48,485,199,143,56
40,31,53,53,332,233,99
40,33,40,31,98,104,-6
40,35,40,41,156,102,54
40,35,40,97,167,145,22
40,35,40,115,145,137,8
40,35,40,131,93,102,-9
40,35,40,143,87,81,6
40,37,40,81,91,135,-44
40,37,40,109,124,96,28
40,37,40,111,236,268,-32
40,37,40,113,97,113,-16
40,37,40,117,154,260,-106
40,37,40,119,212,255,-43
40,37,40,131,144,172,-28
40,37,40,143,3215,3231,-16
40,37,40,145,120,167,-47
40,39,40,9,87,104,-17
40,39,40,15,167,153,14
40,39,40,17,158,257,-99
40,39,40,27,0,105,-105
40,39,40,43,72,0,72
40,39,40,109,132,291,-159
40,39,40,149,207,297,-90
40,41,5,7,426,454,-28
40,41,5,143,88,104,-16
40,41,29,97,137,101,36
40,41,29,119,97,125,-28
40,41,29,145,67,0,67
40,41,40,1,150,113,37
40,41,40,21,95,118,-23
40,41,40,35,102,156,-54
40,41,40,97,227,266,-39
40,41,40,109,69,68,1
40,41,40,115,340,390,-50
40,41,40,131,126,80,46
40,41,40,143,280,209,71
40,43,40,39,0,72,-72
40,43,40,153,68,0,68
40,45,40,153,110,76,34
40,47,4,13,0,61,-61
40,47,5,143,71,99,-28
40,47,8,41,118,0,118
40,47,20,173,72,66,6
40,47,40,3,69,0,69
40,47,40,17,0,180,-180
40,47,40,27,83,112,-29
40,47,40,53,91,102,-11
40,47,40,71,68,111,-43
40,47,40,73,110,100,10
40,47,40,83,0,72,-72
40,47,40,93,154,132,22
40,47,40,103,0,72,-72
40,47,40,109,260,452,-192
40,47,40,119,106,114,-8
40,47,40,143,86,157,-71
40,47,40,151,68,0,68
40,49,40,19,106,90,16
40,49,40,27,135,299,-164
40,49,40,51,79,74,5
40,49,40,87,209,266,-57
40,49,40,99,136,192,-56
40,49,40,109,142,148,-6
40,49,40,123,184,137,47
40,51,40,15,255,188,67
40,51,40,17,548,438,110
40,51,40,27,610,622,-12
40,51,40,31,119,141,-22
40,51,40,49,74,79,-5
40,51,40,87,471,508,-37
40,51,40,109,778,681,97
40,51,40,137,189,177,12
40,51,40,143,0,76,-76
40,53,40,47,102,91,11
40,53,40,71,59,64,-5
40,55,40,65,0,69,-69
40,59,40,153,0,59,-59
40,61,40,79,111,85,26
40,61,40,101,0,82,-82
40,61,40,121,115,99,16
40,63,40,121,0,99,-99
40,63,40,123,92,107,-15
40,63,40,133,158,137,21
40,65,40,17,0,68,-68
40,65,40,27,0,100,-100
40,65,40,31,133,149,-16
40,65,40,55,69,0,69
40,65,40,109,95,190,-95
40,65,40,141,0,78,-78
40,65,48,29,78,0,78
40,67,40,19,0,130,-130
40,67,40,137,73,92,-19
40,69,40,13,131,156,-25
40,69,40,19,143,166,-23
40,69,40,95,88,106,-18
40,71,20,35,140,95,45
40,71,20,173,72,89,-17
40,71,40,47,111,68,43
40,71,40,53,64,59,5
40,71,40,103,138,104,34
40,71,40,109,161,291,-130
40,71,40,113,283,275,8
40,71,40,119,117,183,-66
40,71,40,143,96,161,-65
40,73,40,17,129,216,-87
40,73,40,47,100,110,-10
40,73,40,83,161,64,97
40,73,40,109,192,208,-16
40,75,40,31,67,71,-4
40,77,40,79,145,134,11
40,77,40,121,114,177,-63
40,79,5,33,180,112,68
40,79,5,131,596,674,-78
40,79,40,61,85,111,-26
40,79,40,77,134,145,-11
40,79,40,121,75,0,75
40,79,40,135,217,126,91
40,79,40,143,81,71,10
40,81,40,17,108,0,108
40,81,40,27,159,186,-27
40,81,40,37,135,91,44
40,81,40,109,795,759,36
40,81,40,119,293,335,-42
40,81,40,125,479,431,48
40,81,40,133,0,72,-72
40,81,40,143,97,74,23
40,83,40,17,141,133,8
40,83,40,27,255,220,35
40,83,40,47,72,0,72
40,83,40,73,64,161,-97
40,83,40,109,2322,1993,329
40,83,40,119,222,152,70
40,83,40,143,46,85,-39
40,85,40,19,273,294,-21
40,85,48,97,131,116,15
40,85,48,121,75,0,75
40,87,40,17,220,176,44
40,87,40,27,1480,1354,126
40,87,40,49,266,209,57
40,87,40,51,508,471,37
40,87,40,109,702,527,175
40,87,40,125,0,75,-75
40,89,5,133,84,0,84
40,89,40,13,0,71,-71
40,89,40,23,89,105,-16
40,89,40,109,0,73,-73
40,91,40,27,83,0,83
40,91,40,101,271,256,15
40,91,40,109,114,89,25
40,91,40,111,72,94,-22
40,91,40,121,222,194,28
40,91,40,143,117,144,-27
40,93,40,11,0,83,-83
40,93,40,47,132,154,-22
40,95,40,13,239,148,91
40,95,40,19,170,178,-8
40,95,40,69,106,88,18
40,97,40,21,142,183,-41
40,97,40,35,145,167,-22
40,97,40,41,266,227,39
40,97,40,101,64,76,-12
40,97,40,109,0,58,-58
40,97,40,131,438,509,-71
40,97,40,143,466,489,-23
40,97,40,145,184,139,45
40,99,40,19,103,119,-16
40,99,40,27,82,0,82
40,99,40,49,192,136,56
40,99,40,109,75,60,15
40,99,40,123,0,122,-122
40,101,40,21,366,557,-191
40,101,40,27,0,69,-69
40,101,40,61,82,0,82
40,101,40,91,256,271,-15
40,101,40,97,76,64,12
40,101,40,109,126,181,-55
40,101,40,111,93,130,-37
40,101,40,135,173,163,10
40,101,40,143,682,760,-78
40,101,40,145,538,651,-113
40,103,40,47,72,0,72
40,103,40,71,104,138,-34
40,103,40,109,0,62,-62
40,103,40,119,341,259,82
40,105,20,125,76,80,-4
40,105,40,131,69,124,-55
40,105,40,143,79,67,12
40,105,40,147,165,170,-5
40,107,40,111,141,91,50
40,107,40,133,60,0,60
40,107,40,143,0,76,-76
40,109,2,20,126,139,-13
40,109,4,13,436,461,-25
40,109,4,19,98,124,-26
40,109,5,7,111,181,-70
40,109,5,119,105,99,6
40,109,5,131,115,96,19
40,109,5,143,95,89,6
40,109,6,1,0,53,-53
40,109,6,29,87,73,14
40,109,6,37,425,457,-32
40,109,6,59,186,125,61
40,109,6,65,151,113,38
40,109,6,67,91,88,3
40,109,6,71,150,72,78
40,109,6,73,266,230,36
40,109,6,85,73,0,73
40,109,8,1,120,80,40
40,109,8,5,149,182,-33
40,109,8,13,0,80,-80
40,109,8,31,153,244,-91
40,109,8,35,81,0,81
40,109,8,41,314,261,53
40,109,8,59,81,136,-55
40,109,8,69,0,60,-60
40,109,11,1,0,62,-62
40,109,12,5,79,0,79
40,109,12,9,58,105,-47
40,109,12,11,71,0,71
40,109,12,31,76,88,-12
40,109,12,33,73,0,73
40,109,12,57,78,138,-60
40,109,12,71,0,56,-56
40,109,12,86,62,63,-1
40,109,12,91,72,0,72
40,109,12,95,115,84,31
40,109,12,99,65,44,21
40,109,12,103,0,100,-100
40,109,13,67,0,69,-69
40,109,13,121,59,100,-41
40,109,15,3,133,115,18
40,109,17,31,196,174,22
40,109,18,97,68,0,68
40,109,20,91,148,173,-25
40,109,20,173,415,300,115
40,109,21,111,0,56,-56
40,109,22,15,80,0,80
40,109,22,17,87,0,87
40,109,27,53,53,78,-25
40,109,29,47,0,81,-81
40,109,29,77,0,88,-88
40,109,29,95,142,126,16
40,109,29,189,80,113,-33
40,109,31,55,77,73,4
40,109,31,153,83,0,83
40,109,32,3,181,273,-92
40,109,35,1,112,116,-4
40,109,36,47,67,67,0
40,109,36,61,50,82,-32
40,109,37,119,0,91,-91
40,109,37,183,0,86,-86
40,109,39,49,0,67,-67
40,109,40,9,214,88,126
40,109,40,11,73,0,73
40,109,40,13,93,116,-23
40,109,40,15,200,129,71
40,109,40,17,5370,7200,-1830
40,109,40,19,230,174,56
40,109,40,21,114,88,26
40,109,40,27,9521,11182,-1661
40,109,40,31,840,385,455
40,109,40,37,96,124,-28
40,109,40,39,291,132,159
40,109,40,41,68,69,-1
40,109,40,47,452,260,192
40,109,40,49,148,142,6
40,109,40,51,681,778,-97
40,109,40,65,190,95,95
40,109,40,71,291,161,130
40,109,40,73,208,192,16
40,109,40,81,759,795,-36
40,109,40,83,1993,2322,-329
40,109,40,87,527,702,-175
40,109,40,89,73,0,73
40,109,40,91,89,114,-25
40,109,40,97,58,0,58
40,109,40,99,60,75,-15
40,109,40,101,181,126,55
40,109,40,103,62,0,62
40,109,40,111,118,74,44
40,109,40,113,78,75,3
40,109,40,119,880,463,417
40,109,40,121,171,130,41
40,109,40,123,223,184,39
40,109,40,125,1218,1295,-77
40,109,40,131,171,114,57
40,109,40,133,182,141,41
40,109,40,137,256,129,127
40,109,40,139,65,0,65
40,109,40,143,1751,1808,-57
40,109,40,145,119,134,-15
40,109,40,147,129,97,32
40,109,40,151,60,0,60
40,109,40,153,147,0,147
40,109,41,51,0,76,-76
40,109,41,67,0,52,-52
40,109,47,37,0,72,-72
40,109,47,157,110,82,28
40,109,48,27,117,113,4
40,109,48,29,344,458,-114
40,109,48,85,343,554,-211
40,109,48,113,825,997,-172
40,109,48,121,306,461,-155
40,109,48,135,0,72,-72
40,109,48,141,182,127,55
40,109,48,157,127,145,-18
40,109,48,167,64,65,-1
40,109,48,181,70,0,70
40,109,48,201,701,761,-60
40,109,48,303,100,108,-8
40,109,48,309,56,0,56
40,109,48,329,80,123,-43
40,109,48,339,138,180,-42
40,109,48,355,103,0,103
40,109,48,375,73,0,73
40,109,48,381,99,0,99
40,109,48,423,75,77,-2
40,109,48,439,707,823,-116
40,109,48,441,61,0,61
40,109,48,453,253,287,-34
40,109,48,485,155,132,23
40,109,48,491,95,110,-15
40,109,49,35,69,93,-24
40,109,51,59,74,99,-25
40,109,53,33,168,197,-29
40,109,53,53,77,86,-9
40,109,53,61,78,82,-4
40,109,55,79,0,51,-51
40,111,40,37,268,236,32
40,111,40,91,94,72,22
40,111,40,101,130,93,37
40,111,40,107,91,141,-50
40,111,40,109,74,118,-44
40,111,40,143,945,931,14
40,111,40,145,88,68,20
40,113,40,37,113,97,16
40,113,40,71,275,283,-8
40,113,40,109,75,78,-3
40,113,40,117,99,157,-58
40,113,40,131,161,142,19
40,113,40,143,2198,1975,223
40,113,40,145,83,0,83
40,113,40,147,279,449,-170
40,115,20,21,152,133,19
40,115,29,97,207,196,11
40,115,29,145,109,132,-23
40,115,40,35,137,145,-8
40,115,40,41,390,340,50
40,115,40,143,91,119,-28
40,117,40,37,260,154,106
40,117,40,113,157,99,58
40,117,40,119,137,152,-15
40,117,40,143,454,426,28
40,119,4,13,0,71,-71
40,119,40,17,83,114,-31
40,119,40,27,153,172,-19
40,119,40,37,255,212,43
40,119,40,47,114,106,8
40,119,40,71,183,117,66
40,119,40,81,335,293,42
40,119,40,83,152,222,-70
40,119,40,103,259,341,-82
40,119,40,109,463,880,-417
40,119,40,117,152,137,15
40,119,40,125,67,68,-1
40,119,40,131,50,87,-37
40,119,40,143,485,617,-132
40,119,48,113,0,121,-121
40,119,48,201,0,70,-70
40,119,48,439,0,51,-51
40,119,48,453,0,54,-54
40,121,40,27,63,86,-23
40,121,40,61,99,115,-16
40,121,40,63,99,0,99
40,121,40,77,177,114,63
40,121,40,79,0,75,-75
40,121,40,91,194,222,-28
40,121,40,109,130,171,-41
40,121,40,123,56,0,56
40,121,40,143,126,181,-55
40,123,40,19,85,0,85
40,123,40,27,104,194,-90
40,123,40,29,91,97,-6
40,123,40,49,137,184,-47
40,123,40,63,107,92,15
40,123,40,99,122,0,122
40,123,40,109,184,223,-39
40,123,40,121,0,56,-56
40,123,40,125,79,173,-94
40,123,40,133,174,198,-24
40,123,40,143,0,67,-67
40,123,48,113,0,58,-58
40,125,40,17,134,129,5
40,125,40,27,639,598,41
40,125,40,81,431,479,-48
40,125,40,87,75,0,75
40,125,40,109,1295,1218,77
40,125,40,119,68,67,1
40,125,40,123,173,79,94
40,125,40,133,503,519,-16
40,125,40,143,76,96,-20
40,127,40,23,174,86,88
40,129,40,9,0,89,-89
40,131,40,21,108,61,47
40,131,40,27,53,0,53
40,131,40,35,102,93,9
40,131,40,37,172,144,28
40,131,40,41,80,126,-46
40,131,40,97,509,438,71
40,131,40,105,124,69,55
40,131,40,109,114,171,-57
40,131,40,113,142,161,-19
40,131,40,119,87,50,37
40,131,40,143,4120,3510,610
40,131,40,145,582,589,-7
40,131,40,147,133,183,-50
40,133,40,27,71,50,21
40,133,40,63,137,158,-21
40,133,40,81,72,0,72
40,133,40,107,0,60,-60
40,133,40,109,141,182,-41
40,133,40,123,198,174,24
40,133,40,125,519,503,16
40,135,5,7,61,0,61
40,135,5,33,127,211,-84
40,135,5,131,548,540,8
40,135,40,1,96,0,96
40,135,40,21,116,107,9
40,135,40,79,126,217,-91
40,135,40,101,163,173,-10
40,135,40,143,83,105,-22
40,137,40,17,68,102,-34
40,137,40,19,97,111,-14
40,137,40,27,89,110,-21
40,137,40,31,301,254,47
40,137,40,51,177,189,-12
40,137,40,67,92,73,19
40,137,40,109,129,256,-127
40,139,19,193,0,50,-50
40,139,20,175,191,211,-20
40,139,40,109,0,65,-65
40,139,48,341,0,85,-85
40,141,40,31,97,79,18
40,141,40,65,78,0,78
40,143,4,13,303,433,-130
40,143,4,19,82,62,20
40,143,5,7,241,362,-121
40,143,5,119,167,109,58
40,143,5,131,175,134,41
40,143,5,143,205,207,-2
40,143,6,1,74,78,-4
40,143,6,19,111,0,111
40,143,6,37,394,277,117
40,143,6,59,150,125,25
40,143,6,65,131,73,58
40,143,6,67,96,78,18
40,143,6,71,94,96,-2
40,143,6,73,244,195,49
40,143,6,85,0,57,-57
40,143,8,1,102,0,102
40,143,8,5,127,144,-17
40,143,8,31,104,239,-135
40,143,8,35,74,86,-12
40,143,8,41,143,176,-33
40,143,8,59,78,99,-21
40,143,12,11,0,54,-54
40,143,12,31,74,66,8
40,143,12,57,0,97,-97
40,143,12,86,77,0,77
40,143,12,95,0,104,-104
40,143,12,99,54,0,54
40,143,12,103,0,69,-69
40,143,13,67,63,0,63
40,143,13,121,0,48,-48
40,143,13,135,0,57,-57
40,143,17,31,204,168,36
40,143,20,91,128,176,-48
40,143,20,125,95,63,32
40,143,20,173,276,293,-17
40,143,20,177,58,0,58
40,143,27,53,0,55,-55
40,143,29,77,140,104,36
40,143,29,95,188,212,-24
40,143,29,97,134,128,6
40,143,29,189,79,93,-14
40,143,29,510,51,0,51
40,143,31,55,0,72,-72
40,143,32,3,150,161,-11
40,143,35,1,55,80,-25
40,143,36,47,0,43,-43
40,143,36,61,64,86,-22
40,143,40,1,68,53,15
40,143,40,13,57,0,57
40,143,40,17,231,260,-29
40,143,40,21,407,301,106
40,143,40,27,519,601,-82
40,143,40,31,155,132,23
40,143,40,35,81,87,-6
40,143,40,37,3231,3215,16
40,143,40,41,209,280,-71
40,143,40,47,157,86,71
40,143,40,51,76,0,76
40,143,40,71,161,96,65
40,143,40,79,71,81,-10
40,143,40,81,74,97,-23
40,143,40,83,85,46,39
40,143,40,91,144,117,27
40,143,40,97,489,466,23
40,143,40,101,760,682,78
40,143,40,105,67,79,-12
40,143,40,107,76,0,76
40,143,40,109,1808,1751,57
40,143,40,111,931,945,-14
40,143,40,113,1975,2198,-223
40,143,40,115,119,91,28
40,143,40,117,426,454,-28
40,143,40,119,617,485,132
40,143,40,121,181,126,55
40,143,40,123,67,0,67
40,143,40,125,96,76,20
40,143,40,131,3510,4120,-610
40,143,40,135,105,83,22
40,143,40,145,3946,5236,-1290
40,143,40,147,776,686,90
40,143,41,51,0,78,-78
40,143,42,3,0,50,-50
40,143,47,37,0,62,-62
40,143,47,157,68,108,-40
40,143,48,27,114,81,33
40,143,48,29,166,211,-45
40,143,48,85,288,360,-72
40,143,48,113,555,667,-112
40,143,48,121,274,249,25
40,143,48,141,114,97,17
40,143,48,157,144,79,65
40,143,48,181,0,73,-73
40,143,48,201,561,718,-157
40,143,48,303,69,68,1
40,143,48,329,0,89,-89
40,143,48,339,88,108,-20
40,143,48,439,513,647,-134
40,143,48,453,147,198,-51
40,143,48,491,90,59,31
40,143,49,35,76,59,17
40,143,53,33,118,110,8
40,143,53,53,0,65,-65
40,145,40,21,188,147,41
40,145,40,27,0,68,-68
40,145,40,37,167,120,47
40,145,40,97,139,184,-45
40,145,40,101,651,538,113
40,145,40,109,134,119,15
40,145,40,111,68,88,-20
40,145,40,113,0,83,-83
40,145,40,131,589,582,7
40,145,40,143,5236,3946,1290
40,147,20,125,205,129,76
40,147,40,105,170,165,5
40,147,40,109,97,129,-32
40,147,40,113,449,279,170
40,147,40,131,183,133,50
40,147,40,143,686,776,-90
40,147,48,157,0,79,-79
40,147,48,201,0,152,-152
40,149,40,9,183,235,-52
40,149,40,17,0,96,-96
40,149,40,39,297,207,90
40,151,40,3,77,0,77
40,151,40,47,0,68,-68
40,151,40,109,0,60,-60
40,153,40,17,0,115,-115
40,153,40,43,0,68,-68
40,153,40,45,76,110,-34
40,153,40,59,59,0,59
40,153,40,109,0,147,-147
41,1,16,1,53,0,53
41,1,41,17,72,0,72
41,1,41,61,135,138,-3
41,3,4,13,76,122,-46
41,3,6,1,65,0,65
41,3,6,37,143,75,68
41,3,6,73,116,82,34
41,3,6,85,61,99,-38
41,3,16,1,0,78,-78
41,3,41,5,195,298,-103
41,3,41,17,216,286,-70
41,3,41,19,117,73,44
41,3,41,29,123,89,34
41,3,41,39,617,607,10
41,3,41,41,207,175,32
41,3,41,43,1519,2150,-631
41,3,41,47,359,474,-115
41,3,41,51,438,586,-148
41,3,41,53,322,295,27
41,3,41,67,249,497,-248
41,3,41,71,66,83,-17
41,3,53,11,70,121,-51
41,3,53,33,136,199,-63
41,5,2,20,53,0,53
41,5,4,13,393,684,-291
41,5,4,19,57,129,-72
41,5,4,21,0,93,-93
41,5,4,27,0,55,-55
41,5,6,1,275,90,185
41,5,6,7,57,0,57
41,5,6,13,174,78,96
41,5,6,19,57,0,57
41,5,6,37,697,294,403
41,5,6,41,65,0,65
41,5,6,59,299,177,122
41,5,6,65,217,145,72
41,5,6,67,128,103,25
41,5,6,71,136,60,76
41,5,6,73,367,222,145
41,5,6,75,123,0,123
41,5,6,81,124,0,124
41,5,6,85,380,144,236
41,5,6,97,65,0,65
41,5,6,111,121,0,121
41,5,8,5,64,0,64
41,5,8,31,59,56,3
41,5,8,41,73,63,10
41,5,12,95,61,0,61
41,5,15,3,188,88,100
41,5,15,9,0,117,-117
41,5,16,1,153,217,-64
41,5,16,27,0,110,-110
41,5,16,55,0,66,-66
41,5,17,31,79,72,7
41,5,26,125,58,0,58
41,5,30,29,0,74,-74
41,5,32,3,204,280,-76
41,5,32,31,102,99,3
41,5,41,3,298,195,103
41,5,41,7,137,186,-49
41,5,41,9,210,275,-65
41,5,41,11,82,80,2
41,5,41,13,0,168,-168
41,5,41,17,437,830,-393
41,5,41,19,113,143,-30
41,5,41,27,93,80,13
41,5,41,29,236,196,40
41,5,41,31,64,106,-42
41,5,41,33,89,69,20
41,5,41,35,0,74,-74
41,5,41,39,577,443,134
41,5,41,41,137,226,-89
41,5,41,43,225,297,-72
41,5,41,47,1889,2652,-763
41,5,41,51,15202,10374,4828
41,5,41,53,272,262,10
41,5,41,57,78,181,-103
41,5,41,59,0,75,-75
41,5,41,65,80,82,-2
41,5,41,67,5962,5340,622
41,5,41,71,543,739,-196
41,5,48,113,85,0,85
41,5,48,201,84,71,13
41,5,48,453,72,83,-11
41,5,49,35,149,127,22
41,5,49,49,0,99,-99
41,5,53,5,67,74,-7
41,5,53,11,1718,2540,-822
41,5,53,15,106,196,-90
41,5,53,33,539,523,16
41,5,53,35,54,58,-4
41,5,53,39,0,58,-58
41,5,53,41,0,73,-73
41,5,53,49,0,69,-69
41,5,53,53,167,202,-35
41,5,53,61,165,187,-22
41,5,53,63,117,191,-74
41,5,53,67,103,80,23
41,5,53,77,0,70,-70
41,7,4,13,67,0,67
41,7,6,37,68,0,68
41,7,6,73,55,0,55
41,7,41,5,186,137,49
41,7,41,9,145,105,40
41,7,41,17,73,105,-32
41,7,41,39,75,88,-13
41,7,41,47,0,56,-56
41,7,41,51,445,227,218
41,7,41,57,83,74,9
41,7,41,67,330,285,45
41,7,53,11,79,124,-45
41,7,53,15,89,63,26
41,7,53,33,104,73,31
41,7,53,49,118,219,-101
41,7,53,53,63,0,63
41,9,41,5,275,210,65
41,9,41,7,105,145,-40
41,9,41,17,0,68,-68
41,9,41,39,76,61,15
41,9,41,47,0,77,-77
41,9,41,51,991,486,505
41,9,41,67,1325,613,712
41,9,53,11,176,209,-33
41,9,53,15,255,393,-138
41,11,4,13,90,0,90
41,11,6,37,81,0,81
41,11,6,67,80,0,80
41,11,6,89,69,0,69
41,11,32,3,64,0,64
41,11,41,5,80,82,-2
41,11,41,15,104,105,-1
41,11,41,17,99,82,17
41,11,41,19,279,391,-112
41,11,41,29,195,157,38
41,11,41,33,67,0,67
41,11,41,35,80,0,80
41,11,41,39,356,441,-85
41,11,41,41,0,60,-60
41,11,41,43,0,65,-65
41,11,41,47,53,90,-37
41,11,41,51,138,83,55
41,11,41,67,86,95,-9
41,11,53,33,48,51,-3
41,13,41,5,168,0,168
41,13,41,17,958,594,364
41,13,41,31,145,158,-13
41,13,41,39,97,0,97
41,13,41,47,102,0,102
41,13,41,51,88,0,88
41,13,41,67,103,0,103
41,15,6,15,125,78,47
41,15,6,37,77,0,77
41,15,41,11,105,104,1
41,15,41,17,58,0,58
41,15,41,19,0,70,-70
41,15,41,29,134,104,30
41,15,41,33,85,60,25
41,15,41,39,0,139,-139
41,17,2,20,138,0,138
41,17,4,13,330,393,-63
41,17,4,19,63,140,-77
41,17,4,21,0,93,-93
41,17,4,25,0,88,-88
41,17,6,1,211,62,149
41,17,6,13,207,0,207
41,17,6,23,70,0,70
41,17,6,29,66,0,66
41,17,6,37,504,130,374
41,17,6,41,84,0,84
41,17,6,59,420,79,341
41,17,6,61,91,0,91
41,17,6,65,237,126,111
41,17,6,67,124,0,124
41,17,6,71,145,0,145
41,17,6,73,476,134,342
41,17,6,75,83,0,83
41,17,6,79,73,52,21
41,17,6,81,161,0,161
41,17,6,83,108,0,108
41,17,6,85,298,47,251
41,17,6,87,97,0,97
41,17,6,89,61,0,61
41,17,6,95,58,0,58
41,17,6,97,181,62,119
41,17,6,111,151,0,151
41,17,8,13,51,0,51
41,17,8,31,94,0,94
41,17,15,1,58,0,58
41,17,15,3,69,0,69
41,17,15,9,61,0,61
41,17,16,1,156,243,-87
41,17,16,27,52,73,-21
41,17,16,55,0,64,-64
41,17,17,31,55,0,55
41,17,32,3,216,181,35
41,17,32,31,70,92,-22
41,17,41,1,0,72,-72
41,17,41,3,286,216,70
41,17,41,5,830,437,393
41,17,41,7,105,73,32
41,17,41,9,68,0,68
41,17,41,11,82,99,-17
41,17,41,13,594,958,-364
41,17,41,15,0,58,-58
41,17,41,19,193,142,51
41,17,41,25,0,57,-57
41,17,41,27,58,0,58
41,17,41,29,324,306,18
41,17,41,31,548,744,-196
41,17,41,33,90,109,-19
41,17,41,35,241,287,-46
41,17,41,37,0,64,-64
41,17,41,39,779,599,180
41,17,41,41,116,179,-63
41,17,41,43,270,225,45
41,17,41,47,546,390,156
41,17,41,51,1184,660,524
41,17,41,53,162,116,46
41,17,41,57,62,0,62
41,17,41,59,72,73,-1
41,17,41,61,51,0,51
41,17,41,65,65,75,-10
41,17,41,67,893,453,440
41,17,41,71,202,147,55
41,17,48,453,93,82,11
41,17,49,35,85,83,2
41,17,53,5,63,56,7
41,17,53,11,385,278,107
41,17,53,15,71,0,71
41,17,53,33,661,203,458
41,17,53,35,78,0,78
41,17,53,53,165,97,68
41,17,53,61,144,0,144
41,17,53,63,87,108,-21
41,17,53,67,72,57,15
41,17,53,73,75,0,75
41,19,4,13,97,115,-18
41,19,6,37,137,0,137
41,19,6,59,58,0,58
41,19,6,65,89,0,89
41,19,6,67,112,0,112
41,19,6,71,76,0,76
41,19,6,73,87,53,34
41,19,6,85,56,0,56
41,19,6,89,52,0,52
41,19,32,3,77,80,-3
41,19,41,3,73,117,-44
41,19,41,5,143,113,30
41,19,41,11,391,279,112
41,19,41,15,70,0,70
41,19,41,17,142,193,-51
41,19,41,29,324,259,65
41,19,41,33,236,227,9
41,19,41,35,141,81,60
41,19,41,39,860,875,-15
41,19,41,41,59,0,59
41,19,41,43,146,104,42
41,19,41,47,111,137,-26
41,19,41,51,186,192,-6
41,19,41,67,127,121,6
41,19,53,11,0,80,-80
41,19,53,33,70,66,4
41,19,53,53,59,61,-2
41,25,41,17,57,0,57
41,27,41,5,80,93,-13
41,27,41,17,0,58,-58
41,27,41,51,353,244,109
41,27,41,65,216,397,-181
41,27,41,67,93,76,17
41,27,53,11,0,83,-83
41,27,53,33,56,0,56
41,27,53,39,178,194,-16
41,27,53,59,0,85,-85
41,29,2,20,68,0,68
41,29,4,13,166,297,-131
41,29,4,19,60,86,-26
41,29,6,1,224,63,161
41,29,6,7,88,66,22
41,29,6,13,162,54,108
41,29,6,15,84,0,84
41,29,6,19,0,55,-55
41,29,6,23,149,0,149
41,29,6,37,503,249,254
41,29,6,41,73,0,73
41,29,6,53,0,55,-55
41,29,6,59,176,109,67
41,29,6,61,104,0,104
41,29,6,65,170,78,92
41,29,6,67,185,139,46
41,29,6,71,155,0,155
41,29,6,73,277,121,156
41,29,6,79,60,0,60
41,29,6,81,113,0,113
41,29,6,83,53,0,53
41,29,6,85,279,61,218
41,29,6,87,98,0,98
41,29,6,89,144,85,59
41,29,6,93,231,145,86
41,29,6,95,78,0,78
41,29,6,97,197,55,142
41,29,6,99,54,0,54
41,29,6,111,72,55,17
41,29,15,3,0,62,-62
41,29,16,1,61,91,-30
41,29,17,31,58,0,58
41,29,32,3,163,190,-27
41,29,32,31,76,84,-8
41,29,41,3,89,123,-34
41,29,41,5,196,236,-40
41,29,41,11,157,195,-38
41,29,41,15,104,134,-30
41,29,41,17,306,324,-18
41,29,41,19,259,324,-65
41,29,41,33,1537,1397,140
41,29,41,35,408,404,4
41,29,41,39,503,614,-111
41,29,41,41,0,69,-69
41,29,41,43,74,129,-55
41,29,41,47,176,214,-38
41,29,41,51,447,539,-92
41,29,41,53,79,0,79
41,29,41,67,284,329,-45
41,29,41,71,0,56,-56
41,29,49,35,100,0,100
41,29,53,11,92,147,-55
41,29,53,33,227,143,84
41,29,53,53,79,110,-31
41,29,53,61,77,0,77
41,29,53,63,0,64,-64
41,29,53,67,0,79,-79
41,31,41,5,106,64,42
41,31,41,13,158,145,13
41,31,41,17,744,548,196
41,31,41,47,112,0,112
41,31,41,51,115,67,48
41,31,41,67,98,0,98
41,33,4,13,98,109,-11
41,33,6,1,61,0,61
41,33,6,7,70,0,70
41,33,6,23,54,0,54
41,33,6,37,205,72,133
41,33,6,59,101,0,101
41,33,6,65,85,57,28
41,33,6,67,76,0,76
41,33,6,73,114,63,51
41,33,6,85,92,0,92
41,33,6,89,67,0,67
41,33,6,97,86,0,86
41,33,6,111,62,0,62
41,33,32,3,62,48,14
41,33,41,5,69,89,-20
41,33,41,11,0,67,-67
41,33,41,15,60,85,-25
41,33,41,17,109,90,19
41,33,41,19,227,236,-9
41,33,41,29,1397,1537,-140
41,33,41,35,100,90,10
41,33,41,39,163,203,-40
41,33,41,43,73,0,73
41,33,41,47,77,87,-10
41,33,41,51,101,143,-42
41,33,41,67,90,80,10
41,33,53,33,51,0,51
41,35,4,13,0,85,-85
41,35,6,37,78,0,78
41,35,6,49,78,0,78
41,35,6,65,66,0,66
41,35,6,67,54,0,54
41,35,6,73,87,0,87
41,35,6,89,95,60,35
41,35,6,93,179,134,45
41,35,32,3,77,0,77
41,35,41,5,74,0,74
41,35,41,11,0,80,-80
41,35,41,17,287,241,46
41,35,41,19,81,141,-60
41,35,41,29,404,408,-4
41,35,41,33,90,100,-10
41,35,41,37,79,0,79
41,35,41,39,171,245,-74
41,35,41,43,67,92,-25
41,35,41,47,117,97,20
41,35,41,51,111,111,0
41,35,41,67,74,145,-71
41,35,53,33,60,50,10
41,37,41,17,64,0,64
41,37,41,35,0,79,-79
41,39,2,20,89,56,33
41,39,4,13,393,440,-47
41,39,4,19,94,126,-32
41,39,4,25,72,0,72
41,39,6,1,236,90,146
41,39,6,7,101,67,34
41,39,6,13,167,99,68
41,39,6,19,77,0,77
41,39,6,23,84,0,84
41,39,6,29,116,0,116
41,39,6,37,619,300,319
41,39,6,41,50,0,50
41,39,6,53,66,0,66
41,39,6,59,341,192,149
41,39,6,61,76,0,76
41,39,6,65,224,139,85
41,39,6,67,216,80,136
41,39,6,71,178,71,107
41,39,6,73,399,208,191
41,39,6,75,79,0,79
41,39,6,77,57,0,57
41,39,6,79,88,0,88
41,39,6,81,101,50,51
41,39,6,83,55,0,55
41,39,6,85,253,108,145
41,39,6,87,77,0,77
41,39,6,89,102,82,20
41,39,6,97,138,72,66
41,39,6,99,77,0,77
41,39,6,111,140,0,140
41,39,8,1,0,57,-57
41,39,8,13,0,53,-53
41,39,8,31,56,54,2
41,39,8,41,95,61,34
41,39,15,1,50,55,-5
41,39,15,3,134,105,29
41,39,16,1,102,187,-85
41,39,16,27,79,65,14
41,39,17,31,127,86,41
41,39,27,53,46,0,46
41,39,30,63,77,0,77
41,39,32,3,231,217,14
41,39,32,31,119,86,33
41,39,35,1,59,0,59
41,39,36,47,53,0,53
41,39,41,3,607,617,-10
41,39,41,5,443,577,-134
41,39,41,7,88,75,13
41,39,41,9,61,76,-15
41,39,41,11,441,356,85
41,39,41,13,0,97,-97
41,39,41,15,139,0,139
41,39,41,17,599,779,-180
41,39,41,19,875,860,15
41,39,41,29,614,503,111
41,39,41,33,203,163,40
41,39,41,35,245,171,74
41,39,41,41,274,236,38
41,39,41,43,936,1272,-336
41,39,41,47,728,737,-9
41,39,41,51,1171,1507,-336
41,39,41,53,199,188,11
41,39,41,57,58,0,58
41,39,41,59,81,76,5
41,39,41,67,731,839,-108
41,39,41,71,127,145,-18
41,39,48,29,60,0,60
41,39,48,201,87,0,87
41,39,48,439,47,0,47
41,39,48,453,95,86,9
41,39,49,35,162,113,49
41,39,53,11,268,391,-123
41,39,53,33,436,402,34
41,39,53,35,81,61,20
41,39,53,53,213,186,27
41,39,53,61,151,117,34
41,39,53,63,84,199,-115
41,39,53,67,76,119,-43
41,39,53,73,0,61,-61
41,39,55,25,66,0,66
41,41,4,13,79,88,-9
41,41,6,37,99,0,99
41,41,6,67,54,0,54
41,41,6,73,78,0,78
41,41,16,1,83,0,83
41,41,32,3,53,0,53
41,41,41,3,175,207,-32
41,41,41,5,226,137,89
41,41,41,11,60,0,60
41,41,41,17,179,116,63
41,41,41,19,0,59,-59
41,41,41,29,69,0,69
41,41,41,39,236,274,-38
41,41,41,43,172,175,-3
41,41,41,47,215,272,-57
41,41,41,51,317,147,170
41,41,41,53,92,161,-69
41,41,41,57,68,93,-25
41,41,41,67,263,200,63
41,41,41,71,123,89,34
41,41,53,11,87,104,-17
41,41,53,33,78,0,78
41,43,4,13,105,111,-6
41,43,6,37,135,0,135
41,43,6,65,93,0,93
41,43,6,71,63,0,63
41,43,6,73,69,0,69
41,43,6,85,57,0,57
41,43,32,3,58,0,58
41,43,32,31,54,0,54
41,43,41,3,2150,1519,631
41,43,41,5,297,225,72
41,43,41,11,65,0,65
41,43,41,17,225,270,-45
41,43,41,19,104,146,-42
41,43,41,29,129,74,55
41,43,41,33,0,73,-73
41,43,41,35,92,67,25
41,43,41,39,1272,936,336
41,43,41,41,175,172,3
41,43,41,47,1880,1414,466
41,43,41,51,338,214,124
41,43,41,53,402,272,130
41,43,41,59,69,0,69
41,43,41,67,279,247,32
41,43,41,71,110,68,42
41,43,53,11,137,133,4
41,43,53,33,86,71,15
41,43,53,53,80,56,24
41,43,53,61,60,0,60
41,45,16,1,179,177,2
41,45,16,27,288,265,23
41,45,16,75,465,481,-16
41,45,16,87,102,0,102
41,47,2,20,81,0,81
41,47,4,13,223,328,-105
41,47,4,19,84,82,2
41,47,6,1,76,0,76
41,47,6,13,68,0,68
41,47,6,19,60,0,60
41,47,6,29,74,0,74
41,47,6,37,422,164,258
41,47,6,59,149,69,80
41,47,6,65,126,120,6
41,47,6,67,163,87,76
41,47,6,71,162,63,99
41,47,6,73,259,148,111
41,47,6,81,65,0,65
41,47,6,85,116,0,116
41,47,6,97,91,0,91
41,47,6,111,146,0,146
41,47,15,3,129,69,60
41,47,16,1,104,130,-26
41,47,16,27,0,79,-79
41,47,32,3,160,182,-22
41,47,32,31,72,61,11
41,47,41,3,474,359,115
41,47,41,5,2652,1889,763
41,47,41,7,56,0,56
41,47,41,9,77,0,77
41,47,41,11,90,53,37
41,47,41,13,0,102,-102
41,47,41,17,390,546,-156
41,47,41,19,137,111,26
41,47,41,29,214,176,38
41,47,41,31,0,112,-112
41,47,41,33,87,77,10
41,47,41,35,97,117,-20
41,47,41,39,737,728,9
41,47,41,41,272,215,57
41,47,41,43,1414,1880,-466
41,47,41,51,1551,1296,255
41,47,41,53,3526,3505,21
41,47,41,57,78,92,-14
41,47,41,59,119,84,35
41,47,41,67,1991,1426,565
41,47,41,71,713,660,53
41,47,49,35,72,0,72
41,47,53,11,390,499,-109
41,47,53,15,0,79,-79
41,47,53,33,240,217,23
41,47,53,35,0,59,-59
41,47,53,53,115,144,-29
41,47,53,61,120,114,6
41,47,53,63,81,137,-56
41,47,53,67,76,90,-14
41,47,53,77,61,0,61
41,49,41,59,407,437,-30
41,49,53,5,69,0,69
41,51,2,20,204,140,64
41,51,2,90,49,0,49
41,51,4,5,57,0,57
41,51,4,13,881,882,-1
41,51,4,15,0,50,-50
41,51,4,19,209,284,-75
41,51,4,21,0,67,-67
41,51,4,25,50,50,0
41,51,6,1,958,479,479
41,51,6,7,89,0,89
41,51,6,13,312,163,149
41,51,6,19,134,72,62
41,51,6,23,133,59,74
41,51,6,29,102,51,51
41,51,6,37,2016,1371,645
41,51,6,41,177,55,122
41,51,6,53,100,48,52
41,51,6,55,47,0,47
41,51,6,59,720,371,349
41,51,6,61,123,0,123
41,51,6,65,293,316,-23
41,51,6,67,350,273,77
41,51,6,71,207,173,34
41,51,6,73,1041,668,373
41,51,6,75,1056,497,559
41,51,6,77,83,71,12
41,51,6,79,149,86,63
41,51,6,81,372,145,227
41,51,6,83,203,86,117
41,51,6,85,727,407,320
41,51,6,87,182,93,89
41,51,6,89,69,0,69
41,51,6,95,63,0,63
41,51,6,97,301,121,180
41,51,6,99,54,0,54
41,51,6,111,176,145,31
41,51,6,113,68,0,68
41,51,8,1,51,46,5
41,51,8,5,107,121,-14
41,51,8,13,140,125,15
41,51,8,31,320,385,-65
41,51,8,35,57,0,57
41,51,8,41,113,101,12
41,51,8,59,98,84,14
41,51,8,69,120,65,55
41,51,9,1,72,0,72
41,51,9,3,58,0,58
41,51,9,9,89,0,89
41,51,11,1,244,151,93
41,51,12,1,55,0,55
41,51,12,11,94,76,18
41,51,12,31,64,0,64
41,51,12,57,95,106,-11
41,51,12,71,54,0,54
41,51,12,86,117,101,16
41,51,12,95,111,75,36
41,51,12,99,85,63,22
41,51,12,103,79,128,-49
41,51,12,115,51,0,51
41,51,13,89,85,58,27
41,51,13,121,199,93,106
41,51,15,1,151,142,9
41,51,15,3,458,216,242
41,51,15,9,81,113,-32
41,51,16,1,292,432,-140
41,51,16,27,70,144,-74
41,51,16,55,53,65,-12
41,51,17,19,45,0,45
41,51,17,31,769,449,320
41,51,17,43,73,62,11
41,51,17,89,53,0,53
41,51,18,97,70,66,4
41,51,18,141,59,0,59
41,51,19,153,58,69,-11
41,51,20,91,48,0,48
41,51,21,111,59,0,59
41,51,22,71,103,74,29
41,51,23,5,62,65,-3
41,51,24,3,51,0,51
41,51,24,5,61,0,61
41,51,24,31,116,0,116
41,51,24,510,87,75,12
41,51,25,9,75,0,75
41,51,25,15,48,0,48
41,51,25,17,240,189,51
41,51,25,21,87,0,87
41,51,25,25,176,119,57
41,51,26,81,91,74,17
41,51,26,125,125,68,57
41,51,26,161,137,74,63
41,51,26,163,67,70,-3
41,51,27,53,315,259,56
41,51,27,123,88,65,23
41,51,29,95,94,54,40
41,51,29,189,77,0,77
41,51,29,510,62,0,62
41,51,30,29,0,53,-53
41,51,30,31,111,83,28
41,51,30,63,123,91,32
41,51,31,55,58,68,-10
41,51,32,3,459,584,-125
41,51,32,31,186,129,57
41,51,34,3,55,0,55
41,51,34,17,58,0,58
41,51,35,1,153,193,-40
41,51,35,49,77,106,-29
41,51,36,29,61,67,-6
41,51,36,47,630,390,240
41,51,36,55,66,0,66
41,51,36,61,364,306,58
41,51,36,67,53,0,53
41,51,36,81,212,145,67
41,51,36,103,49,0,49
41,51,36,119,65,0,65
41,51,37,21,59,0,59
41,51,37,63,68,0,68
41,51,37,119,126,95,31
41,51,37,183,88,54,34
41,51,39,35,76,90,-14
41,51,39,49,183,144,39
41,51,39,61,94,58,36
41,51,40,109,76,0,76
41,51,40,143,78,0,78
41,51,41,3,586,438,148
41,51,41,5,10374,15202,-4828
41,51,41,7,227,445,-218
41,51,41,9,486,991,-505
41,51,41,11,83,138,-55
41,51,41,13,0,88,-88
41,51,41,17,660,1184,-524
41,51,41,19,192,186,6
41,51,41,27,244,353,-109
41,51,41,29,539,447,92
41,51,41,31,67,115,-48
41,51,41,33,143,101,42
41,51,41,35,111,111,0
41,51,41,39,1507,1171,336
41,51,41,41,147,317,-170
41,51,41,43,214,338,-124
41,51,41,47,1296,1551,-255
41,51,41,53,253,279,-26
41,51,41,57,171,311,-140
41,51,41,59,132,138,-6
41,51,41,61,0,53,-53
41,51,41,65,154,211,-57
41,51,41,67,10697,11865,-1168
41,51,41,71,490,563,-73
41,51,42,3,106,101,5
41,51,42,101,199,132,67
41,51,44,7,47,0,47
41,51,45,19,75,0,75
41,51,45,83,0,116,-116
41,51,47,37,164,106,58
41,51,48,29,128,124,4
41,51,48,85,60,55,5
41,51,48,113,216,159,57
41,51,48,121,62,0,62
41,51,48,201,311,236,75
41,51,48,439,152,117,35
41,51,48,453,384,315,69
41,51,48,491,0,82,-82
41,51,49,35,357,272,85
41,51,49,49,106,69,37
41,51,50,7,71,52,19
41,51,51,13,66,0,66
41,51,51,59,130,50,80
41,51,51,760,50,0,50
41,51,53,5,97,129,-32
41,51,53,9,0,100,-100
41,51,53,11,4722,7852,-3130
41,51,53,15,273,540,-267
41,51,53,31,0,60,-60
41,51,53,33,2251,1986,265
41,51,53,35,132,140,-8
41,51,53,39,57,172,-115
41,51,53,41,47,73,-26
41,51,53,49,0,96,-96
41,51,53,53,422,477,-55
41,51,53,59,59,104,-45
41,51,53,61,305,218,87
41,51,53,63,217,440,-223
41,51,53,67,254,255,-1
41,51,53,71,68,71,-3
41,51,53,73,181,181,0
41,51,53,77,86,82,4
41,51,55,25,172,101,71
41,51,55,79,160,71,89
41,53,4,13,112,65,47
41,53,6,37,90,0,90
41,53,6,59,69,0,69
41,53,6,73,58,0,58
41,53,32,3,70,0,70
41,53,41,3,295,322,-27
41,53,41,5,262,272,-10
41,53,41,17,116,162,-46
41,53,41,29,0,79,-79
41,53,41,39,188,199,-11
41,53,41,41,161,92,69
41,53,41,43,272,402,-130
41,53,41,47,3505,3526,-21
41,53,41,51,279,253,26
41,53,41,67,360,291,69
41,53,41,71,760,552,208
41,53,53,11,78,108,-30
41,53,53,33,67,62,5
41,57,41,5,181,78,103
41,57,41,7,74,83,-9
41,57,41,17,0,62,-62
41,57,41,39,0,58,-58
41,57,41,41,93,68,25
41,57,41,47,92,78,14
41,57,41,51,311,171,140
41,57,41,67,237,199,38
41,57,41,71,65,62,3
41,57,53,11,0,77,-77
41,59,16,1,59,57,2
41,59,41,5,75,0,75
41,59,41,17,73,72,1
41,59,41,39,76,81,-5
41,59,41,43,0,69,-69
41,59,41,47,84,119,-35
41,59,41,49,437,407,30
41,59,41,51,138,132,6
41,59,41,61,164,155,9
41,59,41,67,104,92,12
41,59,53,5,315,390,-75
41,59,53,11,78,0,78
41,59,53,21,92,112,-20
41,59,53,33,65,65,0
41,59,53,63,69,95,-26
41,59,53,71,422,472,-50
41,59,53,77,0,77,-77
41,61,16,1,0,78,-78
41,61,41,1,138,135,3
41,61,41,17,0,51,-51
41,61,41,51,53,0,53
41,61,41,59,155,164,-9
41,65,41,5,82,80,2
41,65,41,17,75,65,10
41,65,41,27,397,216,181
41,65,41,51,211,154,57
41,65,41,67,92,69,23
41,65,53,11,0,98,-98
41,65,53,39,194,267,-73
41,67,2,20,145,89,56
41,67,4,13,981,1413,-432
41,67,4,19,182,169,13
41,67,4,21,71,123,-52
41,67,4,25,0,55,-55
41,67,6,1,454,209,245
41,67,6,13,251,154,97
41,67,6,19,90,0,90
41,67,6,29,97,0,97
41,67,6,37,1322,608,714
41,67,6,53,77,0,77
41,67,6,59,724,279,445
41,67,6,61,70,72,-2
41,67,6,65,379,257,122
41,67,6,67,337,250,87
41,67,6,71,210,130,80
41,67,6,73,644,509,135
41,67,6,75,133,117,16
41,67,6,77,117,0,117
41,67,6,79,68,53,15
41,67,6,81,200,93,107
41,67,6,83,122,0,122
41,67,6,85,939,699,240
41,67,6,87,82,0,82
41,67,6,89,45,53,-8
41,67,6,95,76,0,76
41,67,6,97,129,52,77
41,67,6,111,161,72,89
41,67,8,1,0,80,-80
41,67,8,5,95,135,-40
41,67,8,31,83,88,-5
41,67,8,35,0,66,-66
41,67,8,41,83,101,-18
41,67,8,59,107,75,32
41,67,8,69,108,55,53
41,67,12,1,84,0,84
41,67,12,11,73,0,73
41,67,12,55,0,62,-62
41,67,12,57,71,99,-28
41,67,12,86,62,0,62
41,67,12,95,59,0,59
41,67,12,99,57,56,1
41,67,12,103,0,51,-51
41,67,13,121,77,78,-1
41,67,15,1,63,64,-1
41,67,15,3,375,169,206
41,67,15,9,114,74,40
41,67,16,1,205,405,-200
41,67,16,27,63,151,-88
41,67,16,55,71,108,-37
41,67,17,19,63,0,63
41,67,17,31,334,120,214
41,67,17,43,61,0,61
41,67,20,91,79,0,79
41,67,24,31,60,0,60
41,67,25,17,112,80,32
41,67,26,125,76,64,12
41,67,26,161,53,0,53
41,67,26,163,57,0,57
41,67,27,53,149,113,36
41,67,30,63,51,0,51
41,67,32,3,410,488,-78
41,67,32,31,116,91,25
41,67,34,3,51,0,51
41,67,35,1,99,118,-19
41,67,36,29,48,0,48
41,67,36,47,118,46,72
41,67,36,61,83,53,30
41,67,36,81,59,0,59
41,67,37,119,114,68,46
41,67,37,183,107,65,42
41,67,39,49,100,74,26
41,67,40,109,52,0,52
41,67,41,3,497,249,248
41,67,41,5,5340,5962,-622
41,67,41,7,285,330,-45
41,67,41,9,613,1325,-712
41,67,41,11,95,86,9
41,67,41,13,0,103,-103
41,67,41,17,453,893,-440
41,67,41,19,121,127,-6
41,67,41,27,76,93,-17
41,67,41,29,329,284,45
41,67,41,31,0,98,-98
41,67,41,33,80,90,-10
41,67,41,35,145,74,71
41,67,41,39,839,731,108
41,67,41,41,200,263,-63
41,67,41,43,247,279,-32
41,67,41,47,1426,1991,-565
41,67,41,51,11865,10697,1168
41,67,41,53,291,360,-69
41,67,41,57,199,237,-38
41,67,41,59,92,104,-12
41,67,41,65,69,92,-23
41,67,41,71,1596,2602,-1006
41,67,42,3,85,0,85
41,67,47,37,0,55,-55
41,67,48,29,177,109,68
41,67,48,41,60,0,60
41,67,48,85,124,148,-24
41,67,48,113,188,158,30
41,67,48,121,72,0,72
41,67,48,141,86,0,86
41,67,48,201,226,130,96
41,67,48,439,115,88,27
41,67,48,453,210,298,-88
41,67,48,491,73,133,-60
41,67,49,35,240,232,8
41,67,49,49,159,167,-8
41,67,51,59,107,0,107
41,67,53,5,83,114,-31
41,67,53,11,2001,2931,-930
41,67,53,15,168,216,-48
41,67,53,33,1089,1240,-151
41,67,53,35,123,138,-15
41,67,53,41,0,63,-63
41,67,53,53,331,359,-28
41,67,53,61,312,352,-40
41,67,53,63,195,239,-44
41,67,53,67,159,163,-4
41,67,53,73,70,0,70
41,67,53,77,81,71,10
41,67,55,25,64,0,64
41,67,55,79,49,0,49
41,71,4,13,83,66,17
41,71,6,37,106,0,106
41,71,6,73,77,0,77
41,71,6,85,59,0,59
41,71,41,3,83,66,17
41,71,41,5,739,543,196
41,71,41,17,147,202,-55
41,71,41,29,56,0,56
41,71,41,39,145,127,18
41,71,41,41,89,123,-34
41,71,41,43,68,110,-42
41,71,41,47,660,713,-53
41,71,41,51,563,490,73
41,71,41,53,552,760,-208
41,71,41,57,62,65,-3
41,71,41,67,2602,1596,1006
41,71,53,11,144,148,-4
41,71,53,33,112,80,32
41,71,53,53,59,0,59
42,1,24,3,84,69,15
42,1,24,5,196,95,101
42,1,24,13,553,295,258
42,1,24,21,367,272,95
42,1,24,31,104,0,104
42,1,24,43,103,0,103
42,1,42,41,367,497,-130
42,1,42,43,131,122,9
42,1,42,55,399,499,-100
42,1,42,71,103,108,-5
42,1,42,101,0,45,-45
42,1,42,133,2625,2158,467
42,3,4,13,382,500,-118
42,3,4,19,75,109,-34
42,3,6,1,185,212,-27
42,3,6,13,116,84,32
42,3,6,37,624,644,-20
42,3,6,59,114,155,-41
42,3,6,65,61,69,-8
42,3,6,67,0,60,-60
42,3,6,71,59,78,-19
42,3,6,73,296,314,-18
42,3,6,75,126,267,-141
42,3,6,81,66,148,-82
42,3,6,85,231,635,-404
42,3,8,5,83,57,26
42,3,8,13,72,80,-8
42,3,8,31,121,221,-100
42,3,8,41,103,83,20
42,3,8,59,0,104,-104
42,3,8,69,0,47,-47
42,3,9,1,130,89,41
42,3,9,3,139,109,30
42,3,9,9,118,71,47
42,3,10,3,114,118,-4
42,3,10,5,0,68,-68
42,3,11,1,295,320,-25
42,3,12,9,94,120,-26
42,3,12,11,211,288,-77
42,3,12,21,74,167,-93
42,3,12,31,127,187,-60
42,3,12,57,173,242,-69
42,3,12,69,0,56,-56
42,3,12,71,120,271,-151
42,3,12,81,60,168,-108
42,3,12,86,173,216,-43
42,3,12,95,194,287,-93
42,3,12,97,0,54,-54
42,3,12,99,234,270,-36
42,3,12,101,69,131,-62
42,3,12,103,187,316,-129
42,3,12,105,62,71,-9
42,3,12,109,0,91,-91
42,3,12,111,0,65,-65
42,3,12,115,46,176,-130
42,3,12,117,0,75,-75
42,3,12,119,0,71,-71
42,3,12,127,81,138,-57
42,3,13,67,120,105,15
42,3,13,89,178,173,5
42,3,13,121,216,279,-63
42,3,13,135,77,123,-46
42,3,15,3,76,91,-15
42,3,17,31,561,603,-42
42,3,17,43,95,97,-2
42,3,18,57,61,0,61
42,3,18,97,95,101,-6
42,3,20,91,59,71,-12
42,3,21,67,66,0,66
42,3,21,111,107,73,34
42,3,22,71,76,51,25
42,3,24,3,129,131,-2
42,3,24,5,169,131,38
42,3,24,21,73,81,-8
42,3,24,27,92,71,21
42,3,24,31,345,307,38
42,3,24,33,158,152,6
42,3,24,510,183,142,41
42,3,25,9,53,0,53
42,3,25,17,346,334,12
42,3,25,21,137,119,18
42,3,25,25,194,199,-5
42,3,25,27,87,70,17
42,3,26,81,54,80,-26
42,3,26,125,131,174,-43
42,3,26,161,126,111,15
42,3,26,163,126,162,-36
42,3,27,53,136,150,-14
42,3,29,95,47,0,47
42,3,29,189,88,77,11
42,3,29,510,0,49,-49
42,3,32,3,188,303,-115
42,3,32,31,0,69,-69
42,3,34,3,96,68,28
42,3,34,5,60,67,-7
42,3,34,7,53,60,-7
42,3,34,13,119,0,119
42,3,34,17,183,235,-52
42,3,34,21,53,60,-7
42,3,34,23,176,172,4
42,3,34,25,46,0,46
42,3,34,27,113,99,14
42,3,34,35,52,58,-6
42,3,34,39,0,68,-68
42,3,35,1,0,71,-71
42,3,36,1,58,0,58
42,3,36,5,75,0,75
42,3,36,13,51,0,51
42,3,36,29,222,156,66
42,3,36,47,455,307,148
42,3,36,55,196,175,21
42,3,36,59,122,55,67
42,3,36,61,441,471,-30
42,3,36,67,124,67,57
42,3,36,81,273,162,111
42,3,36,103,98,79,19
42,3,36,119,109,70,39
42,3,37,21,0,47,-47
42,3,37,51,61,51,10
42,3,37,63,74,119,-45
42,3,37,67,0,59,-59
42,3,37,81,92,89,3
42,3,37,119,339,468,-129
42,3,37,129,0,80,-80
42,3,37,133,73,51,22
42,3,37,135,52,0,52
42,3,37,183,228,291,-63
42,3,39,17,0,58,-58
42,3,39,29,89,112,-23
42,3,39,35,506,483,23
42,3,39,41,0,70,-70
42,3,39,49,451,608,-157
42,3,39,61,156,147,9
42,3,39,81,158,120,38
42,3,39,85,59,74,-15
42,3,39,93,56,58,-2
42,3,39,95,68,52,16
42,3,39,99,229,192,37
42,3,39,103,0,63,-63
42,3,39,113,79,62,17
42,3,39,133,96,0,96
42,3,39,151,113,120,-7
42,3,39,153,213,169,44
42,3,39,155,123,97,26
42,3,40,143,50,0,50
42,3,41,51,101,106,-5
42,3,41,67,0,85,-85
42,3,42,5,553,540,13
42,3,42,7,2459,3151,-692
42,3,42,9,44,84,-40
42,3,42,11,114,68,46
42,3,42,13,205,155,50
42,3,42,17,122,142,-20
42,3,42,19,2921,4612,-1691
42,3,42,21,418,207,211
42,3,42,27,305,184,121
42,3,42,29,197,192,5
42,3,42,31,138,106,32
42,3,42,33,137,80,57
42,3,42,39,204,238,-34
42,3,42,41,263,164,99
42,3,42,43,236,228,8
42,3,42,45,120,135,-15
42,3,42,47,62,0,62
42,3,42,49,757,448,309
42,3,42,51,551,492,59
42,3,42,55,69,58,11
42,3,42,59,104,56,48
42,3,42,61,56,0,56
42,3,42,63,358,256,102
42,3,42,65,115,87,28
42,3,42,69,85,0,85
42,3,42,71,197,208,-11
42,3,42,73,369,352,17
42,3,42,77,95,135,-40
42,3,42,79,111,77,34
42,3,42,81,96,0,96
42,3,42,83,82,58,24
42,3,42,85,405,309,96
42,3,42,89,59,0,59
42,3,42,91,292,322,-30
42,3,42,95,57,0,57
42,3,42,101,524,650,-126
42,3,42,111,157,167,-10
42,3,42,121,152,137,15
42,3,42,123,65,0,65
42,3,42,125,3542,4941,-1399
42,3,42,129,4979,6512,-1533
42,3,42,133,179,171,8
42,3,44,7,85,61,24
42,3,45,13,0,114,-114
42,3,45,15,0,73,-73
42,3,45,19,104,153,-49
42,3,45,45,0,97,-97
42,3,45,51,81,216,-135
42,3,45,79,83,94,-11
42,3,45,91,0,79,-79
42,3,47,37,109,188,-79
42,3,47,157,117,81,36
42,3,48,27,58,0,58
42,3,48,29,116,127,-11
42,3,48,85,107,108,-1
42,3,48,113,215,188,27
42,3,48,121,77,91,-14
42,3,48,157,107,58,49
42,3,48,201,602,403,199
42,3,48,439,143,157,-14
42,3,48,453,167,263,-96
42,3,48,491,0,75,-75
42,3,49,35,128,108,20
42,3,51,13,230,176,54
42,3,51,59,329,340,-11
42,3,51,87,91,52,39
42,3,51,107,110,93,17
42,3,51,153,118,90,28
42,3,51,510,117,98,19
42,3,51,760,0,73,-73
42,3,51,810,92,102,-10
42,3,53,33,301,567,-266
42,3,53,53,59,62,-3
42,3,53,61,0,53,-53
42,3,54,9,102,64,38
42,3,54,29,131,191,-60
42,3,54,33,53,0,53
42,3,54,39,74,0,74
42,3,54,49,81,0,81
42,3,54,61,355,161,194
42,3,54,69,130,96,34
42,3,55,25,114,85,29
42,3,55,79,79,75,4
42,5,42,3,540,553,-13
42,5,42,19,451,471,-20
42,5,42,31,227,182,45
42,5,42,63,239,311,-72
42,5,42,65,75,0,75
42,5,42,129,724,764,-40
42,7,4,13,0,56,-56
42,7,39,29,172,340,-168
42,7,39,49,0,59,-59
42,7,39,99,65,169,-104
42,7,42,3,3151,2459,692
42,7,42,19,842,855,-13
42,7,42,49,82,58,24
42,7,42,73,697,805,-108
42,7,42,85,0,74,-74
42,7,42,125,204,208,-4
42,7,42,129,115,162,-47
42,7,45,51,0,62,-62
42,7,48,201,118,0,118
42,7,54,29,0,82,-82
42,9,24,1,78,111,-33
42,9,42,3,84,44,40
42,9,42,13,451,365,86
42,9,42,21,59,68,-9
42,9,42,55,0,57,-57
42,9,42,57,76,87,-11
42,9,42,61,114,98,16
42,9,42,111,110,105,5
42,11,4,13,0,104,-104
42,11,6,37,55,74,-19
42,11,10,3,63,105,-42
42,11,10,5,0,151,-151
42,11,12,11,77,103,-26
42,11,12,31,0,58,-58
42,11,12,57,90,131,-41
42,11,12,71,0,66,-66
42,11,12,83,0,75,-75
42,11,12,86,0,70,-70
42,11,12,95,100,94,6
42,11,12,97,0,72,-72
42,11,12,99,65,90,-25
42,11,12,103,0,101,-101
42,11,12,105,0,128,-128
42,11,24,5,0,48,-48
42,11,32,3,0,51,-51
42,11,34,5,65,66,-1
42,11,34,7,0,86,-86
42,11,34,13,74,0,74
42,11,34,17,101,0,101
42,11,34,23,106,68,38
42,11,34,31,103,0,103
42,11,36,5,598,240,358
42,11,36,47,427,151,276
42,11,36,59,104,0,104
42,11,36,61,237,126,111
42,11,36,81,302,115,187
42,11,36,103,93,0,93
42,11,37,183,0,77,-77
42,11,42,3,68,114,-46
42,11,42,17,456,303,153
42,11,42,25,84,69,15
42,11,42,27,0,48,-48
42,11,42,29,1381,1059,322
42,11,42,41,91,131,-40
42,11,42,43,249,255,-6
42,11,42,45,223,165,58
42,11,42,71,1602,1618,-16
42,11,42,75,857,918,-61
42,11,42,77,1609,1196,413
42,11,42,79,126,115,11
42,11,42,81,0,58,-58
42,11,42,89,102,86,16
42,11,42,91,3043,2288,755
42,11,42,95,376,276,100
42,11,42,101,752,681,71
42,11,42,107,716,864,-148
42,11,42,133,170,236,-66
42,11,45,51,0,111,-111
42,11,48,201,0,88,-88
42,13,42,3,155,205,-50
42,13,42,9,365,451,-86
42,13,42,21,515,510,5
42,13,42,27,264,304,-40
42,13,42,33,148,140,8
42,13,42,41,0,51,-51
42,13,42,43,0,73,-73
42,13,42,61,284,260,24
42,13,42,87,56,0,56
42,13,42,111,74,0,74
42,13,42,129,73,74,-1
42,15,36,7,76,60,16
42,15,36,15,250,227,23
42,15,36,107,363,371,-8
42,15,42,69,0,53,-53
42,15,42,81,104,64,40
42,15,42,113,87,99,-12
42,15,42,115,82,0,82
42,15,42,117,144,204,-60
42,15,42,131,126,124,2
42,17,4,13,94,171,-77
42,17,6,37,220,218,2
42,17,6,59,93,65,28
42,17,6,65,0,58,-58
42,17,6,73,87,165,-78
42,17,6,75,0,43,-43
42,17,8,31,0,46,-46
42,17,8,59,0,49,-49
42,17,9,1,90,82,8
42,17,9,9,72,0,72
42,17,10,1,0,78,-78
42,17,10,3,224,273,-49
42,17,10,5,60,148,-88
42,17,11,1,63,87,-24
42,17,12,11,109,196,-87
42,17,12,21,0,127,-127
42,17,12,57,98,163,-65
42,17,12,69,0,77,-77
42,17,12,71,85,170,-85
42,17,12,81,0,87,-87
42,17,12,86,63,72,-9
42,17,12,95,77,137,-60
42,17,12,99,153,321,-168
42,17,12,103,91,153,-62
42,17,12,105,0,79,-79
42,17,12,115,62,111,-49
42,17,12,117,0,64,-64
42,17,12,127,0,67,-67
42,17,13,121,0,61,-61
42,17,17,31,84,151,-67
42,17,24,3,0,58,-58
42,17,24,5,55,106,-51
42,17,24,15,0,51,-51
42,17,24,31,84,135,-51
42,17,24,33,0,58,-58
42,17,24,510,81,66,15
42,17,25,17,127,110,17
42,17,25,21,64,0,64
42,17,25,25,55,63,-8
42,17,32,3,0,67,-67
42,17,34,1,159,208,-49
42,17,34,3,155,88,67
42,17,34,5,903,1005,-102
42,17,34,7,386,377,9
42,17,34,9,116,229,-113
42,17,34,13,183,102,81
42,17,34,15,212,205,7
42,17,34,17,169,179,-10
42,17,34,19,504,357,147
42,17,34,21,2390,1330,1060
42,17,34,23,658,315,343
42,17,34,25,314,165,149
42,17,34,27,171,104,67
42,17,34,29,307,266,41
42,17,34,31,70,0,70
42,17,34,35,346,150,196
42,17,34,39,173,56,117
42,17,34,41,127,62,65
42,17,36,5,87,0,87
42,17,36,47,332,193,139
42,17,36,59,138,0,138
42,17,36,61,265,331,-66
42,17,36,81,217,100,117
42,17,36,85,76,0,76
42,17,36,87,58,0,58
42,17,36,103,132,73,59
42,17,36,119,78,53,25
42,17,37,19,0,81,-81
42,17,37,119,0,103,-103
42,17,37,183,80,87,-7
42,17,39,49,0,57,-57
42,17,42,3,142,122,20
42,17,42,11,303,456,-153
42,17,42,25,81,145,-64
42,17,42,27,50,64,-14
42,17,42,29,550,825,-275
42,17,42,41,72,97,-25
42,17,42,43,96,112,-16
42,17,42,45,706,704,2
42,17,42,69,51,56,-5
42,17,42,71,203,334,-131
42,17,42,75,0,63,-63
42,17,42,77,646,997,-351
42,17,42,79,117,102,15
42,17,42,89,169,171,-2
42,17,42,91,7413,7525,-112
42,17,42,95,568,706,-138
42,17,42,101,9961,6068,3893
42,17,42,107,77,0,77
42,17,42,127,53,0,53
42,17,42,133,78,89,-11
42,17,45,51,0,132,-132
42,17,47,37,0,48,-48
42,17,48,113,0,56,-56
42,17,48,201,81,86,-5
42,17,48,453,61,69,-8
42,17,51,13,0,50,-50
42,17,51,59,86,84,2
42,17,51,810,0,53,-53
42,17,53,33,0,78,-78
42,19,6,73,0,59,-59
42,19,34,27,136,0,136
42,19,39,35,0,60,-60
42,19,39,99,49,0,49
42,19,42,3,4612,2921,1691
42,19,42,5,471,451,20
42,19,42,7,855,842,13
42,19,42,31,126,116,10
42,19,42,39,62,72,-10
42,19,42,49,132,101,31
42,19,42,63,50,0,50
42,19,42,73,430,495,-65
42,19,42,85,421,417,4
42,19,42,101,0,42,-42
42,19,42,121,203,193,10
42,19,42,125,211,117,94
42,19,42,129,450,357,93
42,19,48,201,109,0,109
42,21,42,3,207,418,-211
42,21,42,9,68,59,9
42,21,42,13,510,515,-5
42,21,42,27,0,97,-97
42,21,42,33,139,139,0
42,21,42,43,0,48,-48
42,21,42,63,325,371,-46
42,21,42,101,209,72,137
42,21,42,111,769,741,28
42,21,42,129,147,257,-110
42,23,42,47,62,90,-28
42,25,36,5,50,0,50
42,25,36,47,54,0,54
42,25,42,11,69,84,-15
42,25,42,17,145,81,64
42,25,42,71,0,54,-54
42,25,42,77,726,521,205
42,25,42,79,428,353,75
42,25,42,89,496,364,132
42,25,42,91,128,107,21
42,25,42,95,702,411,291
42,25,42,101,142,81,61
42,25,42,107,484,531,-47
42,27,6,37,63,82,-19
42,27,6,85,0,100,-100
42,27,11,1,0,51,-51
42,27,17,31,47,85,-38
42,27,24,31,0,88,-88
42,27,25,17,0,90,-90
42,27,34,17,0,42,-42
42,27,34,23,0,59,-59
42,27,36,61,56,101,-45
42,27,42,3,184,305,-121
42,27,42,11,48,0,48
42,27,42,13,304,264,40
42,27,42,17,64,50,14
42,27,42,21,97,0,97
42,27,42,29,93,100,-7
42,27,42,33,531,574,-43
42,27,42,35,407,367,40
42,27,42,41,80,95,-15
42,27,42,43,86,158,-72
42,27,42,61,156,194,-38
42,27,42,71,99,125,-26
42,27,42,77,60,0,60
42,27,42,81,93,94,-1
42,27,42,87,153,191,-38
42,27,42,91,82,103,-21
42,27,42,101,136,174,-38
42,27,42,129,50,49,1
42,27,42,133,67,76,-9
42,27,48,201,48,0,48
42,27,51,59,0,71,-71
42,27,53,33,0,76,-76
42,29,4,13,134,172,-38
42,29,6,1,85,57,28
42,29,6,37,177,217,-40
42,29,6,59,87,103,-16
42,29,6,73,101,109,-8
42,29,6,75,60,46,14
42,29,6,85,59,79,-20
42,29,8,31,0,71,-71
42,29,9,1,78,70,8
42,29,9,3,93,52,41
42,29,9,9,81,0,81
42,29,10,1,55,94,-39
42,29,10,3,2108,1854,254
42,29,10,5,90,409,-319
42,29,11,1,70,114,-44
42,29,12,9,0,58,-58
42,29,12,11,133,70,63
42,29,12,21,0,112,-112
42,29,12,31,0,81,-81
42,29,12,57,85,88,-3
42,29,12,71,83,122,-39
42,29,12,86,60,66,-6
42,29,12,95,60,98,-38
42,29,12,99,132,204,-72
42,29,12,103,80,145,-65
42,29,12,109,0,71,-71
42,29,12,115,0,71,-71
42,29,13,121,64,99,-35
42,29,13,135,57,0,57
42,29,17,31,162,106,56
42,29,24,3,85,85,0
42,29,24,5,125,96,29
42,29,24,15,321,384,-63
42,29,24,25,79,103,-24
42,29,24,31,138,75,63
42,29,24,510,80,90,-10
42,29,25,17,104,114,-10
42,29,25,21,0,97,-97
42,29,25,25,55,84,-29
42,29,32,3,0,54,-54
42,29,34,1,83,79,4
42,29,34,3,118,0,118
42,29,34,5,276,116,160
42,29,34,7,280,140,140
42,29,34,9,120,153,-33
42,29,34,13,70,0,70
42,29,34,15,147,90,57
42,29,34,17,149,97,52
42,29,34,21,141,71,70
42,29,34,23,216,113,103
42,29,34,25,78,69,9
42,29,34,27,114,76,38
42,29,34,29,83,66,17
42,29,34,35,92,71,21
42,29,34,39,67,0,67
42,29,36,47,91,125,-34
42,29,36,55,52,0,52
42,29,36,59,78,0,78
42,29,36,61,186,211,-25
42,29,36,81,79,83,-4
42,29,36,103,73,0,73
42,29,36,119,69,0,69
42,29,37,63,0,52,-52
42,29,37,119,88,172,-84
42,29,37,183,0,116,-116
42,29,39,49,67,57,10
42,29,42,3,192,197,-5
42,29,42,11,1059,1381,-322
42,29,42,17,825,550,275
42,29,42,27,100,93,7
42,29,42,41,153,82,71
42,29,42,43,167,127,40
42,29,42,45,5087,3379,1708
42,29,42,69,76,0,76
42,29,42,71,1803,1915,-112
42,29,42,75,106,74,32
42,29,42,77,265,173,92
42,29,42,79,92,50,42
42,29,42,89,45,76,-31
42,29,42,91,6031,4811,1220
42,29,42,95,167,83,84
42,29,42,101,2435,2123,312
42,29,42,107,0,58,-58
42,29,42,133,169,195,-26
42,29,45,19,0,93,-93
42,29,45,51,0,65,-65
42,29,47,37,0,52,-52
42,29,48,29,72,0,72
42,29,48,85,78,92,-14
42,29,48,113,77,75,2
42,29,48,121,54,0,54
42,29,48,201,85,108,-23
42,29,48,453,0,97,-97
42,29,51,13,67,65,2
42,29,51,59,177,113,64
42,29,51,107,99,74,25
42,29,53,33,80,113,-33
42,31,42,3,106,138,-32
42,31,42,5,182,227,-45
42,31,42,19,116,126,-10
42,31,42,53,66,0,66
42,31,42,65,214,190,24
42,31,42,121,213,206,7
42,33,42,3,80,137,-57
42,33,42,13,140,148,-8
42,33,42,21,139,139,0
42,33,42,27,574,531,43
42,33,42,47,129,133,-4
42,33,42,63,124,94,30
42,33,42,65,623,659,-36
42,33,42,129,0,58,-58
42,35,42,27,367,407,-40
42,35,42,81,655,548,107
42,37,42,79,920,839,81
42,37,42,81,118,142,-24
42,37,42,93,486,339,147
42,37,42,97,381,355,26
42,37,42,101,58,71,-13
42,37,42,107,125,119,6
42,37,42,119,76,0,76
42,39,39,7,60,77,-17
42,39,39,155,0,60,-60
42,39,42,3,238,204,34
42,39,42,19,72,62,10
42,39,42,49,810,877,-67
42,39,42,85,369,434,-65
42,39,42,121,339,364,-25
42,39,42,123,95,90,5
42,39,42,125,0,55,-55
42,41,4,13,0,81,-81
42,41,6,37,63,0,63
42,41,6,73,110,65,45
42,41,10,5,0,58,-58
42,41,11,1,0,55,-55
42,41,12,31,0,59,-59
42,41,12,57,0,79,-79
42,41,12,103,51,0,51
42,41,15,3,97,0,97
42,41,17,31,53,49,4
42,41,24,5,73,62,11
42,41,24,21,0,51,-51
42,41,24,31,71,75,-4
42,41,24,43,91,0,91
42,41,24,510,69,0,69
42,41,34,23,82,0,82
42,41,36,47,66,0,66
42,41,36,61,57,54,3
42,41,36,81,67,0,67
42,41,36,103,60,0,60
42,41,37,51,105,0,105
42,41,37,183,0,70,-70
42,41,42,1,497,367,130
42,41,42,3,164,263,-99
42,41,42,11,131,91,40
42,41,42,13,51,0,51
42,41,42,17,97,72,25
42,41,42,27,95,80,15
42,41,42,29,82,153,-71
42,41,42,43,4501,3028,1473
42,41,42,45,65,0,65
42,41,42,55,1492,1291,201
42,41,42,67,76,62,14
42,41,42,69,126,0,126
42,41,42,71,552,538,14
42,41,42,75,340,243,97
42,41,42,77,82,63,19
42,41,42,79,101,0,101
42,41,42,81,0,49,-49
42,41,42,91,114,132,-18
42,41,42,95,0,64,-64
42,41,42,97,77,59,18
42,41,42,99,886,973,-87
42,41,42,101,192,208,-16
42,41,42,107,65,57,8
42,41,42,109,0,43,-43
42,41,42,129,0,55,-55
42,41,42,133,2524,2326,198
42,41,45,51,0,70,-70
42,41,51,13,0,72,-72
42,41,51,59,164,114,50
42,43,4,13,70,109,-39
42,43,6,37,69,85,-16
42,43,6,73,0,65,-65
42,43,10,3,58,63,-5
42,43,10,5,0,123,-123
42,43,11,1,55,0,55
42,43,12,11,0,69,-69
42,43,12,57,0,91,-91
42,43,12,71,0,53,-53
42,43,12,95,69,59,10
42,43,12,99,61,68,-7
42,43,12,105,0,71,-71
42,43,13,121,0,68,-68
42,43,17,31,0,64,-64
42,43,24,3,52,0,52
42,43,24,5,105,101,4
42,43,24,31,100,68,32
42,43,24,33,65,73,-8
42,43,24,510,81,71,10
42,43,25,27,72,0,72
42,43,34,13,102,0,102
42,43,34,23,72,0,72
42,43,36,5,274,79,195
42,43,36,47,224,72,152
42,43,36,61,119,79,40
42,43,36,81,185,82,103
42,43,36,103,98,0,98
42,43,37,119,0,73,-73
42,43,37,183,0,58,-58
42,43,39,49,82,81,1
42,43,42,1,122,131,-9
42,43,42,3,228,236,-8
42,43,42,11,255,249,6
42,43,42,13,73,0,73
42,43,42,17,112,96,16
42,43,42,21,48,0,48
42,43,42,27,158,86,72
42,43,42,29,127,167,-40
42,43,42,41,3028,4501,-1473
42,43,42,45,94,103,-9
42,43,42,55,153,181,-28
42,43,42,67,94,77,17
42,43,42,69,90,0,90
42,43,42,71,1641,1460,181
42,43,42,75,1353,1475,-122
42,43,42,77,142,106,36
42,43,42,79,134,69,65
42,43,42,81,132,70,62
42,43,42,87,46,84,-38
42,43,42,89,54,0,54
42,43,42,91,196,210,-14
42,43,42,95,91,0,91
42,43,42,97,196,266,-70
42,43,42,99,501,605,-104
42,43,42,101,478,457,21
42,43,42,107,356,299,57
42,43,42,109,67,68,-1
42,43,42,133,1271,1435,-164
42,43,45,51,0,57,-57
42,43,48,201,73,71,2
42,43,48,439,96,0,96
42,43,51,59,77,75,2
42,43,53,33,63,0,63
42,45,4,13,105,134,-29
42,45,6,37,173,225,-52
42,45,6,59,60,66,-6
42,45,6,73,82,161,-79
42,45,6,75,0,57,-57
42,45,6,85,69,0,69
42,45,8,31,0,58,-58
42,45,9,1,62,0,62
42,45,9,3,68,0,68
42,45,9,9,76,0,76
42,45,10,1,70,215,-145
42,45,10,3,2103,3327,-1224
42,45,10,5,118,272,-154
42,45,11,1,86,74,12
42,45,12,11,105,62,43
42,45,12,21,0,71,-71
42,45,12,31,0,47,-47
42,45,12,57,71,71,0
42,45,12,71,0,114,-114
42,45,12,86,0,69,-69
42,45,12,95,0,93,-93
42,45,12,99,105,169,-64
42,45,12,103,55,96,-41
42,45,13,121,71,71,0
42,45,13,135,71,74,-3
42,45,17,31,101,138,-37
42,45,24,3,0,70,-70
42,45,24,5,89,78,11
42,45,24,15,52,124,-72
42,45,24,31,87,105,-18
42,45,24,33,93,75,18
42,45,24,510,83,82,1
42,45,25,17,112,119,-7
42,45,25,21,0,63,-63
42,45,25,25,64,60,4
42,45,32,3,0,73,-73
42,45,34,1,150,124,26
42,45,34,3,0,62,-62
42,45,34,5,278,320,-42
42,45,34,7,479,512,-33
42,45,34,9,156,241,-85
42,45,34,11,0,54,-54
42,45,34,13,82,66,16
42,45,34,15,385,525,-140
42,45,34,17,79,80,-1
42,45,34,21,116,101,15
42,45,34,23,131,78,53
42,45,34,25,76,0,76
42,45,34,33,55,88,-33
42,45,34,35,62,0,62
42,45,36,5,103,0,103
42,45,36,47,251,168,83
42,45,36,59,90,0,90
42,45,36,61,203,261,-58
42,45,36,81,305,85,220
42,45,36,103,71,0,71
42,45,36,119,0,67,-67
42,45,37,119,0,79,-79
42,45,37,183,84,70,14
42,45,38,17,0,72,-72
42,45,39,35,57,0,57
42,45,39,49,0,71,-71
42,45,42,3,135,120,15
42,45,42,11,165,223,-58
42,45,42,17,704,706,-2
42,45,42,29,3379,5087,-1708
42,45,42,41,0,65,-65
42,45,42,43,103,94,9
42,45,42,69,49,0,49
42,45,42,71,236,369,-133
42,45,42,77,156,117,39
42,45,42,79,88,0,88
42,45,42,89,54,58,-4
42,45,42,91,3341,3700,-359
42,45,42,95,100,91,9
42,45,42,101,13277,8445,4832
42,45,42,107,0,55,-55
42,45,42,133,0,84,-84
42,45,48,29,0,55,-55
42,45,48,113,59,0,59
42,45,48,201,105,73,32
42,45,48,453,54,50,4
42,45,51,13,75,67,8
42,45,51,59,110,120,-10
42,45,51,510,0,64,-64
42,45,51,810,0,78,-78
42,45,53,33,69,100,-31
42,47,42,3,0,62,-62
42,47,42,23,90,62,28
42,47,42,33,133,129,4
42,47,42,65,118,96,22
42,47,42,83,91,99,-8
42,49,4,13,66,103,-37
42,49,6,37,0,55,-55
42,49,6,73,53,0,53
42,49,12,9,0,61,-61
42,49,12,57,0,60,-60
42,49,12,71,0,98,-98
42,49,12,81,56,0,56
42,49,12,95,0,67,-67
42,49,12,103,0,90,-90
42,49,12,105,0,60,-60
42,49,17,31,61,61,0
42,49,36,13,339,295,44
42,49,36,29,98,125,-27
42,49,36,55,0,63,-63
42,49,37,119,0,90,-90
42,49,37,183,0,60,-60
42,49,39,7,112,210,-98
42,49,39,35,111,190,-79
42,49,39,49,73,182,-109
42,49,39,85,0,102,-102
42,49,39,153,0,79,-79
42,49,42,3,448,757,-309
42,49,42,7,58,82,-24
42,49,42,19,101,132,-31
42,49,42,39,877,810,67
42,49,42,85,124,150,-26
42,49,42,101,78,0,78
42,49,42,121,152,82,70
42,49,42,123,325,276,49
42,49,42,125,0,79,-79
42,49,42,129,71,0,71
42,49,51,59,0,52,-52
42,51,42,3,492,551,-59
42,51,42,59,216,193,23
42,51,42,111,122,123,-1
42,51,42,125,522,597,-75
42,51,42,129,1266,1427,-161
42,51,54,61,224,191,33
42,53,42,31,0,66,-66
42,55,24,5,62,79,-17
42,55,24,13,59,0,59
42,55,24,21,339,232,107
42,55,24,31,94,70,24
42,55,24,43,1210,947,263
42,55,42,1,499,399,100
42,55,42,3,58,69,-11
42,55,42,9,57,0,57
42,55,42,41,1291,1492,-201
42,55,42,43,181,153,28
42,55,42,57,219,225,-6
42,55,42,61,98,72,26
42,55,42,71,90,93,-3
42,55,42,101,0,52,-52
42,55,42,133,188,168,20
42,55,54,3,271,241,30
42,57,24,43,106,65,41
42,57,42,9,87,76,11
42,57,42,55,225,219,6
42,57,42,61,71,65,6
42,59,42,3,56,104,-48
42,59,42,51,193,216,-23
42,59,42,125,270,345,-75
42,59,54,61,116,205,-89
42,61,42,3,0,56,-56
42,61,42,9,98,114,-16
42,61,42,13,260,284,-24
42,61,42,27,194,156,38
42,61,42,55,72,98,-26
42,61,42,57,65,71,-6
42,61,42,87,282,304,-22
42,63,42,3,256,358,-102
42,63,42,5,311,239,72
42,63,42,19,0,50,-50
42,63,42,21,371,325,46
42,63,42,33,94,124,-30
42,63,42,65,225,288,-63
42,63,42,129,650,594,56
42,65,42,3,87,115,-28
42,65,42,5,0,75,-75
42,65,42,31,190,214,-24
42,65,42,33,659,623,36
42,65,42,47,96,118,-22
42,65,42,63,288,225,63
42,67,42,41,62,76,-14
42,67,42,43,77,94,-17
42,67,42,71,53,0,53
42,67,42,87,201,212,-11
42,67,42,99,180,135,45
42,67,42,109,149,131,18
42,69,4,13,0,74,-74
42,69,6,37,55,51,4
42,69,12,103,0,54,-54
42,69,34,3,63,0,63
42,69,34,13,129,0,129
42,69,34,17,72,57,15
42,69,34,23,71,0,71
42,69,34,27,53,0,53
42,69,36,5,145,0,145
42,69,36,7,58,48,10
42,69,36,47,222,105,117
42,69,36,61,75,68,7
42,69,36,71,68,0,68
42,69,36,81,122,0,122
42,69,36,103,79,0,79
42,69,37,183,0,80,-80
42,69,42,3,0,85,-85
42,69,42,15,53,0,53
42,69,42,17,56,51,5
42,69,42,29,0,76,-76
42,69,42,41,0,126,-126
42,69,42,43,0,90,-90
42,69,42,45,0,49,-49
42,69,42,71,0,71,-71
42,69,42,77,116,143,-27
42,69,42,79,1576,1732,-156
42,69,42,89,461,253,208
42,69,42,91,71,183,-112
42,69,42,95,94,114,-20
42,69,42,101,198,238,-40
42,69,42,103,137,101,36
42,69,42,115,398,357,41
42,69,42,127,758,740,18
42,69,42,131,424,371,53
42,71,4,13,81,129,-48
42,71,6,37,102,86,16
42,71,6,73,0,74,-74
42,71,8,31,57,56,1
42,71,8,41,0,76,-76
42,71,10,3,178,186,-8
42,71,10,5,96,131,-35
42,71,11,1,53,56,-3
42,71,12,9,0,85,-85
42,71,12,11,0,69,-69
42,71,12,31,0,57,-57
42,71,12,57,101,145,-44
42,71,12,71,86,88,-2
42,71,12,81,0,85,-85
42,71,12,86,68,118,-50
42,71,12,95,97,101,-4
42,71,12,99,70,89,-19
42,71,12,103,0,107,-107
42,71,12,105,0,95,-95
42,71,12,115,0,63,-63
42,71,17,31,97,51,46
42,71,24,3,95,59,36
42,71,24,5,133,121,12
42,71,24,15,122,152,-30
42,71,24,25,116,138,-22
42,71,24,31,75,63,12
42,71,24,33,63,50,13
42,71,24,510,78,79,-1
42,71,25,17,61,46,15
42,71,32,3,0,64,-64
42,71,34,3,71,0,71
42,71,34,5,64,0,64
42,71,34,7,79,0,79
42,71,34,13,78,0,78
42,71,34,17,80,0,80
42,71,34,23,60,0,60
42,71,34,25,56,0,56
42,71,34,29,64,0,64
42,71,36,5,182,0,182
42,71,36,47,195,61,134
42,71,36,59,73,0,73
42,71,36,61,120,108,12
42,71,36,81,148,0,148
42,71,36,103,110,0,110
42,71,37,119,0,62,-62
42,71,37,133,0,53,-53
42,71,37,183,0,74,-74
42,71,39,49,0,66,-66
42,71,42,1,108,103,5
42,71,42,3,208,197,11
42,71,42,11,1618,1602,16
42,71,42,17,334,203,131
42,71,42,25,54,0,54
42,71,42,27,125,99,26
42,71,42,29,1915,1803,112
42,71,42,41,538,552,-14
42,71,42,43,1460,1641,-181
42,71,42,45,369,236,133
42,71,42,55,93,90,3
42,71,42,67,0,53,-53
42,71,42,69,71,0,71
42,71,42,75,1142,1519,-377
42,71,42,77,248,158,90
42,71,42,79,129,68,61
42,71,42,81,102,55,47
42,71,42,91,558,436,122
42,71,42,95,115,89,26
42,71,42,97,72,79,-7
42,71,42,99,91,160,-69
42,71,42,101,596,611,-15
42,71,42,107,167,127,40
42,71,42,133,1954,2419,-465
42,71,45,51,0,132,-132
42,71,47,37,0,52,-52
42,71,48,201,79,82,-3
42,71,48,453,0,58,-58
42,71,51,59,93,83,10
42,71,53,33,0,64,-64
42,73,39,99,157,265,-108
42,73,39,155,59,105,-46
42,73,42,3,352,369,-17
42,73,42,7,805,697,108
42,73,42,19,495,430,65
42,73,42,85,360,484,-124
42,75,36,5,84,0,84
42,75,36,47,69,0,69
42,75,42,11,918,857,61
42,75,42,17,63,0,63
42,75,42,29,74,106,-32
42,75,42,41,243,340,-97
42,75,42,43,1475,1353,122
42,75,42,71,1519,1142,377
42,75,42,77,72,63,9
42,75,42,91,69,63,6
42,75,42,99,0,81,-81
42,75,42,101,132,143,-11
42,75,42,107,236,295,-59
42,75,42,133,214,268,-54
42,77,4,13,67,116,-49
42,77,6,37,56,74,-18
42,77,6,73,0,86,-86
42,77,9,1,63,0,63
42,77,9,3,89,54,35
42,77,10,3,87,74,13
42,77,10,5,0,98,-98
42,77,12,9,0,57,-57
42,77,12,11,75,112,-37
42,77,12,31,0,69,-69
42,77,12,57,92,142,-50
42,77,12,69,0,64,-64
42,77,12,71,0,74,-74
42,77,12,86,67,81,-14
42,77,12,95,89,214,-125
42,77,12,97,0,118,-118
42,77,12,99,77,105,-28
42,77,12,101,0,72,-72
42,77,12,103,72,105,-33
42,77,12,105,72,161,-89
42,77,17,31,62,68,-6
42,77,25,17,0,61,-61
42,77,32,3,0,63,-63
42,77,34,3,135,92,43
42,77,34,5,91,68,23
42,77,34,7,76,0,76
42,77,34,13,289,167,122
42,77,34,17,244,91,153
42,77,34,19,92,0,92
42,77,34,23,205,135,70
42,77,34,25,0,66,-66
42,77,34,27,111,66,45
42,77,34,29,57,63,-6
42,77,34,31,273,56,217
42,77,34,35,148,95,53
42,77,34,39,152,102,50
42,77,34,41,194,99,95
42,77,36,5,947,282,665
42,77,36,47,638,312,326
42,77,36,55,0,62,-62
42,77,36,59,167,58,109
42,77,36,61,409,172,237
42,77,36,81,591,197,394
42,77,36,85,105,0,105
42,77,36,103,163,0,163
42,77,36,119,101,64,37
42,77,37,119,0,113,-113
42,77,37,183,0,108,-108
42,77,42,3,135,95,40
42,77,42,11,1196,1609,-413
42,77,42,17,997,646,351
42,77,42,25,521,726,-205
42,77,42,27,0,60,-60
42,77,42,29,173,265,-92
42,77,42,41,63,82,-19
42,77,42,43,106,142,-36
42,77,42,45,117,156,-39
42,77,42,69,143,116,27
42,77,42,71,158,248,-90
42,77,42,75,63,72,-9
42,77,42,79,279,268,11
42,77,42,89,476,518,-42
42,77,42,91,973,892,81
42,77,42,95,7085,7568,-483
42,77,42,101,578,627,-49
42,77,42,103,63,0,63
42,77,42,107,234,409,-175
42,77,42,133,91,61,30
42,77,45,51,0,75,-75
42,77,48,201,0,123,-123
42,77,51,59,75,0,75
42,79,4,13,0,74,-74
42,79,6,73,0,69,-69
42,79,10,3,0,74,-74
42,79,12,9,0,72,-72
42,79,12,11,0,56,-56
42,79,12,31,0,69,-69
42,79,12,57,0,143,-143
42,79,12,71,0,87,-87
42,79,12,95,84,78,6
42,79,12,99,59,106,-47
42,79,12,103,0,93,-93
42,79,12,105,0,60,-60
42,79,12,127,0,66,-66
42,79,34,3,130,50,80
42,79,34,13,280,65,215
42,79,34,17,184,72,112
42,79,34,23,114,79,35
42,79,34,27,0,49,-49
42,79,34,31,399,136,263
42,79,34,39,81,0,81
42,79,36,5,808,267,541
42,79,36,47,562,213,349
42,79,36,59,67,0,67
42,79,36,61,308,128,180
42,79,36,81,359,157,202
42,79,36,85,84,0,84
42,79,36,103,111,0,111
42,79,36,119,87,0,87
42,79,42,3,77,111,-34
42,79,42,11,115,126,-11
42,79,42,17,102,117,-15
42,79,42,25,353,428,-75
42,79,42,29,50,92,-42
42,79,42,37,839,920,-81
42,79,42,41,0,101,-101
42,79,42,43,69,134,-65
42,79,42,45,0,88,-88
42,79,42,69,1732,1576,156
42,79,42,71,68,129,-61
42,79,42,77,268,279,-11
42,79,42,81,86,100,-14
42,79,42,89,389,274,115
42,79,42,91,139,208,-69
42,79,42,93,58,0,58
42,79,42,95,133,210,-77
42,79,42,97,73,72,1
42,79,42,101,309,272,37
42,79,42,107,630,812,-182
42,79,42,115,96,75,21
42,79,42,127,133,108,25
42,79,42,131,426,323,103
42,79,42,133,70,95,-25
42,79,45,51,0,49,-49
42,81,42,3,0,96,-96
42,81,42,11,58,0,58
42,81,42,15,64,104,-40
42,81,42,27,94,93,1
42,81,42,35,548,655,-107
42,81,42,37,142,118,24
42,81,42,41,49,0,49
42,81,42,43,70,132,-62
42,81,42,71,55,102,-47
42,81,42,79,100,86,14
42,81,42,91,0,68,-68
42,81,42,93,87,85,2
42,81,42,97,392,366,26
42,81,42,101,88,90,-2
42,81,42,109,0,49,-49
42,81,42,113,92,76,16
42,81,42,117,138,150,-12
42,81,42,119,150,142,8
42,83,36,9,159,182,-23
42,83,42,3,58,82,-24
42,83,42,47,99,91,8
42,83,42,105,161,131,30
42,83,42,123,59,82,-23
42,85,39,35,0,55,-55
42,85,39,99,105,280,-175
42,85,39,155,477,666,-189
42,85,42,3,309,405,-96
42,85,42,7,74,0,74
42,85,42,19,417,421,-4
42,85,42,39,434,369,65
42,85,42,49,150,124,26
42,85,42,73,484,360,124
42,85,42,121,177,172,5
42,87,42,13,0,56,-56
42,87,42,27,191,153,38
42,87,42,43,84,46,38
42,87,42,61,304,282,22
42,87,42,67,212,201,11
42,87,42,109,85,99,-14
42,89,12,11,0,74,-74
42,89,12,57,0,66,-66
42,89,12,95,0,58,-58
42,89,12,99,0,77,-77
42,89,12,103,0,77,-77
42,89,12,127,0,55,-55
42,89,34,3,282,126,156
42,89,34,13,391,154,237
42,89,34,17,215,117,98
42,89,34,23,243,101,142
42,89,34,25,103,58,45
42,89,34,27,281,162,119
42,89,34,29,68,55,13
42,89,34,31,313,77,236
42,89,34,35,70,0,70
42,89,34,37,126,75,51
42,89,34,39,150,86,64
42,89,34,41,281,151,130
42,89,36,5,768,290,478
42,89,36,47,994,351,643
42,89,36,59,199,89,110
42,89,36,61,317,178,139
42,89,36,71,63,0,63
42,89,36,81,914,287,627
42,89,36,85,262,81,181
42,89,36,103,219,109,110
42,89,36,119,88,0,88
42,89,37,119,0,71,-71
42,89,37,183,0,63,-63
42,89,42,3,0,59,-59
42,89,42,11,86,102,-16
42,89,42,17,171,169,2
42,89,42,25,364,496,-132
42,89,42,29,76,45,31
42,89,42,43,0,54,-54
42,89,42,45,58,54,4
42,89,42,69,253,461,-208
42,89,42,77,518,476,42
42,89,42,79,274,389,-115
42,89,42,91,160,124,36
42,89,42,95,1190,1133,57
42,89,42,101,184,163,21
42,89,42,103,511,411,100
42,89,42,127,87,137,-50
42,89,42,133,0,59,-59
42,89,45,51,0,96,-96
42,91,4,13,214,290,-76
42,91,4,19,0,63,-63
42,91,6,1,108,116,-8
42,91,6,37,285,354,-69
42,91,6,59,120,137,-17
42,91,6,65,68,0,68
42,91,6,73,222,268,-46
42,91,6,75,50,56,-6
42,91,6,81,0,76,-76
42,91,6,85,93,145,-52
42,91,8,5,0,69,-69
42,91,8,31,0,121,-121
42,91,8,41,67,0,67
42,91,8,59,0,65,-65
42,91,9,1,119,104,15
42,91,9,3,109,82,27
42,91,9,9,73,48,25
42,91,10,1,57,78,-21
42,91,10,3,459,611,-152
42,91,10,5,126,232,-106
42,91,11,1,199,167,32
42,91,12,9,0,78,-78
42,91,12,11,183,142,41
42,91,12,21,75,113,-38
42,91,12,31,0,106,-106
42,91,12,57,92,223,-131
42,91,12,69,0,50,-50
42,91,12,71,116,214,-98
42,91,12,81,0,104,-104
42,91,12,85,0,52,-52
42,91,12,86,138,137,1
42,91,12,95,113,170,-57
42,91,12,99,226,389,-163
42,91,12,101,0,57,-57
42,91,12,103,87,199,-112
42,91,12,105,71,99,-28
42,91,12,115,0,107,-107
42,91,12,127,63,66,-3
42,91,13,67,0,60,-60
42,91,13,89,80,67,13
42,91,13,121,124,122,2
42,91,13,135,0,110,-110
42,91,17,31,242,171,71
42,91,24,3,89,97,-8
42,91,24,5,150,118,32
42,91,24,15,0,65,-65
42,91,24,25,0,67,-67
42,91,24,27,86,0,86
42,91,24,31,193,220,-27
42,91,24,33,96,75,21
42,91,24,510,126,121,5
42,91,25,17,191,257,-66
42,91,25,21,92,110,-18
42,91,25,25,88,129,-41
42,91,25,27,72,0,72
42,91,26,125,67,59,8
42,91,27,53,63,0,63
42,91,32,3,67,105,-38
42,91,34,1,192,257,-65
42,91,34,3,207,129,78
42,91,34,5,466,389,77
42,91,34,7,522,447,75
42,91,34,9,180,232,-52
42,91,34,13,103,66,37
42,91,34,15,269,206,63
42,91,34,17,185,188,-3
42,91,34,19,84,70,14
42,91,34,21,225,136,89
42,91,34,23,376,222,154
42,91,34,25,130,111,19
42,91,34,27,176,138,38
42,91,34,29,202,121,81
42,91,34,35,115,99,16
42,91,34,39,97,98,-1
42,91,34,41,56,0,56
42,91,36,5,112,0,112
42,91,36,29,62,0,62
42,91,36,47,414,198,216
42,91,36,55,64,0,64
42,91,36,59,146,0,146
42,91,36,61,395,544,-149
42,91,36,81,296,151,145
42,91,36,103,128,89,39
42,91,36,119,95,83,12
42,91,37,19,0,54,-54
42,91,37,63,0,62,-62
42,91,37,119,160,179,-19
42,91,37,183,127,235,-108
42,91,39,35,81,82,-1
42,91,39,49,89,65,24
42,91,39,61,55,0,55
42,91,42,3,322,292,30
42,91,42,11,2288,3043,-755
42,91,42,17,7525,7413,112
42,91,42,25,107,128,-21
42,91,42,27,103,82,21
42,91,42,29,4811,6031,-1220
42,91,42,41,132,114,18
42,91,42,43,210,196,14
42,91,42,45,3700,3341,359
42,91,42,69,183,71,112
42,91,42,71,436,558,-122
42,91,42,75,63,69,-6
42,91,42,77,892,973,-81
42,91,42,79,208,139,69
42,91,42,81,68,0,68
42,91,42,89,124,160,-36
42,91,42,95,463,345,118
42,91,42,101,15657,10017,5640
42,91,42,107,109,109,0
42,91,42,127,0,64,-64
42,91,42,133,160,136,24
42,91,45,19,0,70,-70
42,91,45,51,59,108,-49
42,91,47,37,56,0,56
42,91,48,29,75,0,75
42,91,48,85,0,128,-128
42,91,48,113,143,123,20
42,91,48,201,176,146,30
42,91,48,439,0,71,-71
42,91,48,453,82,128,-46
42,91,51,13,99,65,34
42,91,51,59,252,163,89
42,91,51,107,0,59,-59
42,91,51,510,0,61,-61
42,91,51,810,0,92,-92
42,91,53,33,105,224,-119
42,93,42,37,339,486,-147
42,93,42,79,0,58,-58
42,93,42,81,85,87,-2
42,93,42,97,434,562,-128
42,93,42,119,76,96,-20
42,95,4,13,0,123,-123
42,95,6,37,79,77,2
42,95,6,73,60,58,2
42,95,8,31,0,41,-41
42,95,10,5,0,76,-76
42,95,12,11,0,63,-63
42,95,12,57,0,97,-97
42,95,12,71,0,77,-77
42,95,12,81,0,69,-69
42,95,12,95,62,101,-39
42,95,12,97,0,69,-69
42,95,12,99,89,60,29
42,95,12,103,0,53,-53
42,95,12,105,0,118,-118
42,95,12,115,0,66,-66
42,95,17,31,56,57,-1
42,95,25,17,0,57,-57
42,95,32,3,0,53,-53
42,95,34,3,159,60,99
42,95,34,13,464,191,273
42,95,34,17,281,91,190
42,95,34,19,372,187,185
42,95,34,21,85,0,85
42,95,34,23,386,157,229
42,95,34,25,113,0,113
42,95,34,27,240,119,121
42,95,34,29,89,69,20
42,95,34,31,129,0,129
42,95,34,35,212,112,100
42,95,34,37,123,0,123
42,95,34,39,317,104,213
42,95,34,41,1056,673,383
42,95,36,5,233,76,157
42,95,36,47,465,176,289
42,95,36,59,103,0,103
42,95,36,61,203,157,46
42,95,36,81,358,118,240
42,95,36,85,131,0,131
42,95,36,103,79,0,79
42,95,37,119,0,72,-72
42,95,37,183,0,59,-59
42,95,42,3,0,57,-57
42,95,42,11,276,376,-100
42,95,42,17,706,568,138
42,95,42,25,411,702,-291
42,95,42,29,83,167,-84
42,95,42,41,64,0,64
42,95,42,43,0,91,-91
42,95,42,45,91,100,-9
42,95,42,69,114,94,20
42,95,42,71,89,115,-26
42,95,42,77,7568,7085,483
42,95,42,79,210,133,77
42,95,42,89,1133,1190,-57
42,95,42,91,345,463,-118
42,95,42,101,277,485,-208
42,95,42,103,101,58,43
42,95,42,107,102,124,-22
42,95,45,51,0,90,-90
42,95,48,201,0,85,-85
42,97,42,37,355,381,-26
42,97,42,41,59,77,-18
42,97,42,43,266,196,70
42,97,42,71,79,72,7
42,97,42,79,72,73,-1
42,97,42,81,366,392,-26
42,97,42,93,562,434,128
42,97,42,101,107,61,46
42,97,42,107,274,353,-79
42,97,42,109,428,405,23
42,97,42,119,659,562,97
42,99,42,41,973,886,87
42,99,42,43,605,501,104
42,99,42,67,135,180,-45
42,99,42,71,160,91,69
42,99,42,75,81,0,81
42,99,42,133,177,142,35
42,101,4,13,308,400,-92
42,101,4,19,84,61,23
42,101,6,1,215,227,-12
42,101,6,13,56,96,-40
42,101,6,37,646,964,-318
42,101,6,59,139,217,-78
42,101,6,65,0,54,-54
42,101,6,67,67,112,-45
42,101,6,71,59,90,-31
42,101,6,73,307,344,-37
42,101,6,75,333,408,-75
42,101,6,81,49,92,-43
42,101,6,85,159,370,-211
42,101,8,5,60,69,-9
42,101,8,13,48,85,-37
42,101,8,31,155,304,-149
42,101,8,41,55,73,-18
42,101,8,59,44,58,-14
42,101,9,1,273,118,155
42,101,9,3,179,161,18
42,101,9,9,236,191,45
42,101,10,1,164,434,-270
42,101,10,3,1833,2603,-770
42,101,10,5,142,202,-60
42,101,11,1,841,583,258
42,101,12,9,59,126,-67
42,101,12,11,332,355,-23
42,101,12,19,0,64,-64
42,101,12,21,44,48,-4
42,101,12,31,140,245,-105
42,101,12,57,234,318,-84
42,101,12,69,0,75,-75
42,101,12,71,108,105,3
42,101,12,86,422,328,94
42,101,12,95,322,432,-110
42,101,12,97,114,142,-28
42,101,12,99,263,318,-55
42,101,12,101,0,76,-76
42,101,12,103,118,190,-72
42,101,12,105,68,169,-101
42,101,12,111,0,72,-72
42,101,12,115,0,95,-95
42,101,12,117,0,64,-64
42,101,12,127,62,139,-77
42,101,13,63,0,96,-96
42,101,13,67,92,144,-52
42,101,13,89,213,214,-1
42,101,13,121,278,335,-57
42,101,13,135,126,182,-56
42,101,15,3,73,83,-10
42,101,17,19,46,0,46
42,101,17,31,762,727,35
42,101,17,43,68,0,68
42,101,17,97,0,55,-55
42,101,18,97,109,111,-2
42,101,21,111,82,54,28
42,101,22,71,123,111,12
42,101,23,5,46,60,-14
42,101,24,3,116,190,-74
42,101,24,5,247,296,-49
42,101,24,15,101,95,6
42,101,24,21,53,0,53
42,101,24,25,83,69,14
42,101,24,27,131,103,28
42,101,24,31,430,394,36
42,101,24,33,295,297,-2
42,101,24,45,54,0,54
42,101,24,510,543,433,110
42,101,25,9,119,91,28
42,101,25,13,83,0,83
42,101,25,17,518,504,14
42,101,25,21,155,154,1
42,101,25,25,520,444,76
42,101,25,27,80,91,-11
42,101,26,125,66,96,-30
42,101,26,161,107,108,-1
42,101,26,163,60,111,-51
42,101,27,53,151,189,-38
42,101,27,123,0,69,-69
42,101,29,95,53,0,53
42,101,29,189,75,97,-22
42,101,29,510,64,79,-15
42,101,32,3,127,204,-77
42,101,33,11,0,62,-62
42,101,34,1,769,516,253
42,101,34,3,267,223,44
42,101,34,5,1663,2044,-381
42,101,34,7,2889,4394,-1505
42,101,34,9,323,471,-148
42,101,34,11,137,179,-42
42,101,34,13,444,239,205
42,101,34,15,1117,1576,-459
42,101,34,17,630,530,100
42,101,34,19,143,66,77
42,101,34,21,736,484,252
42,101,34,23,576,360,216
42,101,34,25,360,250,110
42,101,34,27,231,123,108
42,101,34,29,338,225,113
42,101,34,31,160,102,58
42,101,34,33,112,141,-29
42,101,34,35,257,138,119
42,101,34,37,46,0,46
42,101,34,39,248,181,67
42,101,35,1,0,53,-53
42,101,36,1,80,0,80
42,101,36,5,927,421,506
42,101,36,27,73,50,23
42,101,36,29,121,129,-8
42,101,36,47,3093,1335,1758
42,101,36,55,149,159,-10
42,101,36,59,295,166,129
42,101,36,61,2038,1803,235
42,101,36,67,123,65,58
42,101,36,71,84,0,84
42,101,36,81,1277,549,728
42,101,36,85,113,94,19
42,101,36,87,128,0,128
42,101,36,103,298,120,178
42,101,36,109,59,58,1
42,101,36,119,302,192,110
42,101,37,21,51,44,7
42,101,37,51,94,135,-41
42,101,37,63,128,133,-5
42,101,37,67,0,72,-72
42,101,37,81,74,112,-38
42,101,37,119,208,345,-137
42,101,37,135,77,55,22
42,101,37,183,205,269,-64
42,101,39,35,188,178,10
42,101,39,49,184,193,-9
42,101,39,61,137,132,5
42,101,39,153,50,0,50
42,101,41,51,132,199,-67
42,101,42,1,45,0,45
42,101,42,3,650,524,126
42,101,42,11,681,752,-71
42,101,42,17,6068,9961,-3893
42,101,42,19,42,0,42
42,101,42,21,72,209,-137
42,101,42,25,81,142,-61
42,101,42,27,174,136,38
42,101,42,29,2123,2435,-312
42,101,42,37,71,58,13
42,101,42,41,208,192,16
42,101,42,43,457,478,-21
42,101,42,45,8445,13277,-4832
42,101,42,49,0,78,-78
42,101,42,55,52,0,52
42,101,42,69,238,198,40
42,101,42,71,611,596,15
42,101,42,75,143,132,11
42,101,42,77,627,578,49
42,101,42,79,272,309,-37
42,101,42,81,90,88,2
42,101,42,89,163,184,-21
42,101,42,91,10017,15657,-5640
42,101,42,95,485,277,208
42,101,42,97,61,107,-46
42,101,42,107,95,79,16
42,101,42,129,72,0,72
42,101,42,133,256,273,-17
42,101,44,7,137,150,-13
42,101,45,19,61,78,-17
42,101,45,51,0,88,-88
42,101,45,79,85,103,-18
42,101,47,37,152,156,-4
42,101,47,157,92,0,92
42,101,48,27,0,68,-68
42,101,48,29,80,112,-32
42,101,48,85,76,102,-26
42,101,48,113,179,247,-68
42,101,48,121,51,66,-15
42,101,48,201,350,406,-56
42,101,48,439,89,119,-30
42,101,48,453,284,239,45
42,101,49,35,50,68,-18
42,101,50,7,47,0,47
42,101,51,13,261,174,87
42,101,51,41,0,66,-66
42,101,51,59,312,287,25
42,101,51,87,63,62,1
42,101,51,107,83,74,9
42,101,51,153,69,99,-30
42,101,51,510,103,85,18
42,101,51,700,47,90,-43
42,101,51,710,74,80,-6
42,101,51,760,137,91,46
42,101,51,810,87,118,-31
42,101,53,33,315,498,-183
42,101,53,53,63,0,63
42,101,53,61,0,56,-56
42,101,55,25,94,68,26
42,101,55,79,86,73,13
42,103,34,3,129,0,129
42,103,34,13,107,0,107
42,103,34,17,55,0,55
42,103,34,23,68,0,68
42,103,34,27,105,91,14
42,103,34,29,0,49,-49
42,103,34,31,73,0,73
42,103,34,37,322,206,116
42,103,36,5,99,58,41
42,103,36,47,184,108,76
42,103,36,59,108,55,53
42,103,36,61,103,83,20
42,103,36,71,653,385,268
42,103,36,81,215,0,215
42,103,36,85,101,0,101
42,103,36,87,68,0,68
42,103,36,103,143,68,75
42,103,36,105,106,0,106
42,103,42,69,101,137,-36
42,103,42,77,0,63,-63
42,103,42,89,411,511,-100
42,103,42,95,58,101,-43
42,103,42,127,388,393,-5
42,105,42,83,131,161,-30
42,105,42,117,124,196,-72
42,107,36,47,73,0,73
42,107,42,11,864,716,148
42,107,42,17,0,77,-77
42,107,42,25,531,484,47
42,107,42,29,58,0,58
42,107,42,37,119,125,-6
42,107,42,41,57,65,-8
42,107,42,43,299,356,-57
42,107,42,45,55,0,55
42,107,42,71,127,167,-40
42,107,42,75,295,236,59
42,107,42,77,409,234,175
42,107,42,79,812,630,182
42,107,42,91,109,109,0
42,107,42,95,124,102,22
42,107,42,97,353,274,79
42,107,42,101,79,95,-16
42,107,42,133,0,66,-66
42,109,42,41,43,0,43
42,109,42,43,68,67,1
42,109,42,67,131,149,-18
42,109,42,81,49,0,49
42,109,42,87,99,85,14
42,109,42,97,405,428,-23
42,109,42,119,307,367,-60
42,111,24,1,78,59,19
42,111,42,3,167,157,10
42,111,42,9,105,110,-5
42,111,42,13,0,74,-74
42,111,42,21,741,769,-28
42,111,42,51,123,122,1
42,111,42,129,171,187,-16
42,113,42,15,99,87,12
42,113,42,81,76,92,-16
42,115,36,7,310,258,52
42,115,42,15,0,82,-82
42,115,42,69,357,398,-41
42,115,42,79,75,96,-21
42,115,42,127,109,89,20
42,115,42,131,270,249,21
42,117,36,15,112,126,-14
42,117,36,101,246,172,74
42,117,42,15,204,144,60
42,117,42,81,150,138,12
42,117,42,105,196,124,72
42,119,42,37,0,76,-76
42,119,42,81,142,150,-8
42,119,42,93,96,76,20
42,119,42,97,562,659,-97
42,119,42,109,367,307,60
42,121,42,3,137,152,-15
42,121,42,19,193,203,-10
42,121,42,31,206,213,-7
42,121,42,39,364,339,25
42,121,42,49,82,152,-70
42,121,42,85,172,177,-5
42,123,36,13,193,198,-5
42,123,42,3,0,65,-65
42,123,42,39,90,95,-5
42,123,42,49,276,325,-49
42,123,42,83,82,59,23
42,125,4,13,0,48,-48
42,125,12,71,0,82,-82
42,125,12,103,0,65,-65
42,125,39,13,65,0,65
42,125,39,81,49,67,-18
42,125,42,3,4941,3542,1399
42,125,42,7,208,204,4
42,125,42,19,117,211,-94
42,125,42,39,55,0,55
42,125,42,49,79,0,79
42,125,42,51,597,522,75
42,125,42,59,345,270,75
42,125,42,129,825,749,76
42,125,45,51,0,58,-58
42,125,54,9,111,82,29
42,125,54,29,118,127,-9
42,125,54,61,115,107,8
42,125,54,69,116,150,-34
42,127,36,47,84,0,84
42,127,36,59,66,0,66
42,127,36,71,97,0,97
42,127,36,81,72,0,72
42,127,36,103,74,0,74
42,127,36,105,77,0,77
42,127,42,17,0,53,-53
42,127,42,69,740,758,-18
42,127,42,79,108,133,-25
42,127,42,89,137,87,50
42,127,42,91,64,0,64
42,127,42,103,393,388,5
42,127,42,115,89,109,-20
42,129,4,13,77,97,-20
42,129,6,37,55,0,55
42,129,12,71,0,70,-70
42,129,12,103,56,63,-7
42,129,32,3,0,58,-58
42,129,39,35,0,56,-56
42,129,42,3,6512,4979,1533
42,129,42,5,764,724,40
42,129,42,7,162,115,47
42,129,42,13,74,73,1
42,129,42,19,357,450,-93
42,129,42,21,257,147,110
42,129,42,27,49,50,-1
42,129,42,33,58,0,58
42,129,42,41,55,0,55
42,129,42,49,0,71,-71
42,129,42,51,1427,1266,161
42,129,42,63,594,650,-56
42,129,42,101,0,72,-72
42,129,42,111,187,171,16
42,129,42,125,749,825,-76
42,129,42,133,72,74,-2
42,129,45,51,0,131,-131
42,129,54,61,81,0,81
42,131,42,15,124,126,-2
42,131,42,69,371,424,-53
42,131,42,79,323,426,-103
42,131,42,115,249,270,-21
42,133,4,13,98,112,-14
42,133,6,37,71,60,11
42,133,6,73,109,81,28
42,133,10,3,62,73,-11
42,133,10,5,96,270,-174
42,133,12,9,0,86,-86
42,133,12,31,0,62,-62
42,133,12,57,0,67,-67
42,133,12,71,0,69,-69
42,133,12,95,94,94,0
42,133,12,103,81,126,-45
42,133,12,105,0,88,-88
42,133,24,3,333,184,149
42,133,24,5,1882,952,930
42,133,24,13,897,487,410
42,133,24,15,85,0,85
42,133,24,21,134,95,39
42,133,24,25,699,570,129
42,133,24,27,171,113,58
42,133,24,31,136,111,25
42,133,24,33,128,82,46
42,133,24,47,0,86,-86
42,133,24,510,561,431,130
42,133,32,3,0,58,-58
42,133,36,5,159,0,159
42,133,36,47,147,0,147
42,133,36,61,75,54,21
42,133,36,81,90,0,90
42,133,36,103,63,0,63
42,133,37,119,0,88,-88
42,133,37,183,0,92,-92
42,133,39,49,0,54,-54
42,133,42,1,2158,2625,-467
42,133,42,3,171,179,-8
42,133,42,11,236,170,66
42,133,42,17,89,78,11
42,133,42,27,76,67,9
42,133,42,29,195,169,26
42,133,42,41,2326,2524,-198
42,133,42,43,1435,1271,164
42,133,42,45,84,0,84
42,133,42,55,168,188,-20
42,133,42,71,2419,1954,465
42,133,42,75,268,214,54
42,133,42,77,61,91,-30
42,133,42,79,95,70,25
42,133,42,89,59,0,59
42,133,42,91,136,160,-24
42,133,42,99,142,177,-35
42,133,42,101,273,256,17
42,133,42,107,66,0,66
42,133,42,129,74,72,2
42,133,45,51,69,146,-77
42,133,48,29,0,56,-56
42,133,51,59,0,60,-60
44,1,25,5,476,433,43
44,1,25,17,52,67,-15
44,1,25,21,77,59,18
44,1,25,25,53,52,1
44,1,44,3,153,268,-115
44,1,44,5,458,337,121
44,1,44,7,1127,1060,67
44,1,44,9,83,71,12
44,3,4,13,0,75,-75
44,3,6,37,0,51,-51
44,3,9,3,0,67,-67
44,3,9,9,44,58,-14
44,3,9,11,158,216,-58
44,3,9,15,121,311,-190
44,3,12,11,54,0,54
44,3,12,71,0,96,-96
44,3,12,99,60,83,-23
44,3,12,103,0,55,-55
44,3,12,115,0,63,-63
44,3,25,5,464,426,38
44,3,25,17,151,183,-32
44,3,25,21,106,120,-14
44,3,25,23,84,55,29
44,3,25,25,101,100,1
44,3,25,27,202,118,84
44,3,33,11,59,52,7
44,3,44,1,268,153,115
44,3,44,5,334,249,85
44,3,44,7,6874,5139,1735
44,3,44,9,1663,1959,-296
44,5,6,37,0,53,-53
44,5,6,73,258,283,-25
44,5,9,1,72,0,72
44,5,9,3,74,55,19
44,5,9,11,60,58,2
44,5,12,11,0,57,-57
44,5,12,31,89,99,-10
44,5,12,99,46,66,-20
44,5,15,3,108,144,-36
44,5,24,3,0,93,-93
44,5,25,1,59,0,59
44,5,25,5,744,784,-40
44,5,25,17,157,119,38
44,5,25,21,122,82,40
44,5,25,23,64,52,12
44,5,25,25,112,98,14
44,5,25,27,101,0,101
44,5,36,47,57,43,14
44,5,36,61,75,49,26
44,5,44,1,337,458,-121
44,5,44,3,249,334,-85
44,5,44,7,675,667,8
44,5,44,9,388,585,-197
44,5,51,59,74,107,-33
44,5,51,810,126,93,33
44,7,4,13,88,206,-118
44,7,4,19,0,55,-55
44,7,6,1,52,78,-26
44,7,6,37,194,331,-137
44,7,6,59,74,62,12
44,7,6,73,88,150,-62
44,7,6,75,0,71,-71
44,7,6,81,0,55,-55
44,7,6,85,59,154,-95
44,7,8,31,0,62,-62
44,7,9,1,172,111,61
44,7,9,3,271,269,2
44,7,9,7,54,0,54
44,7,9,9,230,182,48
44,7,9,11,245,332,-87
44,7,9,13,44,0,44
44,7,9,15,287,652,-365
44,7,11,1,96,106,-10
44,7,12,9,0,85,-85
44,7,12,11,174,188,-14
44,7,12,15,0,63,-63
44,7,12,21,67,75,-8
44,7,12,31,0,63,-63
44,7,12,57,140,148,-8
44,7,12,69,0,66,-66
44,7,12,71,95,145,-50
44,7,12,81,0,62,-62
44,7,12,86,157,150,7
44,7,12,95,196,216,-20
44,7,12,97,82,96,-14
44,7,12,99,164,273,-109
44,7,12,101,0,95,-95
44,7,12,103,116,114,2
44,7,12,105,79,124,-45
44,7,12,111,0,85,-85
44,7,12,115,0,109,-109
44,7,12,127,0,84,-84
44,7,13,67,0,59,-59
44,7,13,89,0,65,-65
44,7,13,121,0,74,-74
44,7,13,135,0,105,-105
44,7,17,31,190,212,-22
44,7,23,5,58,69,-11
44,7,24,31,69,101,-32
44,7,24,510,59,67,-8
44,7,25,1,164,161,3
44,7,25,5,3284,3435,-151
44,7,25,9,433,268,165
44,7,25,13,123,130,-7
44,7,25,15,0,56,-56
44,7,25,17,1142,900,242
44,7,25,21,1632,1142,490
44,7,25,23,580,390,190
44,7,25,25,1286,906,380
44,7,25,27,1452,1292,160
44,7,27,53,0,72,-72
44,7,32,3,0,92,-92
44,7,33,9,55,72,-17
44,7,33,11,141,165,-24
44,7,33,13,0,52,-52
44,7,33,15,79,107,-28
44,7,34,3,87,0,87
44,7,34,17,88,113,-25
44,7,34,23,94,73,21
44,7,34,31,72,0,72
44,7,36,1,49,0,49
44,7,36,5,470,158,312
44,7,36,47,371,238,133
44,7,36,55,50,0,50
44,7,36,59,99,0,99
44,7,36,61,356,310,46
44,7,36,81,242,139,103
44,7,36,103,117,95,22
44,7,36,119,105,67,38
44,7,37,63,0,50,-50
44,7,37,119,98,150,-52
44,7,37,183,54,143,-89
44,7,39,49,69,65,4
44,7,41,51,0,47,-47
44,7,42,3,61,85,-24
44,7,42,101,150,137,13
44,7,44,1,1060,1127,-67
44,7,44,3,5139,6874,-1735
44,7,44,5,667,675,-8
44,7,44,9,1349,1843,-494
44,7,45,19,0,67,-67
44,7,48,29,0,55,-55
44,7,48,85,0,92,-92
44,7,48,113,80,115,-35
44,7,48,121,0,62,-62
44,7,48,201,136,125,11
44,7,48,439,0,59,-59
44,7,48,453,75,87,-12
44,7,50,7,0,54,-54
44,7,51,59,52,87,-35
44,7,53,33,90,155,-65
44,9,9,1,107,0,107
44,9,9,3,243,96,147
44,9,9,9,111,65,46
44,9,9,11,650,973,-323
44,9,9,13,72,0,72
44,9,9,15,56,101,-45
44,9,12,15,0,48,-48
44,9,12,21,0,79,-79
44,9,12,71,0,78,-78
44,9,12,99,63,102,-39
44,9,12,115,0,80,-80
44,9,25,5,163,124,39
44,9,25,13,59,0,59
44,9,25,17,133,159,-26
44,9,25,21,112,102,10
44,9,25,25,106,107,-1
44,9,25,27,98,68,30
44,9,36,61,60,58,2
44,9,36,119,55,0,55
44,9,44,1,71,83,-12
44,9,44,3,1959,1663,296
44,9,44,5,585,388,197
44,9,44,7,1843,1349,494
45,1,45,7,539,400,139
45,1,45,45,119,115,4
45,1,45,47,454,422,32
45,1,45,59,68,63,5
45,3,12,11,80,0,80
45,3,12,31,53,76,-23
45,3,12,99,56,0,56
45,3,13,33,60,72,-12
45,3,13,67,0,77,-77
45,3,13,73,697,677,20
45,3,13,89,0,57,-57
45,3,13,121,0,82,-82
45,3,13,245,1742,1389,353
45,3,37,119,102,92,10
45,3,45,5,65,0,65
45,3,45,11,342,217,125
45,3,45,13,106,75,31
45,3,45,15,61,62,-1
45,3,45,19,173,109,64
45,3,45,35,79,82,-3
45,3,45,37,984,935,49
45,3,45,45,139,225,-86
45,3,45,47,82,75,7
45,3,45,51,80,0,80
45,3,45,63,570,683,-113
45,3,45,75,119,72,47
45,3,45,79,340,416,-76
45,3,45,81,236,205,31
45,3,45,83,0,58,-58
45,3,45,91,0,81,-81
45,5,45,3,0,65,-65
45,5,45,11,75,89,-14
45,5,45,49,87,90,-3
45,7,13,121,0,52,-52
45,7,13,135,81,0,81
45,7,13,147,147,78,69
45,7,37,119,84,125,-41
45,7,45,1,400,539,-139
45,7,45,13,67,0,67
45,7,45,15,77,0,77
45,7,45,19,95,114,-19
45,7,45,45,3324,2822,502
45,7,45,47,258,203,55
45,7,45,51,136,63,73
45,7,45,59,207,158,49
45,7,45,63,140,140,0
45,7,45,73,690,652,38
45,7,45,77,1922,1620,302
45,7,45,79,149,100,49
45,7,45,83,390,460,-70
45,7,45,91,91,0,91
45,9,45,11,96,106,-10
45,9,45,75,173,170,3
45,9,45,79,0,50,-50
45,11,45,3,217,342,-125
45,11,45,5,89,75,14
45,11,45,9,106,96,10
45,11,45,63,0,79,-79
45,11,45,75,0,54,-54
45,11,45,79,0,85,-85
45,13,4,13,141,87,54
45,13,4,27,0,130,-130
45,13,6,37,153,87,66
45,13,6,59,85,0,85
45,13,6,65,77,82,-5
45,13,6,71,69,88,-19
45,13,6,73,478,442,36
45,13,9,1,145,0,145
45,13,9,3,98,0,98
45,13,9,9,81,0,81
45,13,12,9,0,68,-68
45,13,12,11,83,67,16
45,13,12,21,0,58,-58
45,13,12,31,92,192,-100
45,13,12,33,57,0,57
45,13,12,57,65,81,-16
45,13,12,71,68,56,12
45,13,12,86,71,80,-9
45,13,12,95,91,112,-21
45,13,12,99,92,82,10
45,13,12,103,0,68,-68
45,13,12,109,0,91,-91
45,13,12,127,55,0,55
45,13,13,51,566,518,48
45,13,13,67,131,72,59
45,13,13,89,75,85,-10
45,13,13,103,96,164,-68
45,13,13,121,204,126,78
45,13,13,135,106,91,15
45,13,15,3,92,124,-32
45,13,17,31,78,0,78
45,13,17,97,88,0,88
45,13,24,5,62,0,62
45,13,24,31,70,0,70
45,13,25,9,57,0,57
45,13,25,17,98,0,98
45,13,34,3,72,0,72
45,13,34,23,69,0,69
45,13,34,25,108,0,108
45,13,34,27,102,0,102
45,13,34,29,62,0,62
45,13,36,59,80,0,80
45,13,36,61,85,55,30
45,13,36,103,193,0,193
45,13,36,119,77,0,77
45,13,37,21,60,79,-19
45,13,37,49,117,92,25
45,13,37,67,73,0,73
45,13,37,89,0,62,-62
45,13,37,119,242,205,37
45,13,37,129,0,57,-57
45,13,37,133,415,448,-33
45,13,37,183,111,97,14
45,13,39,35,56,0,56
45,13,39,49,114,49,65
45,13,42,3,114,0,114
45,13,45,3,75,106,-31
45,13,45,7,0,67,-67
45,13,45,15,118,185,-67
45,13,45,19,392,469,-77
45,13,45,29,97,102,-5
45,13,45,35,127,112,15
45,13,45,45,174,289,-115
45,13,45,49,162,187,-25
45,13,45,51,115,96,19
45,13,45,53,978,1498,-520
45,13,45,63,113,152,-39
45,13,45,79,240,282,-42
45,13,45,83,62,81,-19
45,13,45,91,180,112,68
45,13,47,93,77,0,77
45,13,48,29,0,64,-64
45,13,48,113,60,0,60
45,13,48,201,65,0,65
45,13,51,59,205,68,137
45,13,51,107,72,0,72
45,13,51,153,126,114,12
45,13,51,810,95,87,8
45,15,4,13,93,70,23
45,15,6,37,99,91,8
45,15,6,73,241,223,18
45,15,8,41,66,0,66
45,15,9,1,100,0,100
45,15,9,11,114,222,-108
45,15,12,9,59,0,59
45,15,12,11,74,0,74
45,15,12,31,202,174,28
45,15,12,57,110,0,110
45,15,12,86,73,48,25
45,15,12,95,62,71,-9
45,15,12,99,66,0,66
45,15,13,39,141,161,-20
45,15,13,51,62,84,-22
45,15,13,67,58,63,-5
45,15,13,121,108,91,17
45,15,13,135,70,89,-19
45,15,13,245,63,0,63
45,15,15,3,178,170,8
45,15,16,17,71,0,71
45,15,17,31,64,0,64
45,15,24,3,62,0,62
45,15,24,5,59,0,59
45,15,32,3,0,58,-58
45,15,36,5,63,0,63
45,15,36,47,79,0,79
45,15,36,61,64,0,64
45,15,36,91,0,554,-554
45,15,36,103,151,0,151
45,15,37,51,90,0,90
45,15,37,119,236,200,36
45,15,37,133,81,0,81
45,15,37,183,115,68,47
45,15,42,3,73,0,73
45,15,45,3,62,61,1
45,15,45,7,0,77,-77
45,15,45,13,185,118,67
45,15,45,19,8531,5763,2768
45,15,45,27,0,63,-63
45,15,45,29,178,251,-73
45,15,45,35,4992,4544,448
45,15,45,41,111,0,111
45,15,45,43,70,93,-23
45,15,45,45,152,311,-159
45,15,45,51,250,132,118
45,15,45,63,136,277,-141
45,15,45,75,302,396,-94
45,15,45,79,357,285,72
45,15,45,83,148,147,1
45,15,45,85,73,81,-8
45,15,45,91,90,99,-9
45,15,48,29,80,61,19
45,15,48,201,63,84,-21
45,15,48,439,0,86,-86
45,15,51,59,101,0,101
45,15,51,550,75,107,-32
45,15,51,650,75,71,4
45,15,51,700,71,98,-27
45,15,51,710,100,270,-170
45,15,51,810,145,154,-9
45,15,53,33,70,72,-2
45,15,53,35,244,306,-62
45,15,53,53,82,0,82
45,15,53,61,64,0,64
45,17,45,63,295,283,12
45,17,45,75,317,380,-63
45,17,45,79,112,153,-41
45,19,1,73,74,0,74
45,19,4,13,127,159,-32
45,19,6,37,225,181,44
45,19,6,59,89,0,89
45,19,6,73,243,231,12
45,19,6,75,63,60,3
45,19,8,13,0,59,-59
45,19,8,31,86,147,-61
45,19,8,41,78,69,9
45,19,9,1,202,77,125
45,19,9,3,123,0,123
45,19,9,9,85,0,85
45,19,9,11,70,56,14
45,19,10,5,56,0,56
45,19,11,1,201,145,56
45,19,12,9,49,100,-51
45,19,12,11,172,144,28
45,19,12,21,54,0,54
45,19,12,31,169,234,-65
45,19,12,57,143,159,-16
45,19,12,71,50,0,50
45,19,12,86,123,91,32
45,19,12,89,0,49,-49
45,19,12,91,0,65,-65
45,19,12,95,123,149,-26
45,19,12,99,141,98,43
45,19,12,103,71,116,-45
45,19,12,109,0,71,-71
45,19,12,127,0,58,-58
45,19,13,51,185,186,-1
45,19,13,67,173,129,44
45,19,13,73,74,0,74
45,19,13,89,198,189,9
45,19,13,121,356,309,47
45,19,13,135,126,145,-19
45,19,13,245,96,66,30
45,19,15,3,98,99,-1
45,19,17,31,291,147,144
45,19,17,43,89,0,89
45,19,18,97,62,0,62
45,19,21,67,57,0,57
45,19,21,111,83,0,83
45,19,22,71,60,53,7
45,19,24,3,171,73,98
45,19,24,5,85,0,85
45,19,24,27,49,0,49
45,19,24,31,146,72,74
45,19,24,33,73,0,73
45,19,24,510,109,49,60
45,19,25,9,62,0,62
45,19,25,17,149,79,70
45,19,25,21,99,0,99
45,19,25,23,62,0,62
45,19,25,25,104,49,55
45,19,25,27,63,0,63
45,19,26,125,91,56,35
45,19,26,163,71,0,71
45,19,32,3,74,125,-51
45,19,33,11,72,0,72
45,19,33,15,59,0,59
45,19,34,3,110,0,110
45,19,34,5,84,0,84
45,19,34,17,71,51,20
45,19,34,23,58,0,58
45,19,34,25,63,0,63
45,19,34,27,79,0,79
45,19,34,29,73,0,73
45,19,34,35,63,0,63
45,19,36,5,75,0,75
45,19,36,29,59,0,59
45,19,36,47,155,94,61
45,19,36,55,61,0,61
45,19,36,59,118,0,118
45,19,36,61,283,165,118
45,19,36,67,64,0,64
45,19,36,71,74,0,74
45,19,36,81,101,0,101
45,19,36,91,0,64,-64
45,19,36,103,189,63,126
45,19,36,119,98,0,98
45,19,37,21,134,199,-65
45,19,37,51,97,0,97
45,19,37,63,59,88,-29
45,19,37,67,114,100,14
45,19,37,71,59,65,-6
45,19,37,81,121,99,22
45,19,37,89,0,66,-66
45,19,37,97,91,0,91
45,19,37,119,807,688,119
45,19,37,129,118,79,39
45,19,37,133,81,0,81
45,19,37,135,51,0,51
45,19,37,179,88,69,19
45,19,37,183,311,244,67
45,19,39,35,78,69,9
45,19,39,49,156,80,76
45,19,39,61,97,0,97
45,19,39,113,78,0,78
45,19,39,153,60,0,60
45,19,41,51,0,75,-75
45,19,42,3,153,104,49
45,19,42,29,93,0,93
45,19,42,91,70,0,70
45,19,42,101,78,61,17
45,19,44,7,67,0,67
45,19,45,3,109,173,-64
45,19,45,7,114,95,19
45,19,45,13,469,392,77
45,19,45,15,5763,8531,-2768
45,19,45,27,88,56,32
45,19,45,29,307,406,-99
45,19,45,31,61,0,61
45,19,45,35,4744,5975,-1231
45,19,45,41,172,93,79
45,19,45,43,189,220,-31
45,19,45,45,564,751,-187
45,19,45,47,77,67,10
45,19,45,51,581,382,199
45,19,45,55,56,0,56
45,19,45,57,68,0,68
45,19,45,63,448,372,76
45,19,45,73,70,101,-31
45,19,45,75,215,211,4
45,19,45,77,127,146,-19
45,19,45,79,806,734,72
45,19,45,83,251,253,-2
45,19,45,85,141,67,74
45,19,45,91,297,192,105
45,19,47,37,141,134,7
45,19,47,93,87,76,11
45,19,47,157,69,68,1
45,19,48,29,103,104,-1
45,19,48,113,67,79,-12
45,19,48,201,162,174,-12
45,19,48,439,114,69,45
45,19,48,453,87,130,-43
45,19,49,35,0,65,-65
45,19,51,13,108,71,37
45,19,51,41,60,0,60
45,19,51,59,258,173,85
45,19,51,107,120,0,120
45,19,51,153,71,0,71
45,19,51,510,88,51,37
45,19,51,550,52,55,-3
45,19,51,710,0,86,-86
45,19,51,760,51,82,-31
45,19,51,810,87,109,-22
45,19,53,33,150,255,-105
45,19,53,35,0,88,-88
45,19,53,53,81,83,-2
45,19,53,61,89,58,31
45,21,37,45,209,213,-4
45,21,37,71,164,115,49
45,21,37,119,125,52,73
45,21,37,161,87,58,29
45,21,45,45,146,122,24
45,21,45,83,1137,1244,-107
45,21,45,87,87,85,2
45,21,45,91,207,141,66
45,23,37,119,142,90,52
45,23,45,39,84,100,-16
45,23,45,57,192,259,-67
45,23,45,79,70,63,7
45,23,45,91,1027,816,211
45,25,37,7,91,0,91
45,25,37,119,114,88,26
45,25,37,179,236,204,32
45,25,45,31,284,310,-26
45,25,45,41,95,112,-17
45,25,45,51,0,62,-62
45,25,45,55,0,63,-63
45,25,45,57,113,91,22
45,25,45,69,193,169,24
45,25,45,79,0,87,-87
45,27,45,15,63,0,63
45,27,45,19,56,88,-32
45,27,45,35,62,0,62
45,27,45,41,179,144,35
45,27,45,75,71,57,14
45,27,45,79,92,174,-82
45,27,45,85,495,629,-134
45,27,45,89,108,85,23
45,29,45,13,102,97,5
45,29,45,15,251,178,73
45,29,45,19,406,307,99
45,29,45,35,487,366,121
45,29,45,49,88,69,19
45,29,45,63,0,66,-66
45,29,45,75,0,66,-66
45,29,45,79,70,86,-16
45,31,37,119,76,102,-26
45,31,45,19,0,61,-61
45,31,45,25,310,284,26
45,31,45,41,1516,1566,-50
45,31,45,51,117,96,21
45,31,45,61,158,153,5
45,31,45,63,0,61,-61
45,31,45,67,67,0,67
45,31,45,69,76,0,76
45,31,45,79,113,229,-116
45,31,45,85,65,0,65
45,33,37,155,101,132,-31
45,33,45,41,142,174,-32
45,33,45,51,104,72,32
45,33,45,67,290,230,60
45,33,45,69,0,98,-98
45,35,4,13,0,86,-86
45,35,6,59,69,0,69
45,35,6,73,93,67,26
45,35,12,9,0,73,-73
45,35,12,31,82,85,-3
45,35,12,57,69,0,69
45,35,13,51,77,78,-1
45,35,13,121,58,48,10
45,35,24,3,61,0,61
45,35,37,51,0,74,-74
45,35,37,119,134,173,-39
45,35,37,183,53,78,-25
45,35,45,3,82,79,3
45,35,45,13,112,127,-15
45,35,45,15,4544,4992,-448
45,35,45,19,5975,4744,1231
45,35,45,27,0,62,-62
45,35,45,29,366,487,-121
45,35,45,41,71,0,71
45,35,45,45,140,224,-84
45,35,45,51,211,148,63
45,35,45,63,157,192,-35
45,35,45,75,261,383,-122
45,35,45,79,225,318,-93
45,35,45,83,96,83,13
45,35,45,91,62,112,-50
45,35,51,810,97,0,97
45,35,53,33,0,72,-72
45,35,53,35,86,0,86
45,37,13,73,144,90,54
45,37,13,245,190,163,27
45,37,45,3,935,984,-49
45,37,45,63,0,71,-71
45,37,45,81,111,86,25
45,39,45,23,100,84,16
45,39,45,55,100,142,-42
45,39,45,63,82,115,-33
45,39,45,71,0,72,-72
45,39,45,79,565,627,-62
45,41,37,51,72,64,8
45,41,37,119,130,205,-75
45,41,37,183,0,80,-80
45,41,45,15,0,111,-111
45,41,45,19,93,172,-79
45,41,45,25,112,95,17
45,41,45,27,144,179,-35
45,41,45,31,1566,1516,50
45,41,45,33,174,142,32
45,41,45,35,0,71,-71
45,41,45,43,108,159,-51
45,41,45,45,100,251,-151
45,41,45,51,381,402,-21
45,41,45,55,0,57,-57
45,41,45,61,87,77,10
45,41,45,63,73,171,-98
45,41,45,67,338,209,129
45,41,45,69,65,0,65
45,41,45,79,266,479,-213
45,41,45,83,0,81,-81
45,41,45,85,194,234,-40
45,41,45,89,504,446,58
45,41,45,91,0,84,-84
45,43,36,103,60,0,60
45,43,37,119,132,74,58
45,43,45,15,93,70,23
45,43,45,19,220,189,31
45,43,45,41,159,108,51
45,43,45,45,0,77,-77
45,43,45,51,1297,1534,-237
45,43,45,79,104,128,-24
45,43,45,89,355,341,14
45,43,45,91,58,0,58
45,45,1,73,0,75,-75
45,45,4,13,169,166,3
45,45,6,37,191,84,107
45,45,6,59,82,0,82
45,45,6,71,77,0,77
45,45,6,73,173,92,81
45,45,6,85,0,67,-67
45,45,8,31,62,82,-20
45,45,8,41,0,63,-63
45,45,9,1,94,0,94
45,45,9,3,81,0,81
45,45,9,9,88,0,88
45,45,11,1,46,48,-2
45,45,12,1,67,0,67
45,45,12,9,85,76,9
45,45,12,11,234,109,125
45,45,12,31,162,109,53
45,45,12,57,176,118,58
45,45,12,71,147,91,56
45,45,12,86,241,74,167
45,45,12,95,216,138,78
45,45,12,99,229,119,110
45,45,12,101,85,0,85
45,45,12,103,129,81,48
45,45,12,105,64,73,-9
45,45,12,111,63,0,63
45,45,12,115,70,74,-4
45,45,12,117,95,0,95
45,45,12,127,83,59,24
45,45,13,51,120,61,59
45,45,13,67,204,161,43
45,45,13,73,84,0,84
45,45,13,89,139,201,-62
45,45,13,121,314,285,29
45,45,13,135,206,184,22
45,45,13,245,103,0,103
45,45,15,3,67,0,67
45,45,17,31,171,146,25
45,45,18,97,83,0,83
45,45,21,111,0,66,-66
45,45,24,3,65,0,65
45,45,24,5,56,0,56
45,45,24,31,61,58,3
45,45,25,17,67,65,2
45,45,26,81,50,0,50
45,45,26,125,141,117,24
45,45,26,163,106,83,23
45,45,32,3,85,71,14
45,45,34,3,101,0,101
45,45,34,13,97,0,97
45,45,34,23,67,0,67
45,45,34,29,75,0,75
45,45,36,5,70,0,70
45,45,36,29,88,0,88
45,45,36,47,88,68,20
45,45,36,55,80,0,80
45,45,36,59,94,0,94
45,45,36,61,52,66,-14
45,45,36,81,114,0,114
45,45,36,103,177,0,177
45,45,36,119,54,0,54
45,45,37,21,412,248,164
45,45,37,25,60,64,-4
45,45,37,35,63,57,6
45,45,37,51,83,0,83
45,45,37,63,73,68,5
45,45,37,67,131,76,55
45,45,37,71,115,132,-17
45,45,37,81,151,82,69
45,45,37,89,326,148,178
45,45,37,119,760,675,85
45,45,37,129,60,62,-2
45,45,37,133,64,0,64
45,45,37,149,70,74,-4
45,45,37,179,107,0,107
45,45,37,183,246,260,-14
45,45,39,35,97,0,97
45,45,39,49,107,119,-12
45,45,39,61,105,0,105
45,45,42,3,97,0,97
45,45,45,1,115,119,-4
45,45,45,3,225,139,86
45,45,45,7,2822,3324,-502
45,45,45,13,289,174,115
45,45,45,15,311,152,159
45,45,45,19,751,564,187
45,45,45,21,122,146,-24
45,45,45,35,224,140,84
45,45,45,41,251,100,151
45,45,45,43,77,0,77
45,45,45,47,465,290,175
45,45,45,51,356,261,95
45,45,45,55,70,57,13
45,45,45,57,62,0,62
45,45,45,59,1583,1778,-195
45,45,45,63,533,387,146
45,45,45,71,59,58,1
45,45,45,73,406,417,-11
45,45,45,75,104,0,104
45,45,45,77,2341,2621,-280
45,45,45,79,797,569,228
45,45,45,83,4881,7038,-2157
45,45,45,85,124,74,50
45,45,45,87,74,68,6
45,45,45,91,394,339,55
45,45,47,37,157,79,78
45,45,47,65,124,62,62
45,45,47,93,121,75,46
45,45,47,157,91,0,91
45,45,47,179,60,0,60
45,45,48,29,59,0,59
45,45,48,85,0,63,-63
45,45,48,113,111,121,-10
45,45,48,121,69,0,69
45,45,48,201,241,138,103
45,45,48,439,99,66,33
45,45,48,453,128,0,128
45,45,51,59,139,0,139
45,45,53,33,74,75,-1
45,47,45,1,422,454,-32
45,47,45,3,75,82,-7
45,47,45,7,203,258,-55
45,47,45,19,67,77,-10
45,47,45,45,290,465,-175
45,47,45,59,339,402,-63
45,47,45,63,73,95,-22
45,47,45,65,157,146,11
45,47,45,77,0,69,-69
45,47,45,79,110,143,-33
45,47,45,81,133,188,-55
45,47,45,83,116,159,-43
45,49,45,5,90,87,3
45,49,45,13,187,162,25
45,49,45,29,69,88,-19
45,49,45,53,156,152,4
45,49,45,79,0,63,-63
45,51,4,13,121,143,-22
45,51,6,37,98,61,37
45,51,6,73,91,48,43
45,51,9,1,180,60,120
45,51,9,3,333,56,277
45,51,9,5,110,0,110
45,51,9,7,77,0,77
45,51,9,9,290,75,215
45,51,9,11,80,0,80
45,51,9,13,96,0,96
45,51,10,3,117,0,117
45,51,11,1,0,58,-58
45,51,12,9,54,0,54
45,51,12,11,156,93,63
45,51,12,31,70,131,-61
45,51,12,57,57,131,-74
45,51,12,69,61,0,61
45,51,12,71,88,62,26
45,51,12,95,67,101,-34
45,51,12,99,116,127,-11
45,51,12,103,75,85,-10
45,51,12,105,66,71,-5
45,51,12,115,57,57,0
45,51,12,127,59,46,13
45,51,13,51,68,59,9
45,51,13,67,104,60,44
45,51,13,89,59,52,7
45,51,13,121,0,66,-66
45,51,13,135,93,73,20
45,51,17,31,58,0,58
45,51,24,3,223,74,149
45,51,24,5,200,61,139
45,51,24,9,76,0,76
45,51,24,13,83,0,83
45,51,24,17,98,0,98
45,51,24,21,115,0,115
45,51,24,25,130,0,130
45,51,24,31,129,0,129
45,51,24,33,129,0,129
45,51,24,43,72,0,72
45,51,24,510,58,0,58
45,51,25,1,54,0,54
45,51,25,5,114,0,114
45,51,25,9,73,0,73
45,51,25,13,117,0,117
45,51,25,17,115,0,115
45,51,25,21,66,0,66
45,51,25,23,85,0,85
45,51,25,27,167,0,167
45,51,26,125,80,0,80
45,51,26,163,58,0,58
45,51,32,3,133,125,8
45,51,33,11,85,0,85
45,51,33,15,70,0,70
45,51,34,1,75,0,75
45,51,34,3,121,0,121
45,51,34,5,108,0,108
45,51,34,7,92,0,92
45,51,34,13,70,0,70
45,51,34,15,85,0,85
45,51,34,21,135,0,135
45,51,34,23,167,0,167
45,51,34,25,239,0,239
45,51,34,27,217,0,217
45,51,34,29,388,66,322
45,51,34,31,75,0,75
45,51,34,35,111,0,111
45,51,34,37,64,0,64
45,51,34,39,114,0,114
45,51,34,41,69,0,69
45,51,36,1,82,0,82
45,51,36,5,55,0,55
45,51,36,7,72,0,72
45,51,36,27,170,0,170
45,51,36,29,62,0,62
45,51,36,47,84,50,34
45,51,36,55,88,0,88
45,51,36,59,247,0,247
45,51,36,65,59,0,59
45,51,36,67,83,0,83
45,51,36,71,305,68,237
45,51,36,79,70,0,70
45,51,36,81,131,0,131
45,51,36,85,70,0,70
45,51,36,87,92,0,92
45,51,36,91,104,0,104
45,51,36,103,531,95,436
45,51,36,111,118,0,118
45,51,36,119,192,0,192
45,51,37,19,648,488,160
45,51,37,21,58,76,-18
45,51,37,25,160,0,160
45,51,37,35,77,0,77
45,51,37,47,431,359,72
45,51,37,51,215,163,52
45,51,37,57,117,0,117
45,51,37,63,85,61,24
45,51,37,67,166,72,94
45,51,37,71,174,71,103
45,51,37,81,215,185,30
45,51,37,97,118,0,118
45,51,37,101,78,64,14
45,51,37,119,561,401,160
45,51,37,129,175,158,17
45,51,37,133,111,116,-5
45,51,37,147,71,0,71
45,51,37,151,107,64,43
45,51,37,155,100,0,100
45,51,37,159,70,70,0
45,51,37,179,123,86,37
45,51,37,183,290,234,56
45,51,39,17,55,0,55
45,51,39,35,67,56,11
45,51,39,49,120,75,45
45,51,39,151,79,0,79
45,51,39,153,65,0,65
45,51,42,3,216,81,135
45,51,42,7,62,0,62
45,51,42,11,111,0,111
45,51,42,17,132,0,132
45,51,42,29,65,0,65
45,51,42,41,70,0,70
45,51,42,43,57,0,57
45,51,42,71,132,0,132
45,51,42,77,75,0,75
45,51,42,79,49,0,49
45,51,42,89,96,0,96
45,51,42,91,108,59,49
45,51,42,95,90,0,90
45,51,42,101,88,0,88
45,51,42,125,58,0,58
45,51,42,129,131,0,131
45,51,42,133,146,69,77
45,51,45,3,0,80,-80
45,51,45,7,63,136,-73
45,51,45,13,96,115,-19
45,51,45,15,132,250,-118
45,51,45,19,382,581,-199
45,51,45,25,62,0,62
45,51,45,31,96,117,-21
45,51,45,33,72,104,-32
45,51,45,35,148,211,-63
45,51,45,41,402,381,21
45,51,45,43,1534,1297,237
45,51,45,45,261,356,-95
45,51,45,55,0,75,-75
45,51,45,57,109,70,39
45,51,45,63,231,272,-41
45,51,45,67,361,401,-40
45,51,45,73,0,76,-76
45,51,45,77,0,63,-63
45,51,45,79,350,412,-62
45,51,45,83,106,190,-84
45,51,45,85,108,114,-6
45,51,45,89,113,102,11
45,51,45,91,292,254,38
45,51,47,37,0,66,-66
45,51,47,93,61,81,-20
45,51,48,453,63,53,10
45,51,51,41,84,0,84
45,51,51,59,246,80,166
45,51,51,107,100,0,100
45,51,51,153,179,71,108
45,51,51,179,67,0,67
45,51,51,810,50,63,-13
45,51,54,3,71,0,71
45,51,54,39,122,0,122
45,51,54,55,79,0,79
45,51,54,61,67,0,67
45,53,13,51,127,179,-52
45,53,13,103,0,83,-83
45,53,45,13,1498,978,520
45,53,45,49,152,156,-4
45,53,45,79,0,50,-50
45,55,37,119,67,68,-1
45,55,45,19,0,56,-56
45,55,45,25,63,0,63
45,55,45,39,142,100,42
45,55,45,41,57,0,57
45,55,45,45,57,70,-13
45,55,45,51,75,0,75
45,55,45,57,281,163,118
45,55,45,61,164,120,44
45,55,45,63,325,312,13
45,55,45,79,1651,1220,431
45,55,45,85,227,214,13
45,55,45,91,77,0,77
45,57,36,59,65,0,65
45,57,36,103,92,0,92
45,57,37,71,74,69,5
45,57,37,119,2446,1092,1354
45,57,37,179,953,548,405
45,57,45,19,0,68,-68
45,57,45,23,259,192,67
45,57,45,25,91,113,-22
45,57,45,45,0,62,-62
45,57,45,51,70,109,-39
45,57,45,55,163,281,-118
45,57,45,63,0,77,-77
45,57,45,79,131,104,27
45,57,45,91,1450,1410,40
45,59,45,1,63,68,-5
45,59,45,7,158,207,-49
45,59,45,45,1778,1583,195
45,59,45,47,402,339,63
45,59,45,63,65,67,-2
45,59,45,71,139,137,2
45,59,45,77,106,103,3
45,59,45,79,106,69,37
45,59,45,83,406,465,-59
45,61,45,31,153,158,-5
45,61,45,41,77,87,-10
45,61,45,55,120,164,-44
45,61,45,79,80,104,-24
45,61,45,85,220,289,-69
45,63,4,13,122,72,50
45,63,6,37,64,49,15
45,63,6,59,61,0,61
45,63,6,73,75,0,75
45,63,9,9,57,0,57
45,63,12,11,127,0,127
45,63,12,31,0,79,-79
45,63,12,57,85,0,85
45,63,12,86,101,0,101
45,63,12,95,83,0,83
45,63,12,99,57,0,57
45,63,12,103,61,80,-19
45,63,12,105,61,0,61
45,63,12,127,0,55,-55
45,63,13,51,66,61,5
45,63,13,67,0,81,-81
45,63,13,73,80,99,-19
45,63,13,89,0,51,-51
45,63,13,121,74,78,-4
45,63,13,135,65,92,-27
45,63,13,245,88,124,-36
45,63,17,31,84,0,84
45,63,36,47,74,0,74
45,63,36,103,94,0,94
45,63,37,21,51,56,-5
45,63,37,51,74,0,74
45,63,37,119,258,369,-111
45,63,37,133,0,70,-70
45,63,37,183,132,89,43
45,63,45,3,683,570,113
45,63,45,7,140,140,0
45,63,45,11,79,0,79
45,63,45,13,152,113,39
45,63,45,15,277,136,141
45,63,45,17,283,295,-12
45,63,45,19,372,448,-76
45,63,45,29,66,0,66
45,63,45,31,61,0,61
45,63,45,35,192,157,35
45,63,45,37,71,0,71
45,63,45,39,115,82,33
45,63,45,41,171,73,98
45,63,45,45,387,533,-146
45,63,45,47,95,73,22
45,63,45,51,272,231,41
45,63,45,55,312,325,-13
45,63,45,57,77,0,77
45,63,45,59,67,65,2
45,63,45,71,400,471,-71
45,63,45,75,600,312,288
45,63,45,77,69,86,-17
45,63,45,79,9666,8210,1456
45,63,45,81,370,468,-98
45,63,45,83,216,207,9
45,63,45,85,323,197,126
45,63,45,91,260,207,53
45,63,48,201,64,0,64
45,63,51,810,59,0,59
45,65,13,73,77,0,77
45,65,45,47,146,157,-11
45,67,45,31,0,67,-67
45,67,45,33,230,290,-60
45,67,45,41,209,338,-129
45,67,45,51,401,361,40
45,67,45,79,0,125,-125
45,69,37,165,131,166,-35
45,69,45,25,169,193,-24
45,69,45,31,0,76,-76
45,69,45,33,98,0,98
45,69,45,41,0,65,-65
45,71,45,39,72,0,72
45,71,45,45,58,59,-1
45,71,45,59,137,139,-2
45,71,45,63,471,400,71
45,71,45,79,329,414,-85
45,71,45,81,0,58,-58
45,71,45,83,57,71,-14
45,73,13,121,63,0,63
45,73,13,135,73,0,73
45,73,13,257,63,0,63
45,73,45,7,652,690,-38
45,73,45,19,101,70,31
45,73,45,45,417,406,11
45,73,45,51,76,0,76
45,73,45,77,753,739,14
45,73,45,83,113,81,32
45,75,37,119,0,89,-89
45,75,45,3,72,119,-47
45,75,45,9,170,173,-3
45,75,45,11,54,0,54
45,75,45,15,396,302,94
45,75,45,17,380,317,63
45,75,45,19,211,215,-4
45,75,45,27,57,71,-14
45,75,45,29,66,0,66
45,75,45,35,383,261,122
45,75,45,45,0,104,-104
45,75,45,63,312,600,-288
45,75,45,79,384,798,-414
45,75,45,85,67,71,-4
45,77,13,121,0,62,-62
45,77,37,21,65,0,65
45,77,37,119,61,95,-34
45,77,37,183,0,51,-51
45,77,45,7,1620,1922,-302
45,77,45,19,146,127,19
45,77,45,45,2621,2341,280
45,77,45,47,69,0,69
45,77,45,51,63,0,63
45,77,45,59,103,106,-3
45,77,45,63,86,69,17
45,77,45,73,739,753,-14
45,77,45,79,109,103,6
45,77,45,83,271,331,-60
45,79,1,73,0,57,-57
45,79,4,13,116,160,-44
45,79,6,37,152,142,10
45,79,6,59,0,57,-57
45,79,6,71,71,0,71
45,79,6,73,99,79,20
45,79,8,31,0,56,-56
45,79,8,41,234,224,10
45,79,9,1,51,0,51
45,79,9,3,69,0,69
45,79,11,1,76,77,-1
45,79,12,11,167,64,103
45,79,12,31,135,130,5
45,79,12,57,113,184,-71
45,79,12,71,68,0,68
45,79,12,86,125,80,45
45,79,12,91,0,77,-77
45,79,12,95,103,158,-55
45,79,12,99,145,62,83
45,79,12,103,0,93,-93
45,79,13,51,132,123,9
45,79,13,63,64,0,64
45,79,13,67,142,149,-7
45,79,13,73,128,166,-38
45,79,13,89,157,185,-28
45,79,13,121,197,310,-113
45,79,13,135,162,149,13
45,79,13,179,142,98,44
45,79,13,215,115,0,115
45,79,13,245,265,271,-6
45,79,15,3,290,253,37
45,79,17,31,107,91,16
45,79,18,97,54,0,54
45,79,20,61,93,84,9
45,79,21,111,0,69,-69
45,79,22,71,60,0,60
45,79,22,115,81,0,81
45,79,24,3,67,0,67
45,79,24,31,61,76,-15
45,79,24,33,77,73,4
45,79,25,17,0,61,-61
45,79,32,3,68,81,-13
45,79,34,13,60,0,60
45,79,36,5,91,0,91
45,79,36,45,119,93,26
45,79,36,47,115,99,16
45,79,36,61,71,86,-15
45,79,36,81,77,0,77
45,79,36,103,70,0,70
45,79,37,21,58,107,-49
45,79,37,25,84,89,-5
45,79,37,51,373,334,39
45,79,37,63,0,87,-87
45,79,37,67,62,83,-21
45,79,37,71,73,115,-42
45,79,37,81,102,120,-18
45,79,37,85,0,106,-106
45,79,37,119,776,1103,-327
45,79,37,179,0,69,-69
45,79,37,183,162,296,-134
45,79,39,35,55,0,55
45,79,39,49,108,70,38
45,79,39,61,57,57,0
45,79,40,31,64,70,-6
45,79,42,3,94,83,11
45,79,42,101,103,85,18
45,79,45,3,416,340,76
45,79,45,7,100,149,-49
45,79,45,9,50,0,50
45,79,45,11,85,0,85
45,79,45,13,282,240,42
45,79,45,15,285,357,-72
45,79,45,17,153,112,41
45,79,45,19,734,806,-72
45,79,45,23,63,70,-7
45,79,45,25,87,0,87
45,79,45,27,174,92,82
45,79,45,29,86,70,16
45,79,45,31,229,113,116
45,79,45,35,318,225,93
45,79,45,39,627,565,62
45,79,45,41,479,266,213
45,79,45,43,128,104,24
45,79,45,45,569,797,-228
45,79,45,47,143,110,33
45,79,45,49,63,0,63
45,79,45,51,412,350,62
45,79,45,53,50,0,50
45,79,45,55,1220,1651,-431
45,79,45,57,104,131,-27
45,79,45,59,69,106,-37
45,79,45,61,104,80,24
45,79,45,63,8210,9666,-1456
45,79,45,67,125,0,125
45,79,45,71,414,329,85
45,79,45,75,798,384,414
45,79,45,77,103,109,-6
45,79,45,81,58,0,58
45,79,45,83,273,336,-63
45,79,45,85,954,592,362
45,79,45,89,113,103,10
45,79,45,91,493,528,-35
45,79,47,37,73,77,-4
45,79,47,93,62,54,8
45,79,47,125,170,121,49
45,79,48,27,236,185,51
45,79,48,29,130,164,-34
45,79,48,99,84,0,84
45,79,48,113,66,64,2
45,79,48,141,232,143,89
45,79,48,201,87,169,-82
45,79,48,439,0,64,-64
45,79,48,453,66,112,-46
45,79,51,59,147,126,21
45,79,51,153,72,57,15
45,79,51,760,0,45,-45
45,79,51,810,61,0,61
45,79,53,33,0,63,-63
45,79,53,53,185,124,61
45,81,45,3,205,236,-31
45,81,45,37,86,111,-25
45,81,45,47,188,133,55
45,81,45,63,468,370,98
45,81,45,71,58,0,58
45,81,45,79,0,58,-58
45,83,4,13,74,0,74
45,83,6,59,60,0,60
45,83,6,67,83,0,83
45,83,6,73,69,51,18
45,83,12,11,97,0,97
45,83,12,31,0,62,-62
45,83,12,71,64,0,64
45,83,12,86,94,58,36
45,83,12,99,69,0,69
45,83,13,89,52,0,52
45,83,13,121,0,71,-71
45,83,13,135,131,77,54
45,83,17,31,80,0,80
45,83,36,103,65,0,65
45,83,37,21,224,114,110
45,83,37,45,164,88,76
45,83,37,71,125,88,37
45,83,37,81,0,54,-54
45,83,37,89,320,89,231
45,83,37,119,343,356,-13
45,83,37,149,264,181,83
45,83,37,161,185,168,17
45,83,37,183,101,0,101
45,83,41,51,116,0,116
45,83,45,3,58,0,58
45,83,45,7,460,390,70
45,83,45,13,81,62,19
45,83,45,15,147,148,-1
45,83,45,19,253,251,2
45,83,45,21,1244,1137,107
45,83,45,35,83,96,-13
45,83,45,41,81,0,81
45,83,45,45,7038,4881,2157
45,83,45,47,159,116,43
45,83,45,51,190,106,84
45,83,45,59,465,406,59
45,83,45,63,207,216,-9
45,83,45,71,71,57,14
45,83,45,73,81,113,-32
45,83,45,77,331,271,60
45,83,45,79,336,273,63
45,83,45,87,496,468,28
45,83,45,91,242,295,-53
45,83,53,11,152,0,152
45,85,12,57,0,82,-82
45,85,12,91,0,68,-68
45,85,15,3,103,0,103
45,85,32,3,126,79,47
45,85,37,51,87,87,0
45,85,37,119,85,118,-33
45,85,45,15,81,73,8
45,85,45,19,67,141,-74
45,85,45,27,629,495,134
45,85,45,31,0,65,-65
45,85,45,41,234,194,40
45,85,45,45,74,124,-50
45,85,45,51,114,108,6
45,85,45,55,214,227,-13
45,85,45,61,289,220,69
45,85,45,63,197,323,-126
45,85,45,75,71,67,4
45,85,45,79,592,954,-362
45,85,45,91,0,77,-77
45,85,48,29,124,69,55
45,87,45,21,85,87,-2
45,87,45,45,68,74,-6
45,87,45,83,468,496,-28
45,89,45,27,85,108,-23
45,89,45,41,446,504,-58
45,89,45,43,341,355,-14
45,89,45,51,102,113,-11
45,89,45,79,103,113,-10
45,91,4,13,153,108,45
45,91,6,37,95,0,95
45,91,6,73,111,0,111
45,91,9,1,90,0,90
45,91,9,3,115,0,115
45,91,9,9,60,0,60
45,91,12,11,123,62,61
45,91,12,31,121,71,50
45,91,12,57,95,71,24
45,91,12,86,79,0,79
45,91,12,95,82,69,13
45,91,12,99,89,0,89
45,91,12,103,62,0,62
45,91,13,67,70,0,70
45,91,13,89,0,59,-59
45,91,13,121,69,47,22
45,91,13,135,66,76,-10
45,91,17,31,145,59,86
45,91,26,125,63,0,63
45,91,34,23,94,0,94
45,91,36,29,66,0,66
45,91,36,55,71,0,71
45,91,36,59,82,0,82
45,91,36,81,80,0,80
45,91,36,103,201,0,201
45,91,37,21,66,49,17
45,91,37,25,381,183,198
45,91,37,35,69,63,6
45,91,37,45,129,167,-38
45,91,37,51,0,56,-56
45,91,37,67,80,94,-14
45,91,37,71,1099,859,240
45,91,37,81,119,120,-1
45,91,37,97,144,83,61
45,91,37,109,88,86,2
45,91,37,119,7141,3176,3965
45,91,37,179,518,366,152
45,91,37,183,159,154,5
45,91,39,49,72,0,72
45,91,42,3,79,0,79
45,91,45,3,81,0,81
45,91,45,7,0,91,-91
45,91,45,13,112,180,-68
45,91,45,15,99,90,9
45,91,45,19,192,297,-105
45,91,45,21,141,207,-66
45,91,45,23,816,1027,-211
45,91,45,35,112,62,50
45,91,45,41,84,0,84
45,91,45,43,0,58,-58
45,91,45,45,339,394,-55
45,91,45,51,254,292,-38
45,91,45,55,0,77,-77
45,91,45,57,1410,1450,-40
45,91,45,63,207,260,-53
45,91,45,79,528,493,35
45,91,45,83,295,242,53
45,91,45,85,77,0,77
45,91,48,201,80,57,23
45,91,48,439,0,65,-65
45,91,51,59,104,0,104
46,3,46,102,0,86,-86
46,5,46,13,57,63,-6
46,5,46,99,72,102,-30
46,9,46,135,137,101,36
46,11,27,53,0,52,-52
46,11,46,29,114,70,44
46,11,46,57,70,0,70
46,11,46,77,85,61,24
46,11,46,79,79,72,7
46,11,46,83,50,105,-55
46,11,46,99,244,432,-188
46,11,46,101,93,91,2
46,11,46,103,0,64,-64
46,13,27,53,0,52,-52
46,13,27,123,0,69,-69
46,13,38,17,0,68,-68
46,13,46,5,63,57,6
46,13,46,29,67,71,-4
46,13,46,37,64,64,0
46,13,46,45,122,85,37
46,13,46,99,94,212,-118
46,13,46,103,57,83,-26
46,13,46,115,66,102,-36
46,19,46,81,346,210,136
46,19,46,93,121,59,62
46,19,46,103,101,95,6
46,23,46,99,53,84,-31
46,25,46,29,73,0,73
46,27,46,83,0,92,-92
46,27,46,99,116,203,-87
46,27,46,127,97,96,1
46,27,46,135,148,115,33
46,29,46,11,70,114,-44
46,29,46,13,71,67,4
46,29,46,25,0,73,-73
46,29,46,39,0,74,-74
46,29,46,51,65,0,65
46,29,46,57,117,141,-24
46,29,46,83,0,72,-72
46,29,46,99,151,200,-49
46,29,46,109,72,71,1
46,33,46,47,78,98,-20
46,33,46,103,292,257,35
46,35,46,61,99,82,17
46,35,46,67,62,88,-26
46,35,46,83,0,84,-84
46,35,46,99,113,208,-95
46,37,46,13,64,64,0
46,39,46,29,74,0,74
46,45,46,13,85,122,-37
46,47,46,33,98,78,20
46,47,46,103,103,156,-53
46,51,46,29,0,65,-65
46,57,46,11,0,70,-70
46,57,46,29,141,117,24
46,61,46,35,82,99,-17
46,65,46,83,0,62,-62
46,65,46,99,64,158,-94
46,65,46,103,109,151,-42
46,65,46,117,170,202,-32
46,67,46,35,88,62,26
46,67,46,99,53,54,-1
46,71,46,103,0,66,-66
46,77,46,11,61,85,-24
46,79,46,11,72,79,-7
46,79,46,99,235,525,-290
46,81,4,13,0,70,-70
46,81,46,19,210,346,-136
46,81,46,93,242,351,-109
46,81,46,99,0,69,-69
46,81,46,103,243,330,-87
46,81,56,5,73,76,-3
46,83,19,167,96,61,35
46,83,19,193,74,0,74
46,83,27,53,73,92,-19
46,83,31,55,0,67,-67
46,83,46,11,105,50,55
46,83,46,27,92,0,92
46,83,46,29,72,0,72
46,83,46,35,84,0,84
46,83,46,65,62,0,62
46,83,46,99,5151,3897,1254
46,83,46,103,109,59,50
46,83,46,125,110,103,7
46,83,46,127,141,122,19
46,83,46,135,108,72,36
46,87,46,99,217,155,62
46,93,4,13,0,71,-71
46,93,46,19,59,121,-62
46,93,46,81,351,242,109
46,93,46,99,60,0,60
46,93,46,103,1733,1763,-30
46,99,4,13,167,281,-114
46,99,4,19,0,63,-63
46,99,6,37,83,70,13
46,99,6,73,102,0,102
46,99,8,31,68,61,7
46,99,8,41,58,66,-8
46,99,17,31,78,0,78
46,99,19,119,113,70,43
46,99,19,153,68,125,-57
46,99,19,167,92,64,28
46,99,19,193,118,117,1
46,99,27,37,92,58,34
46,99,27,53,208,286,-78
46,99,27,83,73,0,73
46,99,27,105,158,106,52
46,99,27,117,101,90,11
46,99,27,123,0,106,-106
46,99,27,133,170,136,34
46,99,31,55,134,191,-57
46,99,31,109,0,57,-57
46,99,32,3,91,101,-10
46,99,38,17,125,135,-10
46,99,38,35,60,0,60
46,99,46,5,102,72,30
46,99,46,11,432,244,188
46,99,46,13,212,94,118
46,99,46,23,84,53,31
46,99,46,27,203,116,87
46,99,46,29,200,151,49
46,99,46,35,208,113,95
46,99,46,65,158,64,94
46,99,46,67,54,53,1
46,99,46,79,525,235,290
46,99,46,81,69,0,69
46,99,46,83,3897,5151,-1254
46,99,46,87,155,217,-62
46,99,46,93,0,60,-60
46,99,46,101,103,133,-30
46,99,46,103,339,275,64
46,99,46,109,53,0,53
46,99,46,125,138,222,-84
46,99,46,127,153,129,24
46,99,46,135,187,117,70
46,99,48,201,0,61,-61
46,99,53,33,0,64,-64
46,101,46,11,91,93,-2
46,101,46,99,133,103,30
46,102,46,3,86,0,86
46,102,46,103,186,317,-131
46,103,4,13,149,262,-113
46,103,4,19,0,92,-92
46,103,6,37,55,0,55
46,103,6,65,87,0,87
46,103,6,73,70,0,70
46,103,8,1,67,0,67
46,103,8,5,111,48,63
46,103,8,31,0,56,-56
46,103,8,41,121,83,38
46,103,8,59,80,52,28
46,103,8,69,60,71,-11
46,103,8,123,52,0,52
46,103,27,53,0,60,-60
46,103,31,55,0,59,-59
46,103,32,3,104,141,-37
46,103,46,11,64,0,64
46,103,46,13,83,57,26
46,103,46,19,95,101,-6
46,103,46,33,257,292,-35
46,103,46,47,156,103,53
46,103,46,65,151,109,42
46,103,46,71,66,0,66
46,103,46,81,330,243,87
46,103,46,83,59,109,-50
46,103,46,93,1763,1733,30
46,103,46,99,275,339,-64
46,103,46,102,317,186,131
46,103,48,373,62,0,62
46,103,48,441,66,0,66
46,103,53,33,74,0,74
46,103,56,5,93,110,-17
46,109,46,29,71,72,-1
46,109,46,99,0,53,-53
46,115,46,13,102,66,36
46,117,46,65,202,170,32
46,125,46,83,103,110,-7
46,125,46,99,222,138,84
46,127,19,149,75,0,75
46,127,19,193,578,339,239
46,127,31,43,75,0,75
46,127,31,55,0,54,-54
46,127,46,27,96,97,-1
46,127,46,83,122,141,-19
46,127,46,99,129,153,-24
46,135,31,27,66,0,66
46,135,31,107,64,0,64
46,135,46,9,101,137,-36
46,135,46,27,115,148,-33
46,135,46,83,72,108,-36
46,135,46,99,117,187,-70
47,1,47,9,240,182,58
47,1,47,13,394,436,-42
47,1,47,37,0,50,-50
47,1,47,65,57,59,-2
47,1,47,93,2721,2420,301
47,1,47,105,104,114,-10
47,1,47,129,201,199,2
47,1,47,145,550,712,-162
47,1,47,155,125,63,62
47,1,47,173,91,164,-73
47,3,47,31,303,406,-103
47,3,47,37,229,174,55
47,3,47,51,0,137,-137
47,3,47,103,90,130,-40
47,3,47,117,254,235,19
47,3,47,119,99,0,99
47,3,47,127,0,106,-106
47,3,47,149,1372,865,507
47,3,47,187,69,0,69
47,3,47,189,69,0,69
47,5,47,17,168,153,15
47,5,47,79,175,141,34
47,5,47,85,104,90,14
47,7,47,35,67,77,-10
47,7,47,65,121,70,51
47,7,47,143,128,159,-31
47,7,47,153,112,128,-16
47,9,12,11,58,0,58
47,9,12,71,62,0,62
47,9,12,95,48,0,48
47,9,12,99,71,0,71
47,9,12,103,58,0,58
47,9,47,1,182,240,-58
47,9,47,37,63,83,-20
47,9,47,65,88,67,21
47,9,47,89,71,95,-24
47,9,47,93,3035,2691,344
47,9,47,105,588,594,-6
47,9,47,107,58,65,-7
47,9,47,123,352,373,-21
47,9,47,145,104,94,10
47,9,47,149,71,0,71
47,9,47,155,778,574,204
47,9,47,157,64,68,-4
47,9,47,173,64,0,64
47,9,47,179,59,50,9
47,11,13,47,196,99,97
47,11,13,213,65,55,10
47,11,13,295,98,97,1
47,11,13,313,146,117,29
47,11,47,37,79,87,-8
47,11,47,65,1841,1494,347
47,11,47,93,180,182,-2
47,11,47,107,598,542,56
47,11,47,121,215,278,-63
47,11,47,123,61,0,61
47,11,47,139,516,500,16
47,11,47,143,114,110,4
47,11,47,149,82,69,13
47,13,21,235,141,156,-15
47,13,47,1,436,394,42
47,13,47,25,143,86,57
47,13,47,93,287,288,-1
47,13,47,151,0,70,-70
47,15,47,31,0,113,-113
47,15,47,37,62,0,62
47,15,47,41,0,91,-91
47,15,47,149,750,431,319
47,15,47,177,100,135,-35
47,17,47,5,153,168,-15
47,17,47,53,236,215,21
47,17,47,77,116,101,15
47,17,47,79,176,214,-38
47,17,47,113,182,134,48
47,17,47,183,192,255,-63
47,19,37,11,92,61,31
47,19,47,59,0,100,-100
47,19,47,91,75,81,-6
47,19,47,93,0,68,-68
47,19,47,163,456,516,-60
47,19,47,171,217,165,52
47,19,47,179,1532,1439,93
47,21,47,37,1842,950,892
47,21,47,43,182,366,-184
47,21,47,81,0,74,-74
47,21,47,125,321,501,-180
47,21,47,147,302,365,-63
47,21,47,149,191,109,82
47,21,47,165,182,217,-35
47,21,47,187,177,148,29
47,21,47,189,72,84,-12
47,23,47,77,105,114,-9
47,23,47,109,157,154,3
47,23,47,113,326,513,-187
47,25,21,13,392,281,111
47,25,47,13,86,143,-57
47,25,47,63,0,84,-84
47,25,47,93,124,162,-38
47,25,47,173,108,135,-27
47,27,47,111,78,0,78
47,27,47,133,79,72,7
47,27,47,141,0,57,-57
47,29,47,59,78,140,-62
47,29,47,63,195,201,-6
47,29,47,89,271,254,17
47,29,47,93,123,124,-1
47,29,47,155,449,301,148
47,31,1,89,0,60,-60
47,31,47,3,406,303,103
47,31,47,15,113,0,113
47,31,47,37,206,167,39
47,31,47,51,780,856,-76
47,31,47,61,100,97,3
47,31,47,65,66,49,17
47,31,47,103,82,101,-19
47,31,47,119,0,60,-60
47,31,47,127,177,250,-73
47,31,47,149,1096,498,598
47,31,47,177,311,259,52
47,31,47,187,49,0,49
47,33,47,45,102,123,-21
47,33,47,53,171,201,-30
47,33,47,75,112,108,4
47,33,47,113,224,243,-19
47,35,17,31,73,0,73
47,35,17,97,56,0,56
47,35,47,7,77,67,10
47,35,47,37,72,74,-2
47,35,47,49,219,154,65
47,35,47,65,56,0,56
47,35,47,93,121,166,-45
47,35,47,141,297,378,-81
47,35,47,143,77,85,-8
47,35,47,145,135,150,-15
47,35,47,149,60,0,60
47,35,47,185,138,137,1
47,37,1,3,0,99,-99
47,37,1,73,425,267,158
47,37,1,77,67,0,67
47,37,1,81,70,0,70
47,37,1,83,0,58,-58
47,37,1,89,304,337,-33
47,37,1,97,105,58,47
47,37,1,101,97,0,97
47,37,1,103,44,0,44
47,37,1,117,101,74,27
47,37,1,125,91,0,91
47,37,4,13,428,344,84
47,37,4,19,77,97,-20
47,37,5,7,65,0,65
47,37,5,119,149,90,59
47,37,5,143,55,58,-3
47,37,6,1,141,97,44
47,37,6,13,56,63,-7
47,37,6,37,1041,760,281
47,37,6,53,50,0,50
47,37,6,59,307,158,149
47,37,6,65,152,66,86
47,37,6,67,59,87,-28
47,37,6,71,77,71,6
47,37,6,73,390,288,102
47,37,6,75,190,97,93
47,37,6,81,66,67,-1
47,37,6,83,55,0,55
47,37,6,85,157,98,59
47,37,6,111,60,0,60
47,37,8,1,54,49,5
47,37,8,5,104,100,4
47,37,8,13,78,64,14
47,37,8,31,171,282,-111
47,37,8,35,55,0,55
47,37,8,41,78,107,-29
47,37,8,59,68,97,-29
47,37,9,1,95,56,39
47,37,9,3,85,0,85
47,37,9,9,69,64,5
47,37,11,1,220,228,-8
47,37,12,1,57,0,57
47,37,12,5,55,0,55
47,37,12,9,75,59,16
47,37,12,11,247,146,101
47,37,12,21,84,0,84
47,37,12,31,219,179,40
47,37,12,33,92,90,2
47,37,12,57,284,277,7
47,37,12,71,153,128,25
47,37,12,73,79,0,79
47,37,12,81,50,80,-30
47,37,12,86,351,231,120
47,37,12,91,67,0,67
47,37,12,95,342,222,120
47,37,12,97,63,0,63
47,37,12,99,236,109,127
47,37,12,101,71,75,-4
47,37,12,103,199,232,-33
47,37,12,105,109,91,18
47,37,12,109,0,82,-82
47,37,12,115,56,73,-17
47,37,12,117,76,63,13
47,37,12,127,68,77,-9
47,37,13,51,101,90,11
47,37,13,59,47,56,-9
47,37,13,63,0,47,-47
47,37,13,67,279,199,80
47,37,13,89,288,387,-99
47,37,13,121,553,607,-54
47,37,13,135,183,220,-37
47,37,13,215,50,0,50
47,37,15,3,58,0,58
47,37,17,19,61,0,61
47,37,17,31,1133,632,501
47,37,17,43,195,105,90
47,37,17,77,45,0,45
47,37,17,89,74,0,74
47,37,17,97,97,0,97
47,37,17,113,57,0,57
47,37,17,143,68,0,68
47,37,17,167,51,0,51
47,37,17,197,89,0,89
47,37,18,57,107,104,3
47,37,18,89,56,0,56
47,37,18,97,278,258,20
47,37,18,163,97,0,97
47,37,20,91,61,75,-14
47,37,21,47,164,175,-11
47,37,21,59,65,0,65
47,37,21,67,233,149,84
47,37,21,111,361,359,2
47,37,21,145,84,64,20
47,37,21,213,0,102,-102
47,37,21,227,335,222,113
47,37,22,33,84,0,84
47,37,22,51,72,49,23
47,37,22,71,119,94,25
47,37,24,5,85,0,85
47,37,24,27,50,0,50
47,37,24,31,144,101,43
47,37,24,33,75,71,4
47,37,24,510,127,52,75
47,37,25,9,161,0,161
47,37,25,17,208,164,44
47,37,25,21,113,0,113
47,37,25,25,173,99,74
47,37,25,27,60,0,60
47,37,26,49,60,0,60
47,37,26,81,120,72,48
47,37,26,99,70,0,70
47,37,26,125,212,121,91
47,37,26,161,62,69,-7
47,37,26,163,181,154,27
47,37,27,53,206,205,1
47,37,27,123,0,88,-88
47,37,28,33,96,63,33
47,37,28,49,125,81,44
47,37,28,81,68,0,68
47,37,28,89,74,0,74
47,37,28,121,56,0,56
47,37,29,95,81,65,16
47,37,29,189,179,167,12
47,37,29,510,110,90,20
47,37,31,55,75,71,4
47,37,31,109,51,0,51
47,37,32,3,242,201,41
47,37,34,3,62,0,62
47,37,34,17,151,87,64
47,37,34,23,65,0,65
47,37,34,27,70,0,70
47,37,35,1,58,64,-6
47,37,36,29,89,53,36
47,37,36,47,391,183,208
47,37,36,55,94,55,39
47,37,36,59,81,0,81
47,37,36,61,397,381,16
47,37,36,71,49,0,49
47,37,36,81,207,67,140
47,37,36,103,91,67,24
47,37,36,119,75,0,75
47,37,37,21,95,91,4
47,37,37,63,118,109,9
47,37,37,67,82,85,-3
47,37,37,81,71,56,15
47,37,37,119,386,291,95
47,37,37,129,0,62,-62
47,37,37,183,276,209,67
47,37,39,17,55,0,55
47,37,39,35,211,121,90
47,37,39,49,321,354,-33
47,37,39,61,185,192,-7
47,37,39,95,51,0,51
47,37,39,113,103,91,12
47,37,39,153,55,58,-3
47,37,40,109,72,0,72
47,37,40,143,62,0,62
47,37,41,51,106,164,-58
47,37,41,67,55,0,55
47,37,42,3,188,109,79
47,37,42,17,48,0,48
47,37,42,29,52,0,52
47,37,42,71,52,0,52
47,37,42,91,0,56,-56
47,37,42,101,156,152,4
47,37,45,19,134,141,-7
47,37,45,45,79,157,-78
47,37,45,51,66,0,66
47,37,45,79,77,73,4
47,37,47,1,50,0,50
47,37,47,3,174,229,-55
47,37,47,9,83,63,20
47,37,47,11,87,79,8
47,37,47,15,0,62,-62
47,37,47,21,950,1842,-892
47,37,47,31,167,206,-39
47,37,47,35,74,72,2
47,37,47,41,75,67,8
47,37,47,43,472,937,-465
47,37,47,45,58,0,58
47,37,47,51,72,94,-22
47,37,47,53,86,60,26
47,37,47,55,80,90,-10
47,37,47,65,660,592,68
47,37,47,81,142,264,-122
47,37,47,85,49,82,-33
47,37,47,93,816,586,230
47,37,47,99,73,83,-10
47,37,47,103,0,69,-69
47,37,47,111,0,118,-118
47,37,47,113,395,254,141
47,37,47,117,96,221,-125
47,37,47,119,708,1160,-452
47,37,47,125,1255,3013,-1758
47,37,47,131,53,0,53
47,37,47,141,254,239,15
47,37,47,147,1024,2022,-998
47,37,47,149,5752,10637,-4885
47,37,47,155,79,61,18
47,37,47,157,1557,1145,412
47,37,47,159,109,138,-29
47,37,47,163,62,70,-8
47,37,47,165,3302,5973,-2671
47,37,47,169,0,88,-88
47,37,47,177,58,79,-21
47,37,47,179,110,87,23
47,37,47,183,53,0,53
47,37,47,185,0,54,-54
47,37,47,187,5284,7762,-2478
47,37,47,189,2704,5537,-2833
47,37,48,29,171,126,45
47,37,48,85,156,136,20
47,37,48,113,503,492,11
47,37,48,121,96,84,12
47,37,48,157,59,0,59
47,37,48,201,526,370,156
47,37,48,339,62,49,13
47,37,48,439,208,190,18
47,37,48,453,341,284,57
47,37,48,491,62,90,-28
47,37,49,35,119,81,38
47,37,51,3,0,50,-50
47,37,51,13,118,74,44
47,37,51,59,187,145,42
47,37,51,87,68,76,-8
47,37,51,510,66,45,21
47,37,51,760,62,57,5
47,37,53,33,292,352,-60
47,37,53,61,53,0,53
47,37,55,25,84,0,84
47,37,55,79,135,123,12
47,39,47,77,182,208,-26
47,41,47,15,91,0,91
47,41,47,37,67,75,-8
47,41,47,141,104,158,-54
47,41,47,149,134,114,20
47,41,47,159,81,60,21
47,41,47,177,187,189,-2
47,41,47,185,102,114,-12
47,41,47,189,301,154,147
47,43,47,21,366,182,184
47,43,47,37,937,472,465
47,43,47,81,429,459,-30
47,43,47,85,249,292,-43
47,43,47,119,65,93,-28
47,43,47,125,236,290,-54
47,43,47,149,176,116,60
47,43,47,165,72,68,4
47,43,47,187,350,209,141
47,43,47,189,69,0,69
47,45,29,155,71,0,71
47,45,47,33,123,102,21
47,45,47,37,0,58,-58
47,45,47,53,113,168,-55
47,45,47,95,140,119,21
47,45,47,97,337,219,118
47,45,47,113,92,89,3
47,45,47,131,185,197,-12
47,45,47,157,68,100,-32
47,47,28,33,132,101,31
47,47,28,93,0,61,-61
47,47,47,69,161,190,-29
47,47,47,75,60,0,60
47,47,47,157,2905,1924,981
47,47,47,167,143,167,-24
47,49,47,35,154,219,-65
47,49,47,141,110,130,-20
47,51,1,89,77,0,77
47,51,47,3,137,0,137
47,51,47,31,856,780,76
47,51,47,37,94,72,22
47,51,47,61,99,100,-1
47,51,47,65,53,65,-12
47,51,47,103,181,145,36
47,51,47,115,60,0,60
47,51,47,127,113,79,34
47,51,47,149,265,127,138
47,53,47,17,215,236,-21
47,53,47,33,201,171,30
47,53,47,37,60,86,-26
47,53,47,45,168,113,55
47,53,47,77,66,0,66
47,53,47,113,1091,912,179
47,53,47,131,166,121,45
47,53,47,149,72,107,-35
47,53,47,157,144,138,6
47,53,47,183,144,168,-24
47,55,1,83,208,166,42
47,55,1,89,91,169,-78
47,55,47,37,90,80,10
47,55,47,99,254,260,-6
47,55,47,103,116,134,-18
47,55,47,117,121,135,-14
47,55,47,119,294,228,66
47,55,47,149,73,0,73
47,57,47,63,323,296,27
47,57,47,73,99,126,-27
47,57,47,89,200,165,35
47,57,47,93,322,306,16
47,57,47,155,83,0,83
47,57,47,173,86,91,-5
47,59,47,19,100,0,100
47,59,47,29,140,78,62
47,59,47,63,241,214,27
47,59,47,73,251,165,86
47,59,47,89,69,0,69
47,59,47,93,102,149,-47
47,59,47,155,68,0,68
47,59,47,163,193,179,14
47,59,47,179,620,656,-36
47,61,47,31,97,100,-3
47,61,47,51,100,99,1
47,61,47,115,131,199,-68
47,61,47,177,87,70,17
47,63,47,25,84,0,84
47,63,47,29,201,195,6
47,63,47,57,296,323,-27
47,63,47,59,214,241,-27
47,63,47,73,334,354,-20
47,63,47,89,947,947,0
47,63,47,93,269,373,-104
47,63,47,155,140,150,-10
47,63,47,163,0,57,-57
47,63,47,179,51,112,-61
47,65,1,49,119,105,14
47,65,1,71,110,133,-23
47,65,1,73,102,127,-25
47,65,1,89,125,141,-16
47,65,1,97,63,0,63
47,65,4,13,147,81,66
47,65,6,37,109,80,29
47,65,6,65,61,0,61
47,65,6,73,112,61,51
47,65,8,31,51,0,51
47,65,8,41,70,0,70
47,65,12,1,54,0,54
47,65,12,11,116,66,50
47,65,12,31,96,89,7
47,65,12,57,114,99,15
47,65,12,71,79,0,79
47,65,12,86,96,0,96
47,65,12,95,123,75,48
47,65,12,99,94,0,94
47,65,12,103,104,53,51
47,65,12,105,53,0,53
47,65,12,117,0,63,-63
47,65,12,127,59,0,59
47,65,13,15,0,58,-58
47,65,13,47,1733,1981,-248
47,65,13,57,55,0,55
47,65,13,67,219,237,-18
47,65,13,83,283,269,14
47,65,13,89,160,138,22
47,65,13,115,100,0,100
47,65,13,117,62,68,-6
47,65,13,121,279,274,5
47,65,13,135,226,185,41
47,65,13,213,81,72,9
47,65,13,295,1190,1506,-316
47,65,13,313,424,317,107
47,65,17,31,138,100,38
47,65,21,111,50,0,50
47,65,26,125,57,0,57
47,65,26,163,62,0,62
47,65,32,3,140,61,79
47,65,37,21,86,55,31
47,65,37,119,64,91,-27
47,65,37,183,67,75,-8
47,65,45,45,62,124,-62
47,65,47,1,59,57,2
47,65,47,7,70,121,-51
47,65,47,9,67,88,-21
47,65,47,11,1494,1841,-347
47,65,47,31,49,66,-17
47,65,47,35,0,56,-56
47,65,47,37,592,660,-68
47,65,47,51,65,53,12
47,65,47,93,583,543,40
47,65,47,105,68,0,68
47,65,47,107,135,199,-64
47,65,47,113,72,0,72
47,65,47,115,463,413,50
47,65,47,119,80,52,28
47,65,47,121,147,196,-49
47,65,47,125,132,87,45
47,65,47,139,54,85,-31
47,65,47,141,117,67,50
47,65,47,143,529,501,28
47,65,47,149,367,331,36
47,65,47,153,432,447,-15
47,65,47,155,0,62,-62
47,65,47,157,303,287,16
47,65,47,163,66,0,66
47,65,47,165,146,100,46
47,65,47,179,92,82,10
47,65,47,187,187,162,25
47,65,47,189,78,94,-16
47,65,48,85,0,61,-61
47,65,48,113,63,84,-21
47,65,48,201,146,96,50
47,65,48,453,84,0,84
47,65,51,59,59,0,59
47,65,53,33,66,79,-13
47,69,47,47,190,161,29
47,69,47,109,65,79,-14
47,69,47,113,162,256,-94
47,69,47,157,186,244,-58
47,71,47,109,449,294,155
47,71,47,113,0,65,-65
47,71,47,157,78,53,25
47,71,47,181,82,91,-9
47,73,47,57,126,99,27
47,73,47,59,165,251,-86
47,73,47,63,354,334,20
47,73,47,93,58,58,0
47,73,47,163,1275,1396,-121
47,73,47,179,236,297,-61
47,73,51,169,138,75,63
47,75,47,33,108,112,-4
47,75,47,47,0,60,-60
47,75,47,97,111,85,26
47,75,47,113,211,307,-96
47,75,47,157,113,122,-9
47,75,47,167,0,93,-93
47,77,47,17,101,116,-15
47,77,47,23,114,105,9
47,77,47,39,208,182,26
47,77,47,53,0,66,-66
47,77,47,113,340,315,25
47,77,47,157,62,0,62
47,79,21,35,151,170,-19
47,79,47,5,141,175,-34
47,79,47,17,214,176,38
47,79,47,113,0,65,-65
47,79,47,125,0,76,-76
47,79,47,157,73,0,73
47,79,47,183,116,105,11
47,81,47,21,74,0,74
47,81,47,37,264,142,122
47,81,47,43,459,429,30
47,81,47,85,73,75,-2
47,81,47,101,0,63,-63
47,81,47,119,146,159,-13
47,81,47,149,77,85,-8
47,81,47,187,300,162,138
47,83,47,125,121,138,-17
47,83,47,161,98,133,-35
47,85,47,5,90,104,-14
47,85,47,37,82,49,33
47,85,47,43,292,249,43
47,85,47,81,75,73,2
47,87,47,133,51,102,-51
47,87,47,141,384,415,-31
47,89,47,9,95,71,24
47,89,47,29,254,271,-17
47,89,47,57,165,200,-35
47,89,47,59,0,69,-69
47,89,47,63,947,947,0
47,89,47,93,823,805,18
47,89,47,155,884,643,241
47,89,47,179,47,0,47
47,91,37,189,85,0,85
47,91,47,19,81,75,6
47,91,47,179,61,0,61
47,93,1,73,94,88,6
47,93,1,89,69,141,-72
47,93,4,13,147,194,-47
47,93,6,37,241,143,98
47,93,6,59,99,0,99
47,93,6,65,98,0,98
47,93,6,73,157,102,55
47,93,6,85,0,56,-56
47,93,8,5,0,65,-65
47,93,8,31,0,63,-63
47,93,8,41,109,74,35
47,93,11,1,0,82,-82
47,93,12,9,79,64,15
47,93,12,11,220,71,149
47,93,12,31,101,119,-18
47,93,12,57,130,141,-11
47,93,12,71,161,80,81
47,93,12,73,65,0,65
47,93,12,86,145,57,88
47,93,12,95,105,79,26
47,93,12,99,166,64,102
47,93,12,101,93,0,93
47,93,12,103,225,143,82
47,93,12,105,105,74,31
47,93,12,115,111,55,56
47,93,12,117,0,59,-59
47,93,12,127,95,65,30
47,93,13,51,69,0,69
47,93,13,67,123,112,11
47,93,13,89,190,114,76
47,93,13,121,171,235,-64
47,93,13,135,104,143,-39
47,93,15,3,63,0,63
47,93,17,31,217,130,87
47,93,17,43,66,0,66
47,93,18,97,0,51,-51
47,93,21,13,61,0,61
47,93,21,67,112,67,45
47,93,21,111,85,93,-8
47,93,26,99,65,0,65
47,93,26,125,66,0,66
47,93,26,163,54,59,-5
47,93,32,3,115,99,16
47,93,36,55,65,0,65
47,93,36,61,50,77,-27
47,93,37,21,95,97,-2
47,93,37,63,0,58,-58
47,93,37,67,61,67,-6
47,93,37,81,53,0,53
47,93,37,119,160,199,-39
47,93,37,183,128,109,19
47,93,39,49,126,92,34
47,93,39,61,50,62,-12
47,93,45,13,0,77,-77
47,93,45,19,76,87,-11
47,93,45,45,75,121,-46
47,93,45,51,81,61,20
47,93,45,79,54,62,-8
47,93,47,1,2420,2721,-301
47,93,47,9,2691,3035,-344
47,93,47,11,182,180,2
47,93,47,13,288,287,1
47,93,47,19,68,0,68
47,93,47,25,162,124,38
47,93,47,29,124,123,1
47,93,47,35,166,121,45
47,93,47,37,586,816,-230
47,93,47,57,306,322,-16
47,93,47,59,149,102,47
47,93,47,63,373,269,104
47,93,47,65,543,583,-40
47,93,47,73,58,58,0
47,93,47,89,805,823,-18
47,93,47,105,1115,1536,-421
47,93,47,107,172,192,-20
47,93,47,123,215,248,-33
47,93,47,125,153,119,34
47,93,47,129,119,78,41
47,93,47,141,114,121,-7
47,93,47,145,700,660,40
47,93,47,149,258,303,-45
47,93,47,151,82,87,-5
47,93,47,155,1693,1428,265
47,93,47,157,337,260,77
47,93,47,163,264,218,46
47,93,47,165,142,145,-3
47,93,47,173,622,808,-186
47,93,47,179,390,230,160
47,93,47,187,203,236,-33
47,93,47,189,107,156,-49
47,93,48,29,70,76,-6
47,93,48,113,73,94,-21
47,93,48,121,58,0,58
47,93,48,201,187,116,71
47,93,48,439,78,107,-29
47,93,48,453,82,81,1
47,93,49,35,0,71,-71
47,93,51,59,109,104,5
47,93,53,33,77,84,-7
47,95,47,45,119,140,-21
47,97,47,45,219,337,-118
47,97,47,75,85,111,-26
47,97,47,113,0,75,-75
47,97,47,157,123,117,6
47,97,47,167,226,272,-46
47,99,1,77,146,143,3
47,99,47,37,83,73,10
47,99,47,55,260,254,6
47,99,47,101,114,67,47
47,99,47,119,510,345,165
47,99,47,149,79,64,15
47,99,47,181,120,138,-18
47,101,47,81,63,0,63
47,101,47,99,67,114,-47
47,101,47,119,182,144,38
47,103,1,83,64,94,-30
47,103,1,89,619,457,162
47,103,47,3,130,90,40
47,103,47,31,101,82,19
47,103,47,37,69,0,69
47,103,47,51,145,181,-36
47,103,47,55,134,116,18
47,103,47,117,146,125,21
47,103,47,127,0,74,-74
47,103,47,149,92,77,15
47,105,47,1,114,104,10
47,105,47,9,594,588,6
47,105,47,65,0,68,-68
47,105,47,93,1536,1115,421
47,105,47,107,88,121,-33
47,105,47,123,555,515,40
47,105,47,145,342,354,-12
47,105,47,155,64,0,64
47,107,47,9,65,58,7
47,107,47,11,542,598,-56
47,107,47,65,199,135,64
47,107,47,93,192,172,20
47,107,47,105,121,88,33
47,107,47,121,280,264,16
47,107,47,123,687,498,189
47,107,47,139,144,146,-2
47,107,47,143,61,0,61
47,109,28,3,182,152,30
47,109,47,23,154,157,-3
47,109,47,69,79,65,14
47,109,47,71,294,449,-155
47,109,47,113,73,126,-53
47,109,47,157,81,0,81
47,111,21,3,0,67,-67
47,111,47,27,0,78,-78
47,111,47,37,118,0,118
47,111,47,159,116,84,32
47,111,47,165,630,383,247
47,111,47,169,135,108,27
47,111,47,189,138,85,53
47,113,28,33,74,0,74
47,113,47,17,134,182,-48
47,113,47,23,513,326,187
47,113,47,33,243,224,19
47,113,47,37,254,395,-141
47,113,47,45,89,92,-3
47,113,47,53,912,1091,-179
47,113,47,65,0,72,-72
47,113,47,69,256,162,94
47,113,47,71,65,0,65
47,113,47,75,307,211,96
47,113,47,77,315,340,-25
47,113,47,79,65,0,65
47,113,47,97,75,0,75
47,113,47,109,126,73,53
47,113,47,125,79,79,0
47,113,47,131,57,0,57
47,113,47,149,141,257,-116
47,113,47,157,515,666,-151
47,113,47,183,59,71,-12
47,115,1,71,174,146,28
47,115,13,47,59,0,59
47,115,47,51,0,60,-60
47,115,47,61,199,131,68
47,115,47,65,413,463,-50
47,115,47,153,133,132,1
47,117,47,3,235,254,-19
47,117,47,37,221,96,125
47,117,47,55,135,121,14
47,117,47,103,125,146,-21
47,117,47,119,699,425,274
47,117,47,149,331,234,97
47,117,47,187,410,164,246
47,119,1,89,59,56,3
47,119,6,37,68,0,68
47,119,39,99,120,0,120
47,119,39,155,74,0,74
47,119,47,3,0,99,-99
47,119,47,31,60,0,60
47,119,47,37,1160,708,452
47,119,47,43,93,65,28
47,119,47,55,228,294,-66
47,119,47,65,52,80,-28
47,119,47,81,159,146,13
47,119,47,99,345,510,-165
47,119,47,101,144,182,-38
47,119,47,117,425,699,-274
47,119,47,125,75,68,7
47,119,47,149,497,588,-91
47,119,47,157,131,0,131
47,119,47,165,123,100,23
47,119,47,187,2865,1748,1117
47,119,47,189,98,129,-31
47,121,47,11,278,215,63
47,121,47,65,196,147,49
47,121,47,107,264,280,-16
47,121,47,123,54,0,54
47,121,47,143,107,91,16
47,123,47,9,373,352,21
47,123,47,11,0,61,-61
47,123,47,93,248,215,33
47,123,47,105,515,555,-40
47,123,47,107,498,687,-189
47,123,47,121,0,54,-54
47,123,47,145,58,126,-68
47,125,1,31,87,84,3
47,125,1,45,144,118,26
47,125,1,73,56,0,56
47,125,1,89,114,185,-71
47,125,1,113,0,57,-57
47,125,2,20,0,79,-79
47,125,2,90,183,120,63
47,125,4,3,103,87,16
47,125,4,13,160,138,22
47,125,6,37,195,103,92
47,125,6,59,77,0,77
47,125,6,65,133,0,133
47,125,6,67,57,0,57
47,125,6,71,170,121,49
47,125,6,73,171,66,105
47,125,8,41,486,510,-24
47,125,12,9,0,96,-96
47,125,12,11,76,0,76
47,125,12,31,68,149,-81
47,125,12,57,231,137,94
47,125,12,71,0,62,-62
47,125,12,86,97,0,97
47,125,12,91,95,131,-36
47,125,12,95,103,94,9
47,125,12,99,90,47,43
47,125,12,101,68,0,68
47,125,12,103,75,0,75
47,125,12,127,0,62,-62
47,125,13,51,137,163,-26
47,125,13,53,93,0,93
47,125,13,73,100,133,-33
47,125,13,89,0,61,-61
47,125,13,121,108,53,55
47,125,13,135,66,88,-22
47,125,13,179,198,222,-24
47,125,13,215,226,335,-109
47,125,13,245,91,85,6
47,125,15,3,437,526,-89
47,125,17,31,226,101,125
47,125,17,197,71,0,71
47,125,18,97,106,65,41
47,125,20,61,245,113,132
47,125,20,103,124,97,27
47,125,20,161,82,75,7
47,125,21,47,2933,1946,987
47,125,21,93,120,101,19
47,125,21,111,95,91,4
47,125,21,141,74,0,74
47,125,21,145,58,0,58
47,125,21,219,127,145,-18
47,125,21,227,101,60,41
47,125,22,115,115,126,-11
47,125,24,3,0,72,-72
47,125,24,33,54,0,54
47,125,26,163,66,0,66
47,125,29,169,132,211,-79
47,125,29,189,0,59,-59
47,125,32,3,111,147,-36
47,125,36,5,56,0,56
47,125,36,45,222,191,31
47,125,37,51,579,526,53
47,125,37,85,118,243,-125
47,125,37,93,99,121,-22
47,125,37,125,70,155,-85
47,125,37,183,0,70,-70
47,125,40,31,160,217,-57
47,125,45,79,121,170,-49
47,125,47,21,501,321,180
47,125,47,37,3013,1255,1758
47,125,47,43,290,236,54
47,125,47,65,87,132,-45
47,125,47,79,76,0,76
47,125,47,83,138,121,17
47,125,47,93,119,153,-34
47,125,47,113,79,79,0
47,125,47,119,68,75,-7
47,125,47,147,702,583,119
47,125,47,149,543,353,190
47,125,47,157,295,222,73
47,125,47,161,321,449,-128
47,125,47,165,447,305,142
47,125,47,187,195,110,85
47,125,47,189,183,146,37
47,125,48,27,405,450,-45
47,125,48,29,207,247,-40
47,125,48,99,106,155,-49
47,125,48,113,85,60,25
47,125,48,141,463,401,62
47,125,48,201,72,74,-2
47,125,48,439,103,104,-1
47,125,51,59,124,179,-55
47,125,51,149,0,97,-97
47,125,51,153,59,0,59
47,125,51,700,114,103,11
47,125,53,53,338,329,9
47,125,53,67,123,139,-16
47,127,47,3,106,0,106
47,127,47,31,250,177,73
47,127,47,51,79,113,-34
47,127,47,103,74,0,74
47,129,47,1,199,201,-2
47,129,47,93,78,119,-41
47,129,47,145,357,300,57
47,131,21,75,174,117,57
47,131,21,83,66,76,-10
47,131,47,37,0,53,-53
47,131,47,45,197,185,12
47,131,47,53,121,166,-45
47,131,47,113,0,57,-57
47,131,47,157,0,77,-77
47,131,47,183,315,325,-10
47,133,47,27,72,79,-7
47,133,47,87,102,51,51
47,133,47,137,77,63,14
47,133,47,141,706,601,105
47,133,47,185,0,89,-89
47,137,47,133,63,77,-14
47,137,47,141,0,67,-67
47,139,13,111,140,99,41
47,139,47,11,500,516,-16
47,139,47,65,85,54,31
47,139,47,107,146,144,2
47,141,47,27,57,0,57
47,141,47,35,378,297,81
47,141,47,37,239,254,-15
47,141,47,41,158,104,54
47,141,47,49,130,110,20
47,141,47,65,67,117,-50
47,141,47,87,415,384,31
47,141,47,93,121,114,7
47,141,47,133,601,706,-105
47,141,47,137,67,0,67
47,141,47,149,141,150,-9
47,141,47,159,136,75,61
47,141,47,165,110,82,28
47,141,47,177,87,68,19
47,141,47,185,607,608,-1
47,141,47,187,0,59,-59
47,141,47,189,164,126,38
47,143,47,7,159,128,31
47,143,47,11,110,114,-4
47,143,47,35,85,77,8
47,143,47,65,501,529,-28
47,143,47,107,0,61,-61
47,143,47,121,91,107,-16
47,143,47,145,0,68,-68
47,145,47,1,712,550,162
47,145,47,9,94,104,-10
47,145,47,35,150,135,15
47,145,47,93,660,700,-40
47,145,47,105,354,342,12
47,145,47,123,126,58,68
47,145,47,129,300,357,-57
47,145,47,143,68,0,68
47,145,47,149,46,0,46
47,147,21,141,79,110,-31
47,147,21,213,71,71,0
47,147,21,227,0,61,-61
47,147,47,21,365,302,63
47,147,47,37,2022,1024,998
47,147,47,125,583,702,-119
47,147,47,149,185,143,42
47,147,47,165,1634,1692,-58
47,147,47,187,72,71,1
47,147,47,189,106,142,-36
47,149,1,73,102,64,38
47,149,1,89,137,152,-15
47,149,4,13,132,117,15
47,149,6,37,188,70,118
47,149,6,59,101,0,101
47,149,6,65,85,0,85
47,149,6,73,118,57,61
47,149,8,41,0,73,-73
47,149,12,9,0,77,-77
47,149,12,11,118,61,57
47,149,12,31,75,56,19
47,149,12,57,86,71,15
47,149,12,71,66,66,0
47,149,12,86,129,0,129
47,149,12,95,79,0,79
47,149,12,99,94,57,37
47,149,12,103,82,81,1
47,149,13,67,85,88,-3
47,149,13,89,0,71,-71
47,149,13,121,80,90,-10
47,149,13,135,120,74,46
47,149,17,31,215,72,143
47,149,17,97,74,0,74
47,149,17,197,96,0,96
47,149,21,111,81,88,-7
47,149,21,227,76,49,27
47,149,26,163,85,0,85
47,149,29,189,50,0,50
47,149,32,3,76,100,-24
47,149,37,119,69,69,0
47,149,39,49,79,63,16
47,149,47,3,865,1372,-507
47,149,47,9,0,71,-71
47,149,47,11,69,82,-13
47,149,47,15,431,750,-319
47,149,47,21,109,191,-82
47,149,47,31,498,1096,-598
47,149,47,35,0,60,-60
47,149,47,37,10637,5752,4885
47,149,47,41,114,134,-20
47,149,47,43,116,176,-60
47,149,47,51,127,265,-138
47,149,47,53,107,72,35
47,149,47,55,0,73,-73
47,149,47,65,331,367,-36
47,149,47,81,85,77,8
47,149,47,93,303,258,45
47,149,47,99,64,79,-15
47,149,47,103,77,92,-15
47,149,47,113,257,141,116
47,149,47,117,234,331,-97
47,149,47,119,588,497,91
47,149,47,125,353,543,-190
47,149,47,141,150,141,9
47,149,47,145,0,46,-46
47,149,47,147,143,185,-42
47,149,47,157,647,433,214
47,149,47,159,63,101,-38
47,149,47,165,622,576,46
47,149,47,167,62,0,62
47,149,47,177,204,361,-157
47,149,47,187,1441,1249,192
47,149,47,189,1301,1374,-73
47,149,48,85,0,73,-73
47,149,48,113,64,63,1
47,149,48,201,106,86,20
47,149,48,439,80,85,-5
47,151,21,147,0,71,-71
47,151,47,13,70,0,70
47,151,47,93,87,82,5
47,153,47,7,128,112,16
47,153,47,65,447,432,15
47,153,47,115,132,133,-1
47,155,12,11,87,0,87
47,155,12,71,75,0,75
47,155,12,95,60,0,60
47,155,12,101,71,0,71
47,155,12,103,89,0,89
47,155,47,1,63,125,-62
47,155,47,9,574,778,-204
47,155,47,29,301,449,-148
47,155,47,37,61,79,-18
47,155,47,57,0,83,-83
47,155,47,59,0,68,-68
47,155,47,63,150,140,10
47,155,47,65,62,0,62
47,155,47,89,643,884,-241
47,155,47,93,1428,1693,-265
47,155,47,105,0,64,-64
47,155,47,163,59,0,59
47,155,47,179,48,65,-17
47,157,1,3,0,165,-165
47,157,1,73,178,218,-40
47,157,1,81,53,0,53
47,157,1,89,119,141,-22
47,157,1,97,0,52,-52
47,157,1,117,66,0,66
47,157,1,125,78,53,25
47,157,4,13,276,402,-126
47,157,5,7,0,115,-115
47,157,5,31,264,243,21
47,157,5,35,1062,838,224
47,157,5,45,58,66,-8
47,157,5,51,0,73,-73
47,157,5,55,126,94,32
47,157,5,69,73,0,73
47,157,5,93,124,89,35
47,157,5,107,68,0,68
47,157,5,119,363,409,-46
47,157,5,123,96,93,3
47,157,5,143,70,87,-17
47,157,6,1,101,89,12
47,157,6,13,0,85,-85
47,157,6,37,396,425,-29
47,157,6,59,107,122,-15
47,157,6,65,85,77,8
47,157,6,67,0,68,-68
47,157,6,71,128,86,42
47,157,6,73,361,422,-61
47,157,6,75,0,52,-52
47,157,6,85,92,97,-5
47,157,8,5,0,64,-64
47,157,8,31,0,137,-137
47,157,8,41,83,191,-108
47,157,8,59,0,54,-54
47,157,9,3,67,0,67
47,157,11,1,65,87,-22
47,157,12,9,0,66,-66
47,157,12,11,192,175,17
47,157,12,31,216,219,-3
47,157,12,33,78,176,-98
47,157,12,57,188,165,23
47,157,12,69,0,62,-62
47,157,12,71,64,0,64
47,157,12,73,56,0,56
47,157,12,81,0,61,-61
47,157,12,86,227,168,59
47,157,12,91,0,120,-120
47,157,12,95,185,262,-77
47,157,12,99,145,89,56
47,157,12,101,0,78,-78
47,157,12,103,107,160,-53
47,157,12,105,0,93,-93
47,157,12,109,0,79,-79
47,157,12,113,67,0,67
47,157,12,117,0,90,-90
47,157,13,51,0,57,-57
47,157,13,63,94,144,-50
47,157,13,67,191,276,-85
47,157,13,89,222,312,-90
47,157,13,121,261,500,-239
47,157,13,135,129,256,-127
47,157,15,3,113,101,12
47,157,17,31,751,568,183
47,157,17,43,76,72,4
47,157,17,97,117,66,51
47,157,17,197,74,0,74
47,157,18,97,126,160,-34
47,157,20,91,54,78,-24
47,157,21,67,63,0,63
47,157,21,111,112,124,-12
47,157,22,33,108,104,4
47,157,22,51,80,95,-15
47,157,22,71,72,179,-107
47,157,22,103,0,56,-56
47,157,24,3,66,0,66
47,157,24,31,0,76,-76
47,157,24,33,75,76,-1
47,157,25,17,101,73,28
47,157,25,25,63,0,63
47,157,26,125,91,71,20
47,157,26,163,142,132,10
47,157,27,37,0,67,-67
47,157,27,53,75,133,-58
47,157,28,3,0,65,-65
47,157,28,9,92,84,8
47,157,28,11,224,125,99
47,157,28,27,143,76,67
47,157,28,33,4929,6689,-1760
47,157,28,43,75,0,75
47,157,28,47,104,103,1
47,157,28,49,316,158,158
47,157,28,71,194,220,-26
47,157,28,81,173,159,14
47,157,28,83,191,113,78
47,157,28,87,71,0,71
47,157,28,89,112,104,8
47,157,28,93,631,729,-98
47,157,28,105,118,0,118
47,157,28,107,138,110,28
47,157,28,121,106,90,16
47,157,28,133,128,100,28
47,157,28,137,218,222,-4
47,157,28,143,140,97,43
47,157,28,151,329,143,186
47,157,29,19,0,72,-72
47,157,29,77,0,63,-63
47,157,29,95,76,104,-28
47,157,29,183,0,75,-75
47,157,29,189,165,219,-54
47,157,29,510,104,111,-7
47,157,31,55,61,55,6
47,157,32,3,232,258,-26
47,157,34,23,71,0,71
47,157,36,5,99,0,99
47,157,36,29,68,0,68
47,157,36,47,90,88,2
47,157,36,61,127,78,49
47,157,36,67,57,0,57
47,157,36,81,95,0,95
47,157,36,103,64,0,64
47,157,37,81,0,62,-62
47,157,37,119,148,189,-41
47,157,37,183,108,159,-51
47,157,39,35,83,62,21
47,157,39,49,111,166,-55
47,157,39,61,91,105,-14
47,157,40,109,82,110,-28
47,157,40,143,108,68,40
47,157,42,3,81,117,-36
47,157,42,101,0,92,-92
47,157,45,19,68,69,-1
47,157,45,45,0,91,-91
47,157,47,9,68,64,4
47,157,47,37,1145,1557,-412
47,157,47,45,100,68,32
47,157,47,47,1924,2905,-981
47,157,47,53,138,144,-6
47,157,47,65,287,303,-16
47,157,47,69,244,186,58
47,157,47,71,53,78,-25
47,157,47,75,122,113,9
47,157,47,77,0,62,-62
47,157,47,79,0,73,-73
47,157,47,93,260,337,-77
47,157,47,97,117,123,-6
47,157,47,109,0,81,-81
47,157,47,113,666,515,151
47,157,47,119,0,131,-131
47,157,47,125,222,295,-73
47,157,47,131,77,0,77
47,157,47,149,433,647,-214
47,157,47,165,107,140,-33
47,157,47,167,1952,2333,-381
47,157,47,183,84,76,8
47,157,47,187,192,443,-251
47,157,47,189,105,135,-30
47,157,48,27,103,87,16
47,157,48,29,189,243,-54
47,157,48,85,205,294,-89
47,157,48,113,419,673,-254
47,157,48,121,126,251,-125
47,157,48,141,0,76,-76
47,157,48,157,0,67,-67
47,157,48,201,525,694,-169
47,157,48,339,0,85,-85
47,157,48,439,328,500,-172
47,157,48,453,245,229,16
47,157,48,491,71,94,-23
47,157,49,35,0,61,-61
47,157,51,59,141,129,12
47,157,51,550,105,0,105
47,157,51,710,83,77,6
47,157,51,810,175,222,-47
47,157,53,33,107,171,-64
47,157,53,53,73,83,-10
47,157,55,79,190,136,54
47,159,47,37,138,109,29
47,159,47,41,60,81,-21
47,159,47,111,84,116,-32
47,159,47,141,75,136,-61
47,159,47,149,101,63,38
47,159,47,165,0,80,-80
47,159,47,169,84,0,84
47,159,47,189,551,415,136
47,161,47,83,133,98,35
47,161,47,125,449,321,128
47,163,37,21,67,0,67
47,163,47,19,516,456,60
47,163,47,37,70,62,8
47,163,47,59,179,193,-14
47,163,47,63,57,0,57
47,163,47,65,0,66,-66
47,163,47,73,1396,1275,121
47,163,47,93,218,264,-46
47,163,47,155,0,59,-59
47,163,47,171,93,94,-1
47,163,47,179,2081,2034,47
47,163,51,167,87,0,87
47,163,51,169,318,245,73
47,163,51,191,536,490,46
47,163,51,195,111,0,111
47,163,51,520,685,478,207
47,165,4,13,83,63,20
47,165,6,37,117,0,117
47,165,6,59,81,0,81
47,165,6,65,90,0,90
47,165,6,71,58,0,58
47,165,6,73,121,0,121
47,165,12,95,0,61,-61
47,165,12,103,64,0,64
47,165,17,31,95,78,17
47,165,18,97,56,0,56
47,165,21,3,94,115,-21
47,165,21,111,67,0,67
47,165,21,213,155,279,-124
47,165,21,227,226,218,8
47,165,47,21,217,182,35
47,165,47,37,5973,3302,2671
47,165,47,43,68,72,-4
47,165,47,65,100,146,-46
47,165,47,93,145,142,3
47,165,47,111,383,630,-247
47,165,47,119,100,123,-23
47,165,47,125,305,447,-142
47,165,47,141,82,110,-28
47,165,47,147,1692,1634,58
47,165,47,149,576,622,-46
47,165,47,157,140,107,33
47,165,47,159,80,0,80
47,165,47,169,163,255,-92
47,165,47,187,358,346,12
47,165,47,189,911,718,193
47,165,48,201,59,0,59
47,167,28,33,140,109,31
47,167,47,47,167,143,24
47,167,47,75,93,0,93
47,167,47,97,272,226,46
47,167,47,149,0,62,-62
47,167,47,157,2333,1952,381
47,169,47,37,88,0,88
47,169,47,111,108,135,-27
47,169,47,159,0,84,-84
47,169,47,165,255,163,92
47,169,47,189,251,186,65
47,171,47,19,165,217,-52
47,171,47,163,94,93,1
47,171,47,179,379,428,-49
47,173,47,1,164,91,73
47,173,47,9,0,64,-64
47,173,47,25,135,108,27
47,173,47,57,91,86,5
47,173,47,93,808,622,186
47,175,47,177,100,69,31
47,175,47,185,123,121,2
47,177,47,15,135,100,35
47,177,47,31,259,311,-52
47,177,47,37,79,58,21
47,177,47,41,189,187,2
47,177,47,61,70,87,-17
47,177,47,141,68,87,-19
47,177,47,149,361,204,157
47,177,47,175,69,100,-31
47,177,47,185,99,130,-31
47,179,37,21,137,104,33
47,179,37,119,0,95,-95
47,179,45,45,0,60,-60
47,179,47,9,50,59,-9
47,179,47,19,1439,1532,-93
47,179,47,37,87,110,-23
47,179,47,59,656,620,36
47,179,47,63,112,51,61
47,179,47,65,82,92,-10
47,179,47,73,297,236,61
47,179,47,89,0,47,-47
47,179,47,91,0,61,-61
47,179,47,93,230,390,-160
47,179,47,155,65,48,17
47,179,47,163,2034,2081,-47
47,179,47,171,428,379,49
47,179,51,169,70,69,1
47,179,51,191,91,0,91
47,179,51,520,67,0,67
47,181,1,77,83,78,5
47,181,47,71,91,82,9
47,181,47,99,138,120,18
47,183,21,83,0,62,-62
47,183,47,17,255,192,63
47,183,47,37,0,53,-53
47,183,47,53,168,144,24
47,183,47,79,105,116,-11
47,183,47,113,71,59,12
47,183,47,131,325,315,10
47,183,47,157,76,84,-8
47,185,47,35,137,138,-1
47,185,47,37,54,0,54
47,185,47,41,114,102,12
47,185,47,133,89,0,89
47,185,47,141,608,607,1
47,185,47,175,121,123,-2
47,185,47,177,130,99,31
47,187,1,73,152,72,80
47,187,1,89,91,115,-24
47,187,4,13,239,106,133
47,187,6,13,69,0,69
47,187,6,37,496,113,383
47,187,6,59,361,60,301
47,187,6,65,91,0,91
47,187,6,73,247,0,247
47,187,6,111,95,0,95
47,187,8,31,0,53,-53
47,187,8,35,80,0,80
47,187,12,11,125,0,125
47,187,12,31,66,0,66
47,187,12,57,92,0,92
47,187,12,86,84,0,84
47,187,12,95,100,65,35
47,187,12,99,151,98,53
47,187,12,117,65,0,65
47,187,13,67,81,0,81
47,187,13,89,59,0,59
47,187,13,121,151,136,15
47,187,17,31,347,93,254
47,187,17,43,148,0,148
47,187,17,89,93,0,93
47,187,17,97,108,0,108
47,187,17,197,85,0,85
47,187,21,111,101,67,34
47,187,21,227,54,0,54
47,187,26,125,118,0,118
47,187,26,163,70,0,70
47,187,29,189,103,0,103
47,187,32,3,71,88,-17
47,187,36,61,0,59,-59
47,187,37,119,142,105,37
47,187,37,183,87,95,-8
47,187,47,3,0,69,-69
47,187,47,21,148,177,-29
47,187,47,31,0,49,-49
47,187,47,37,7762,5284,2478
47,187,47,43,209,350,-141
47,187,47,65,162,187,-25
47,187,47,81,162,300,-138
47,187,47,93,236,203,33
47,187,47,117,164,410,-246
47,187,47,119,1748,2865,-1117
47,187,47,125,110,195,-85
47,187,47,141,59,0,59
47,187,47,147,71,72,-1
47,187,47,149,1249,1441,-192
47,187,47,157,443,192,251
47,187,47,165,346,358,-12
47,187,47,189,383,373,10
47,187,48,85,110,114,-4
47,187,48,113,120,101,19
47,187,48,121,81,0,81
47,187,48,157,78,0,78
47,187,48,201,178,108,70
47,187,48,439,97,0,97
47,187,48,453,90,67,23
47,187,53,33,129,84,45
47,189,4,13,61,67,-6
47,189,6,37,118,0,118
47,189,6,59,77,0,77
47,189,6,73,70,0,70
47,189,12,95,54,0,54
47,189,13,67,63,0,63
47,189,13,121,51,0,51
47,189,17,31,125,0,125
47,189,47,3,0,69,-69
47,189,47,21,84,72,12
47,189,47,37,5537,2704,2833
47,189,47,41,154,301,-147
47,189,47,43,0,69,-69
47,189,47,65,94,78,16
47,189,47,93,156,107,49
47,189,47,111,85,138,-53
47,189,47,119,129,98,31
47,189,47,125,146,183,-37
47,189,47,141,126,164,-38
47,189,47,147,142,106,36
47,189,47,149,1374,1301,73
47,189,47,157,135,105,30
47,189,47,159,415,551,-136
47,189,47,165,718,911,-193
47,189,47,169,186,251,-65
47,189,47,187,373,383,-10
48,1,48,73,156,180,-24
48,1,48,85,0,65,-65
48,1,48,113,190,135,55
48,1,48,161,64,0,64
48,1,48,201,183,151,32
48,1,48,213,255,330,-75
48,1,48,225,123,117,6
48,1,48,289,0,87,-87
48,1,48,339,63,0,63
48,1,48,423,284,474,-190
48,1,48,439,155,117,38
48,3,48,135,190,170,20
48,3,48,303,68,0,68
48,3,48,329,203,145,58
48,5,48,29,0,66,-66
48,5,48,41,65,79,-14
48,5,48,73,138,150,-12
48,5,48,113,95,153,-58
48,5,48,167,0,75,-75
48,5,48,199,65,0,65
48,5,48,201,499,675,-176
48,5,48,225,81,91,-10
48,5,48,241,94,83,11
48,5,48,245,64,78,-14
48,5,48,339,124,188,-64
48,5,48,347,552,577,-25
48,5,48,373,265,166,99
48,5,48,403,57,0,57
48,5,48,405,112,66,46
48,5,48,423,89,145,-56
48,5,48,439,68,228,-160
48,5,48,453,0,73,-73
48,5,48,455,104,111,-7
48,5,48,457,75,63,12
48,7,48,29,150,215,-65
48,7,48,201,146,139,7
48,7,48,355,242,594,-352
48,7,48,409,614,824,-210
48,7,48,453,81,87,-6
48,7,48,469,0,68,-68
48,7,48,491,0,68,-68
48,9,48,485,455,330,125
48,11,48,381,0,62,-62
48,13,48,29,2541,1836,705
48,13,48,187,0,81,-81
48,13,48,201,93,0,93
48,13,48,325,219,262,-43
48,13,48,355,64,70,-6
48,13,48,493,82,82,0
48,15,48,89,105,148,-43
48,15,48,157,301,273,28
48,15,48,201,803,560,243
48,15,48,339,0,72,-72
48,15,48,453,0,71,-71
48,15,48,473,264,155,109
48,15,48,477,120,203,-83
48,17,48,303,0,82,-82
48,19,48,29,875,626,249
48,19,48,201,81,0,81
48,19,48,259,120,117,3
48,19,48,265,173,150,23
48,21,48,27,0,157,-157
48,21,48,29,197,160,37
48,21,48,39,60,0,60
48,21,48,41,63,63,0
48,21,48,55,245,222,23
48,21,48,91,0,66,-66
48,21,48,113,61,58,3
48,21,48,149,127,120,7
48,21,48,201,296,183,113
48,21,48,209,448,358,90
48,21,48,287,154,236,-82
48,21,48,439,59,72,-13
48,21,48,453,4545,2470,2075
48,21,48,491,838,686,152
48,23,48,485,0,58,-58
48,25,48,29,127,168,-41
48,25,48,201,0,101,-101
48,25,48,215,57,58,-1
48,25,48,255,118,68,50
48,25,48,297,111,84,27
48,25,48,355,252,232,20
48,25,48,409,156,124,32
48,25,48,453,0,62,-62
48,25,48,469,0,68,-68
48,27,1,31,0,82,-82
48,27,1,45,142,95,47
48,27,1,89,0,93,-93
48,27,1,97,61,0,61
48,27,1,113,0,115,-115
48,27,2,20,133,74,59
48,27,2,90,265,185,80
48,27,4,3,132,160,-28
48,27,4,13,304,316,-12
48,27,4,19,95,83,12
48,27,5,119,95,76,19
48,27,6,29,0,54,-54
48,27,6,37,464,277,187
48,27,6,59,108,91,17
48,27,6,65,218,107,111
48,27,6,67,149,83,66
48,27,6,71,372,304,68
48,27,6,73,367,211,156
48,27,6,77,60,0,60
48,27,6,85,65,0,65
48,27,8,41,706,812,-106
48,27,12,9,78,66,12
48,27,12,11,115,105,10
48,27,12,31,128,113,15
48,27,12,57,110,173,-63
48,27,12,71,58,0,58
48,27,12,86,177,66,111
48,27,12,91,0,57,-57
48,27,12,95,194,139,55
48,27,12,99,88,0,88
48,27,12,103,76,57,19
48,27,12,105,90,59,31
48,27,13,29,77,0,77
48,27,13,51,129,130,-1
48,27,13,53,78,0,78
48,27,13,63,0,64,-64
48,27,13,67,63,0,63
48,27,13,73,115,211,-96
48,27,13,121,74,71,3
48,27,13,135,59,103,-44
48,27,13,179,393,354,39
48,27,13,215,323,374,-51
48,27,13,245,193,173,20
48,27,15,3,878,878,0
48,27,17,31,201,142,59
48,27,18,97,76,0,76
48,27,20,61,300,277,23
48,27,20,103,225,136,89
48,27,20,161,92,75,17
48,27,21,47,148,141,7
48,27,21,93,92,141,-49
48,27,22,17,71,0,71
48,27,22,51,76,0,76
48,27,22,71,72,0,72
48,27,22,115,222,134,88
48,27,24,3,84,122,-38
48,27,24,33,68,78,-10
48,27,26,163,82,0,82
48,27,29,169,253,273,-20
48,27,32,3,205,190,15
48,27,34,5,92,0,92
48,27,35,1,106,0,106
48,27,36,5,75,0,75
48,27,36,45,402,259,143
48,27,36,47,134,75,59
48,27,36,71,57,64,-7
48,27,36,81,77,0,77
48,27,37,51,506,515,-9
48,27,37,85,113,201,-88
48,27,37,119,0,69,-69
48,27,37,183,63,82,-19
48,27,39,35,77,0,77
48,27,39,49,0,71,-71
48,27,40,31,380,381,-1
48,27,40,109,113,117,-4
48,27,40,143,81,114,-33
48,27,42,3,0,58,-58
48,27,42,101,68,0,68
48,27,45,79,185,236,-51
48,27,47,125,450,405,45
48,27,47,157,87,103,-16
48,27,48,21,157,0,157
48,27,48,29,1206,1549,-343
48,27,48,39,166,134,32
48,27,48,41,190,263,-73
48,27,48,53,98,131,-33
48,27,48,61,97,109,-12
48,27,48,85,209,343,-134
48,27,48,91,84,129,-45
48,27,48,99,3239,3079,160
48,27,48,113,768,725,43
48,27,48,121,238,382,-144
48,27,48,135,68,84,-16
48,27,48,139,104,147,-43
48,27,48,141,789,715,74
48,27,48,145,159,146,13
48,27,48,157,129,184,-55
48,27,48,167,138,77,61
48,27,48,187,145,190,-45
48,27,48,201,1245,1145,100
48,27,48,209,258,242,16
48,27,48,215,145,162,-17
48,27,48,245,117,0,117
48,27,48,251,72,87,-15
48,27,48,257,0,92,-92
48,27,48,281,344,445,-101
48,27,48,303,124,153,-29
48,27,48,309,1201,1033,168
48,27,48,329,117,99,18
48,27,48,331,371,250,121
48,27,48,339,181,227,-46
48,27,48,349,0,63,-63
48,27,48,355,147,170,-23
48,27,48,423,93,109,-16
48,27,48,439,730,1091,-361
48,27,48,441,94,75,19
48,27,48,451,71,110,-39
48,27,48,453,2352,1751,601
48,27,48,469,74,0,74
48,27,48,485,81,0,81
48,27,48,491,2538,2376,162
48,27,51,41,89,101,-12
48,27,51,59,169,194,-25
48,27,51,149,132,126,6
48,27,51,153,97,87,10
48,27,51,700,137,96,41
48,27,51,810,94,0,94
48,27,53,33,91,62,29
48,27,53,53,602,443,159
48,27,53,67,199,209,-10
48,29,1,3,0,62,-62
48,29,1,73,109,79,30
48,29,1,81,58,0,58
48,29,1,89,81,121,-40
48,29,1,97,118,66,52
48,29,1,101,148,120,28
48,29,2,20,300,245,55
48,29,2,90,160,136,24
48,29,4,3,128,106,22
48,29,4,13,1118,1266,-148
48,29,4,19,379,329,50
48,29,4,21,97,93,4
48,29,4,27,86,0,86
48,29,5,7,126,0,126
48,29,5,119,201,93,108
48,29,5,143,0,66,-66
48,29,6,1,242,173,69
48,29,6,13,189,89,100
48,29,6,19,128,96,32
48,29,6,29,205,148,57
48,29,6,37,1517,944,573
48,29,6,53,203,109,94
48,29,6,59,613,361,252
48,29,6,61,80,127,-47
48,29,6,65,524,276,248
48,29,6,67,287,187,100
48,29,6,71,554,250,304
48,29,6,73,1492,1009,483
48,29,6,75,81,98,-17
48,29,6,77,108,63,45
48,29,6,81,102,54,48
48,29,6,83,214,94,120
48,29,6,85,274,285,-11
48,29,6,95,244,284,-40
48,29,6,97,53,0,53
48,29,6,99,76,0,76
48,29,6,111,134,73,61
48,29,6,115,82,0,82
48,29,8,1,215,147,68
48,29,8,5,325,350,-25
48,29,8,13,62,85,-23
48,29,8,31,219,301,-82
48,29,8,35,99,222,-123
48,29,8,41,1013,1077,-64
48,29,8,59,171,149,22
48,29,8,69,82,108,-26
48,29,8,123,59,101,-42
48,29,9,1,91,0,91
48,29,9,3,115,67,48
48,29,9,9,111,83,28
48,29,10,1,133,65,68
48,29,10,3,78,0,78
48,29,11,1,186,168,18
48,29,12,1,79,0,79
48,29,12,5,145,0,145
48,29,12,9,206,171,35
48,29,12,11,309,238,71
48,29,12,19,81,0,81
48,29,12,21,57,65,-8
48,29,12,31,268,269,-1
48,29,12,33,262,249,13
48,29,12,57,383,492,-109
48,29,12,69,0,56,-56
48,29,12,71,100,118,-18
48,29,12,73,60,0,60
48,29,12,81,0,55,-55
48,29,12,86,420,320,100
48,29,12,91,438,405,33
48,29,12,95,340,264,76
48,29,12,97,73,72,1
48,29,12,99,188,154,34
48,29,12,101,93,101,-8
48,29,12,103,170,140,30
48,29,12,105,100,105,-5
48,29,12,111,60,0,60
48,29,12,113,123,133,-10
48,29,12,115,0,55,-55
48,29,12,117,84,91,-7
48,29,12,127,65,0,65
48,29,13,51,100,62,38
48,29,13,67,115,175,-60
48,29,13,73,218,184,34
48,29,13,89,104,114,-10
48,29,13,121,155,211,-56
48,29,13,135,210,136,74
48,29,13,153,160,96,64
48,29,13,179,146,105,41
48,29,13,185,62,73,-11
48,29,13,215,162,126,36
48,29,13,245,179,158,21
48,29,15,3,1184,695,489
48,29,16,1,68,119,-51
48,29,17,31,813,615,198
48,29,17,43,165,127,38
48,29,17,89,153,0,153
48,29,17,97,133,131,2
48,29,17,143,67,0,67
48,29,17,163,239,187,52
48,29,17,197,120,57,63
48,29,18,57,54,0,54
48,29,18,89,100,68,32
48,29,18,97,202,116,86
48,29,19,153,103,77,26
48,29,20,61,176,147,29
48,29,20,91,187,132,55
48,29,20,161,82,0,82
48,29,20,173,215,169,46
48,29,21,47,128,0,128
48,29,21,93,94,89,5
48,29,21,111,124,82,42
48,29,22,15,180,101,79
48,29,22,17,115,90,25
48,29,22,19,0,82,-82
48,29,22,33,142,93,49
48,29,22,51,107,80,27
48,29,22,55,105,76,29
48,29,22,71,140,170,-30
48,29,22,79,65,0,65
48,29,22,103,0,71,-71
48,29,22,115,182,102,80
48,29,24,3,447,395,52
48,29,24,5,86,0,86
48,29,24,21,0,70,-70
48,29,24,27,134,120,14
48,29,24,31,400,260,140
48,29,24,33,262,241,21
48,29,24,510,86,66,20
48,29,25,9,50,0,50
48,29,25,17,196,160,36
48,29,25,25,89,105,-16
48,29,25,27,76,0,76
48,29,26,81,67,83,-16
48,29,26,99,0,62,-62
48,29,26,125,169,144,25
48,29,26,163,160,188,-28
48,29,27,37,78,0,78
48,29,27,53,150,224,-74
48,29,27,123,76,0,76
48,29,28,47,289,180,109
48,29,28,49,69,0,69
48,29,28,59,0,79,-79
48,29,29,77,60,0,60
48,29,29,95,176,124,52
48,29,29,101,68,0,68
48,29,29,169,139,127,12
48,29,29,189,145,178,-33
48,29,29,510,75,54,21
48,29,30,13,97,0,97
48,29,31,55,145,107,38
48,29,31,109,0,75,-75
48,29,31,153,213,175,38
48,29,32,3,823,869,-46
48,29,32,31,121,64,57
48,29,34,3,70,0,70
48,29,34,5,157,100,57
48,29,34,17,75,71,4
48,29,34,23,101,78,23
48,29,35,1,436,297,139
48,29,35,9,139,138,1
48,29,35,13,176,117,59
48,29,35,15,0,67,-67
48,29,35,25,73,0,73
48,29,35,35,160,153,7
48,29,35,49,0,76,-76
48,29,36,5,79,54,25
48,29,36,29,94,102,-8
48,29,36,45,278,160,118
48,29,36,47,206,168,38
48,29,36,55,72,76,-4
48,29,36,59,79,0,79
48,29,36,61,198,159,39
48,29,36,67,68,59,9
48,29,36,71,115,0,115
48,29,36,81,208,84,124
48,29,36,103,102,0,102
48,29,36,119,70,62,8
48,29,37,51,446,382,64
48,29,37,67,63,62,1
48,29,37,81,75,0,75
48,29,37,85,124,126,-2
48,29,37,119,183,254,-71
48,29,37,133,210,181,29
48,29,37,183,199,140,59
48,29,37,191,84,0,84
48,29,38,35,68,50,18
48,29,38,101,112,0,112
48,29,39,35,124,94,30
48,29,39,49,246,241,5
48,29,39,57,104,209,-105
48,29,39,61,104,102,2
48,29,39,113,174,180,-6
48,29,40,27,148,73,75
48,29,40,31,183,114,69
48,29,40,65,0,78,-78
48,29,40,109,458,344,114
48,29,40,143,211,166,45
48,29,41,39,0,60,-60
48,29,41,51,124,128,-4
48,29,41,67,109,177,-68
48,29,42,3,127,116,11
48,29,42,29,0,72,-72
48,29,42,45,55,0,55
48,29,42,91,0,75,-75
48,29,42,101,112,80,32
48,29,42,133,56,0,56
48,29,44,7,55,0,55
48,29,45,13,64,0,64
48,29,45,15,61,80,-19
48,29,45,19,104,103,1
48,29,45,45,0,59,-59
48,29,45,79,164,130,34
48,29,45,85,69,124,-55
48,29,47,37,126,171,-45
48,29,47,93,76,70,6
48,29,47,125,247,207,40
48,29,47,157,243,189,54
48,29,48,5,66,0,66
48,29,48,7,215,150,65
48,29,48,13,1836,2541,-705
48,29,48,19,626,875,-249
48,29,48,21,160,197,-37
48,29,48,25,168,127,41
48,29,48,27,1549,1206,343
48,29,48,31,125,101,24
48,29,48,39,360,352,8
48,29,48,41,508,440,68
48,29,48,49,0,68,-68
48,29,48,53,103,139,-36
48,29,48,55,125,166,-41
48,29,48,57,0,61,-61
48,29,48,61,1669,870,799
48,29,48,85,778,1203,-425
48,29,48,89,0,53,-53
48,29,48,91,3165,6022,-2857
48,29,48,99,265,156,109
48,29,48,113,2060,2448,-388
48,29,48,121,655,878,-223
48,29,48,123,101,66,35
48,29,48,127,126,87,39
48,29,48,131,73,0,73
48,29,48,135,353,391,-38
48,29,48,139,100,127,-27
48,29,48,141,2182,1443,739
48,29,48,157,790,842,-52
48,29,48,163,297,248,49
48,29,48,167,382,326,56
48,29,48,171,223,190,33
48,29,48,177,104,114,-10
48,29,48,183,103,57,46
48,29,48,187,4826,7493,-2667
48,29,48,201,4896,4641,255
48,29,48,209,1241,1088,153
48,29,48,213,0,58,-58
48,29,48,215,2400,1337,1063
48,29,48,221,61,78,-17
48,29,48,245,250,127,123
48,29,48,249,355,155,200
48,29,48,251,87,141,-54
48,29,48,255,167,112,55
48,29,48,257,77,85,-8
48,29,48,259,1696,2783,-1087
48,29,48,265,536,509,27
48,29,48,273,218,129,89
48,29,48,283,64,72,-8
48,29,48,299,69,67,2
48,29,48,303,614,400,214
48,29,48,309,353,307,46
48,29,48,323,837,531,306
48,29,48,325,1704,2396,-692
48,29,48,329,534,454,80
48,29,48,339,619,595,24
48,29,48,347,0,70,-70
48,29,48,355,2574,1499,1075
48,29,48,367,62,142,-80
48,29,48,373,0,90,-90
48,29,48,375,107,91,16
48,29,48,381,163,132,31
48,29,48,397,58,91,-33
48,29,48,409,441,213,228
48,29,48,423,194,219,-25
48,29,48,427,91,0,91
48,29,48,439,1782,1889,-107
48,29,48,441,374,293,81
48,29,48,451,619,375,244
48,29,48,453,3691,4491,-800
48,29,48,463,370,245,125
48,29,48,465,561,471,90
48,29,48,469,396,217,179
48,29,48,471,79,0,79
48,29,48,479,2123,995,1128
48,29,48,481,0,60,-60
48,29,48,485,198,160,38
48,29,48,489,65,0,65
48,29,48,491,1173,1479,-306
48,29,48,493,1569,2157,-588
48,29,48,507,94,103,-9
48,29,49,11,211,115,96
48,29,49,35,278,247,31
48,29,49,49,187,138,49
48,29,49,57,0,79,-79
48,29,51,13,141,125,16
48,29,51,41,72,0,72
48,29,51,59,611,619,-8
48,29,51,87,69,80,-11
48,29,51,107,146,105,41
48,29,51,153,272,185,87
48,29,51,179,89,0,89
48,29,51,199,179,120,59
48,29,51,510,85,110,-25
48,29,51,550,95,101,-6
48,29,51,650,123,107,16
48,29,51,700,150,81,69
48,29,51,710,126,92,34
48,29,51,740,0,87,-87
48,29,51,810,286,201,85
48,29,53,11,113,123,-10
48,29,53,29,62,63,-1
48,29,53,33,423,495,-72
48,29,53,35,129,129,0
48,29,53,53,632,555,77
48,29,53,61,162,123,39
48,29,53,63,127,140,-13
48,29,53,67,140,150,-10
48,29,55,25,102,68,34
48,29,55,79,182,119,63
48,29,56,21,158,130,28
48,31,48,29,101,125,-24
48,31,48,53,83,53,30
48,31,48,91,150,107,43
48,31,48,209,181,71,110
48,31,48,453,195,116,79
48,35,48,113,97,0,97
48,35,48,217,114,103,11
48,35,48,251,196,98,98
48,35,48,309,426,433,-7
48,35,48,425,75,0,75
48,35,48,439,133,100,33
48,37,5,51,0,67,-67
48,37,5,57,134,77,57
48,37,5,61,82,0,82
48,37,5,81,155,159,-4
48,37,5,91,2016,1711,305
48,37,5,119,87,94,-7
48,37,22,17,66,49,17
48,37,48,67,366,391,-25
48,37,48,85,103,148,-45
48,37,48,113,239,285,-46
48,37,48,121,77,98,-21
48,37,48,183,0,70,-70
48,37,48,201,100,106,-6
48,37,48,343,68,0,68
48,37,48,387,113,93,20
48,37,48,423,74,76,-2
48,37,48,439,158,230,-72
48,39,4,13,117,178,-61
48,39,6,37,144,151,-7
48,39,6,73,121,93,28
48,39,8,41,0,76,-76
48,39,12,11,66,0,66
48,39,12,86,85,0,85
48,39,12,99,70,0,70
48,39,17,31,89,80,9
48,39,22,19,98,81,17
48,39,22,33,85,103,-18
48,39,22,51,66,0,66
48,39,32,3,82,76,6
48,39,48,21,0,60,-60
48,39,48,27,134,166,-32
48,39,48,29,352,360,-8
48,39,48,41,133,92,41
48,39,48,61,176,80,96
48,39,48,71,80,92,-12
48,39,48,85,90,110,-20
48,39,48,91,64,154,-90
48,39,48,113,199,237,-38
48,39,48,121,85,143,-58
48,39,48,135,0,82,-82
48,39,48,141,95,0,95
48,39,48,157,3017,2659,358
48,39,48,167,2549,2640,-91
48,39,48,187,54,0,54
48,39,48,201,14496,9842,4654
48,39,48,209,79,104,-25
48,39,48,215,367,217,150
48,39,48,245,256,190,66
48,39,48,291,70,100,-30
48,39,48,303,65,0,65
48,39,48,321,528,346,182
48,39,48,329,0,63,-63
48,39,48,339,390,612,-222
48,39,48,355,157,125,32
48,39,48,361,76,0,76
48,39,48,373,0,103,-103
48,39,48,423,59,69,-10
48,39,48,439,239,224,15
48,39,48,453,259,329,-70
48,39,48,469,144,114,30
48,39,48,471,80,0,80
48,39,48,473,0,63,-63
48,39,48,481,161,111,50
48,39,48,491,103,227,-124
48,41,4,13,61,76,-15
48,41,6,1,0,90,-90
48,41,6,37,112,97,15
48,41,6,73,105,77,28
48,41,6,85,0,152,-152
48,41,8,31,0,47,-47
48,41,8,41,0,74,-74
48,41,17,31,0,59,-59
48,41,25,17,0,52,-52
48,41,32,3,0,52,-52
48,41,41,67,0,60,-60
48,41,48,5,79,65,14
48,41,48,21,63,63,0
48,41,48,27,263,190,73
48,41,48,29,440,508,-68
48,41,48,39,92,133,-41
48,41,48,51,483,519,-36
48,41,48,61,64,0,64
48,41,48,85,177,267,-90
48,41,48,91,94,96,-2
48,41,48,113,356,564,-208
48,41,48,121,153,218,-65
48,41,48,139,0,61,-61
48,41,48,141,71,83,-12
48,41,48,157,235,344,-109
48,41,48,167,129,128,1
48,41,48,185,621,627,-6
48,41,48,201,1756,2107,-351
48,41,48,209,110,182,-72
48,41,48,215,107,87,20
48,41,48,245,109,0,109
48,41,48,287,100,0,100
48,41,48,289,121,103,18
48,41,48,303,79,92,-13
48,41,48,309,200,196,4
48,41,48,313,163,111,52
48,41,48,329,0,60,-60
48,41,48,331,134,102,32
48,41,48,339,447,508,-61
48,41,48,355,104,63,41
48,41,48,367,0,74,-74
48,41,48,395,661,664,-3
48,41,48,423,65,102,-37
48,41,48,439,365,446,-81
48,41,48,453,422,769,-347
48,41,48,469,62,0,62
48,41,48,471,229,132,97
48,41,48,473,113,73,40
48,41,48,477,250,163,87
48,41,48,491,267,414,-147
48,41,53,33,0,80,-80
48,43,48,141,0,68,-68
48,43,48,329,0,65,-65
48,47,48,249,99,149,-50
48,47,48,273,0,59,-59
48,49,48,29,68,0,68
48,49,48,83,122,83,39
48,49,48,93,124,66,58
48,49,48,133,64,0,64
48,49,48,135,0,56,-56
48,49,48,329,64,0,64
48,49,48,439,104,119,-15
48,49,48,441,74,190,-116
48,49,48,451,0,96,-96
48,49,48,453,62,76,-14
48,49,48,491,81,0,81
48,51,48,41,519,483,36
48,51,48,201,172,75,97
48,51,48,453,0,53,-53
48,51,48,477,87,107,-20
48,53,48,27,131,98,33
48,53,48,29,139,103,36
48,53,48,31,53,83,-30
48,53,48,91,60,0,60
48,53,48,113,54,0,54
48,53,48,201,213,111,102
48,53,48,209,130,80,50
48,53,48,281,124,163,-39
48,53,48,299,544,650,-106
48,53,48,329,61,0,61
48,53,48,439,69,0,69
48,53,48,453,964,627,337
48,53,48,491,895,579,316
48,55,48,21,222,245,-23
48,55,48,29,166,125,41
48,55,48,91,0,134,-134
48,55,48,177,127,134,-7
48,55,48,187,227,297,-70
48,55,48,201,93,0,93
48,55,48,209,1061,1097,-36
48,55,48,453,1743,728,1015
48,55,48,491,185,130,55
48,57,48,29,61,0,61
48,57,48,167,74,0,74
48,57,48,201,129,145,-16
48,57,48,239,84,96,-12
48,57,48,469,314,431,-117
48,59,48,133,84,0,84
48,59,48,441,712,588,124
48,61,4,13,0,72,-72
48,61,6,37,72,68,4
48,61,6,73,112,94,18
48,61,8,41,0,71,-71
48,61,12,57,106,112,-6
48,61,17,31,73,0,73
48,61,32,3,0,57,-57
48,61,48,27,109,97,12
48,61,48,29,870,1669,-799
48,61,48,39,80,176,-96
48,61,48,41,0,64,-64
48,61,48,85,70,82,-12
48,61,48,91,0,103,-103
48,61,48,113,299,312,-13
48,61,48,121,80,111,-31
48,61,48,141,173,112,61
48,61,48,157,95,165,-70
48,61,48,167,87,135,-48
48,61,48,201,1236,1517,-281
48,61,48,209,70,179,-109
48,61,48,215,2201,2603,-402
48,61,48,273,89,81,8
48,61,48,339,111,119,-8
48,61,48,355,435,563,-128
48,61,48,409,189,275,-86
48,61,48,427,0,80,-80
48,61,48,439,204,293,-89
48,61,48,453,396,701,-305
48,61,48,479,181,195,-14
48,61,48,489,368,250,118
48,61,48,491,181,240,-59
48,61,51,59,0,88,-88
48,63,48,113,68,0,68
48,63,48,449,305,248,57
48,63,48,459,76,126,-50
48,65,48,179,89,96,-7
48,65,48,233,118,91,27
48,65,48,375,74,82,-8
48,65,48,381,114,130,-16
48,67,5,91,129,84,45
48,67,22,17,85,71,14
48,67,48,37,391,366,25
48,67,48,113,86,0,86
48,67,48,183,0,90,-90
48,67,48,315,0,78,-78
48,67,48,343,192,173,19
48,69,48,117,0,72,-72
48,71,48,39,92,80,12
48,71,48,167,212,114,98
48,71,48,201,3033,1868,1165
48,71,48,245,278,280,-2
48,71,48,291,336,455,-119
48,71,48,339,79,88,-9
48,73,48,1,180,156,24
48,73,48,5,150,138,12
48,73,48,113,93,90,3
48,73,48,121,68,0,68
48,73,48,201,138,97,41
48,73,48,213,115,115,0
48,73,48,347,102,118,-16
48,73,48,401,133,125,8
48,73,48,423,959,1003,-44
48,73,48,439,105,65,40
48,77,48,337,0,68,-68
48,77,48,485,492,390,102
48,79,48,219,0,71,-71
48,79,48,303,0,55,-55
48,81,48,451,127,87,40
48,83,48,49,83,122,-39
48,83,48,441,79,75,4
48,85,1,73,78,0,78
48,85,1,89,65,0,65
48,85,4,13,1051,791,260
48,85,4,19,216,144,72
48,85,5,7,184,178,6
48,85,5,45,72,0,72
48,85,5,51,0,61,-61
48,85,5,119,273,163,110
48,85,5,125,68,0,68
48,85,5,143,90,110,-20
48,85,6,1,573,295,278
48,85,6,13,243,116,127
48,85,6,29,83,0,83
48,85,6,37,2925,784,2141
48,85,6,59,1381,404,977
48,85,6,61,83,0,83
48,85,6,65,351,179,172
48,85,6,67,186,101,85
48,85,6,71,328,107,221
48,85,6,73,780,408,372
48,85,6,75,126,109,17
48,85,6,81,103,77,26
48,85,6,85,733,544,189
48,85,6,95,63,0,63
48,85,6,97,61,0,61
48,85,6,111,239,81,158
48,85,8,1,100,83,17
48,85,8,5,274,256,18
48,85,8,13,0,73,-73
48,85,8,31,185,241,-56
48,85,8,35,212,222,-10
48,85,8,41,243,290,-47
48,85,8,59,103,168,-65
48,85,8,69,77,80,-3
48,85,9,1,146,83,63
48,85,9,3,149,78,71
48,85,9,9,71,0,71
48,85,10,3,64,59,5
48,85,11,1,64,74,-10
48,85,12,9,72,90,-18
48,85,12,11,445,195,250
48,85,12,31,157,132,25
48,85,12,33,57,0,57
48,85,12,57,263,202,61
48,85,12,71,60,92,-32
48,85,12,81,76,111,-35
48,85,12,86,301,172,129
48,85,12,95,315,216,99
48,85,12,99,198,199,-1
48,85,12,101,60,0,60
48,85,12,103,118,143,-25
48,85,12,105,0,59,-59
48,85,12,109,0,96,-96
48,85,12,117,130,75,55
48,85,13,67,176,100,76
48,85,13,89,125,90,35
48,85,13,117,118,0,118
48,85,13,121,353,299,54
48,85,13,135,147,164,-17
48,85,15,3,171,108,63
48,85,17,31,1031,493,538
48,85,17,43,426,156,270
48,85,17,89,110,0,110
48,85,17,97,194,68,126
48,85,17,111,86,0,86
48,85,17,113,424,75,349
48,85,17,197,176,0,176
48,85,18,57,0,71,-71
48,85,18,97,120,60,60
48,85,19,153,100,73,27
48,85,20,91,310,188,122
48,85,20,173,144,98,46
48,85,21,15,159,0,159
48,85,21,111,91,70,21
48,85,21,117,97,0,97
48,85,22,15,142,63,79
48,85,22,17,298,83,215
48,85,22,33,168,61,107
48,85,22,51,106,105,1
48,85,22,55,78,0,78
48,85,22,71,129,61,68
48,85,22,73,171,0,171
48,85,22,103,80,0,80
48,85,24,3,71,0,71
48,85,24,5,111,0,111
48,85,24,27,74,64,10
48,85,24,31,164,100,64
48,85,24,33,128,0,128
48,85,25,17,278,120,158
48,85,25,21,112,0,112
48,85,25,25,95,0,95
48,85,25,27,108,0,108
48,85,26,77,80,0,80
48,85,26,99,97,0,97
48,85,26,125,345,174,171
48,85,26,161,98,73,25
48,85,26,163,186,107,79
48,85,27,53,330,178,152
48,85,28,49,127,0,127
48,85,29,77,54,0,54
48,85,29,95,195,84,111
48,85,29,183,120,0,120
48,85,29,189,403,151,252
48,85,29,510,64,0,64
48,85,31,55,171,97,74
48,85,32,3,398,312,86
48,85,32,31,90,0,90
48,85,34,3,245,81,164
48,85,34,13,98,0,98
48,85,34,17,263,93,170
48,85,34,21,70,0,70
48,85,34,23,503,131,372
48,85,34,27,157,0,157
48,85,34,35,141,0,141
48,85,35,1,219,71,148
48,85,36,29,105,0,105
48,85,36,47,193,112,81
48,85,36,55,89,0,89
48,85,36,59,215,0,215
48,85,36,61,179,181,-2
48,85,36,81,313,106,207
48,85,36,103,176,0,176
48,85,36,119,155,0,155
48,85,37,63,0,55,-55
48,85,37,81,79,0,79
48,85,37,119,270,276,-6
48,85,37,183,302,192,110
48,85,39,35,128,70,58
48,85,39,49,229,161,68
48,85,39,61,112,0,112
48,85,40,13,112,86,26
48,85,40,17,82,0,82
48,85,40,27,178,148,30
48,85,40,31,64,0,64
48,85,40,109,554,343,211
48,85,40,143,360,288,72
48,85,41,51,55,60,-5
48,85,41,67,148,124,24
48,85,42,3,108,107,1
48,85,42,29,92,78,14
48,85,42,91,128,0,128
48,85,42,101,102,76,26
48,85,44,7,92,0,92
48,85,45,45,63,0,63
48,85,47,37,136,156,-20
48,85,47,65,61,0,61
48,85,47,149,73,0,73
48,85,47,157,294,205,89
48,85,47,187,114,110,4
48,85,48,1,65,0,65
48,85,48,27,343,209,134
48,85,48,29,1203,778,425
48,85,48,37,148,103,45
48,85,48,39,110,90,20
48,85,48,41,267,177,90
48,85,48,61,82,70,12
48,85,48,91,62,211,-149
48,85,48,97,122,237,-115
48,85,48,113,35545,24108,11437
48,85,48,121,17692,18145,-453
48,85,48,135,84,51,33
48,85,48,139,352,541,-189
48,85,48,141,424,250,174
48,85,48,147,364,876,-512
48,85,48,157,619,387,232
48,85,48,167,128,146,-18
48,85,48,181,1416,2898,-1482
48,85,48,183,205,122,83
48,85,48,187,68,84,-16
48,85,48,201,2131,1455,676
48,85,48,209,157,176,-19
48,85,48,213,148,200,-52
48,85,48,215,146,78,68
48,85,48,221,0,145,-145
48,85,48,223,94,139,-45
48,85,48,231,934,1518,-584
48,85,48,245,76,0,76
48,85,48,251,171,174,-3
48,85,48,257,659,1013,-354
48,85,48,259,0,69,-69
48,85,48,277,82,101,-19
48,85,48,303,473,266,207
48,85,48,309,256,198,58
48,85,48,329,210,162,48
48,85,48,339,298,356,-58
48,85,48,347,60,0,60
48,85,48,349,72,71,1
48,85,48,355,160,99,61
48,85,48,367,168,226,-58
48,85,48,373,0,79,-79
48,85,48,375,77,0,77
48,85,48,379,0,102,-102
48,85,48,381,187,117,70
48,85,48,397,1384,1659,-275
48,85,48,423,538,374,164
48,85,48,439,5189,3989,1200
48,85,48,441,147,120,27
48,85,48,451,85,0,85
48,85,48,453,1167,1390,-223
48,85,48,467,99,142,-43
48,85,48,485,181,136,45
48,85,48,491,635,714,-79
48,85,48,497,91,90,1
48,85,48,499,95,197,-102
48,85,49,11,85,0,85
48,85,49,35,190,181,9
48,85,49,49,141,159,-18
48,85,51,13,65,65,0
48,85,51,59,358,353,5
48,85,51,87,123,71,52
48,85,51,107,179,107,72
48,85,51,153,94,96,-2
48,85,51,810,93,85,8
48,85,53,11,113,0,113
48,85,53,33,492,896,-404
48,85,53,53,123,114,9
48,85,53,61,207,128,79
48,85,53,63,0,66,-66
48,85,55,25,103,71,32
48,85,55,79,131,84,47
48,85,55,133,119,0,119
48,89,48,15,148,105,43
48,89,48,29,53,0,53
48,89,48,149,103,161,-58
48,89,48,157,148,104,44
48,89,48,201,320,256,64
48,89,48,481,78,56,22
48,91,4,13,103,76,27
48,91,6,37,142,0,142
48,91,6,59,102,0,102
48,91,6,65,97,0,97
48,91,6,71,73,0,73
48,91,6,73,209,0,209
48,91,8,41,73,0,73
48,91,15,3,62,0,62
48,91,32,3,79,0,79
48,91,48,21,66,0,66
48,91,48,27,129,84,45
48,91,48,29,6022,3165,2857
48,91,48,31,107,150,-43
48,91,48,39,154,64,90
48,91,48,41,96,94,2
48,91,48,53,0,60,-60
48,91,48,55,134,0,134
48,91,48,61,103,0,103
48,91,48,85,211,62,149
48,91,48,113,177,146,31
48,91,48,121,104,75,29
48,91,48,141,93,64,29
48,91,48,157,194,90,104
48,91,48,167,140,61,79
48,91,48,177,72,0,72
48,91,48,187,3950,3144,806
48,91,48,201,1030,425,605
48,91,48,209,1427,779,648
48,91,48,215,146,0,146
48,91,48,259,282,178,104
48,91,48,303,118,63,55
48,91,48,309,67,53,14
48,91,48,325,62,0,62
48,91,48,329,85,0,85
48,91,48,339,236,115,121
48,91,48,355,244,118,126
48,91,48,409,63,0,63
48,91,48,439,198,139,59
48,91,48,453,774,559,215
48,91,48,469,83,0,83
48,91,48,479,60,0,60
48,91,48,491,338,215,123
48,91,48,493,108,165,-57
48,93,48,49,66,124,-58
48,93,48,143,211,138,73
48,93,48,439,66,0,66
48,95,48,451,84,100,-16
48,97,40,19,0,89,-89
48,97,40,85,116,131,-15
48,97,48,85,237,122,115
48,97,48,113,161,96,65
48,97,48,121,1283,702,581
48,97,48,181,477,535,-58
48,97,48,337,122,112,10
48,97,48,439,191,123,68
48,99,6,37,71,0,71
48,99,6,71,88,0,88
48,99,6,73,73,0,73
48,99,8,41,227,248,-21
48,99,13,179,116,99,17
48,99,13,215,121,95,26
48,99,15,3,258,174,84
48,99,20,61,117,0,117
48,99,29,169,0,99,-99
48,99,36,45,139,0,139
48,99,37,51,108,158,-50
48,99,45,79,0,84,-84
48,99,47,125,155,106,49
48,99,48,27,3079,3239,-160
48,99,48,29,156,265,-109
48,99,48,113,85,121,-36
48,99,48,121,0,67,-67
48,99,48,141,214,218,-4
48,99,48,193,0,111,-111
48,99,48,201,167,199,-32
48,99,48,281,412,383,29
48,99,48,309,318,331,-13
48,99,48,439,104,148,-44
48,99,48,453,262,239,23
48,99,48,491,234,303,-69
48,99,53,53,224,167,57
48,103,48,135,102,99,3
48,107,48,303,252,264,-12
48,111,48,205,198,253,-55
48,111,48,381,0,68,-68
48,113,1,3,68,65,3
48,113,1,73,241,185,56
48,113,1,89,76,104,-28
48,113,1,97,93,65,28
48,113,1,117,68,0,68
48,113,1,125,52,0,52
48,113,2,20,99,72,27
48,113,4,13,1334,1333,1
48,113,4,19,243,237,6
48,113,4,21,0,58,-58
48,113,5,7,208,238,-30
48,113,5,31,76,0,76
48,113,5,45,90,0,90
48,113,5,51,0,54,-54
48,113,5,69,98,0,98
48,113,5,91,109,0,109
48,113,5,119,590,435,155
48,113,5,125,61,89,-28
48,113,5,131,67,0,67
48,113,5,143,190,204,-14
48,113,6,1,574,428,146
48,113,6,13,211,223,-12
48,113,6,19,160,109,51
48,113,6,29,130,0,130
48,113,6,37,2517,1990,527
48,113,6,53,62,0,62
48,113,6,59,1036,605,431
48,113,6,61,64,0,64
48,113,6,65,373,369,4
48,113,6,67,259,231,28
48,113,6,71,461,302,159
48,113,6,73,1178,858,320
48,113,6,75,374,294,80
48,113,6,77,0,89,-89
48,113,6,81,191,234,-43
48,113,6,83,101,63,38
48,113,6,85,587,575,12
48,113,6,95,73,0,73
48,113,6,97,60,0,60
48,113,6,99,58,0,58
48,113,6,111,222,70,152
48,113,8,1,137,129,8
48,113,8,5,316,442,-126
48,113,8,13,77,112,-35
48,113,8,31,487,808,-321
48,113,8,35,158,213,-55
48,113,8,41,304,474,-170
48,113,8,59,129,223,-94
48,113,8,69,97,90,7
48,113,8,123,68,81,-13
48,113,9,1,302,160,142
48,113,9,3,179,84,95
48,113,9,9,90,74,16
48,113,10,3,140,111,29
48,113,11,1,254,282,-28
48,113,12,1,49,44,5
48,113,12,5,80,69,11
48,113,12,9,116,81,35
48,113,12,11,560,444,116
48,113,12,15,0,65,-65
48,113,12,21,62,80,-18
48,113,12,31,342,307,35
48,113,12,33,106,74,32
48,113,12,57,446,441,5
48,113,12,69,0,62,-62
48,113,12,71,178,137,41
48,113,12,73,0,49,-49
48,113,12,81,57,69,-12
48,113,12,86,776,507,269
48,113,12,91,67,0,67
48,113,12,95,438,452,-14
48,113,12,97,87,66,21
48,113,12,99,348,378,-30
48,113,12,101,57,77,-20
48,113,12,103,210,252,-42
48,113,12,105,100,81,19
48,113,12,111,68,0,68
48,113,12,115,72,108,-36
48,113,12,117,122,129,-7
48,113,12,127,79,81,-2
48,113,13,51,85,67,18
48,113,13,63,106,90,16
48,113,13,67,332,256,76
48,113,13,89,395,383,12
48,113,13,117,72,70,2
48,113,13,121,625,617,8
48,113,13,135,262,259,3
48,113,15,3,258,209,49
48,113,16,1,77,111,-34
48,113,17,31,2088,1202,886
48,113,17,43,303,201,102
48,113,17,89,108,61,47
48,113,17,97,200,130,70
48,113,17,113,115,0,115
48,113,17,143,100,0,100
48,113,17,163,80,0,80
48,113,17,197,159,76,83
48,113,17,201,78,0,78
48,113,18,3,83,154,-71
48,113,18,57,0,75,-75
48,113,18,89,146,0,146
48,113,18,97,285,234,51
48,113,19,13,58,0,58
48,113,19,113,69,0,69
48,113,19,153,132,94,38
48,113,20,45,79,0,79
48,113,20,91,310,285,25
48,113,20,173,332,203,129
48,113,20,177,51,0,51
48,113,21,67,81,0,81
48,113,21,111,179,164,15
48,113,22,15,291,141,150
48,113,22,17,949,444,505
48,113,22,19,100,62,38
48,113,22,33,337,205,132
48,113,22,51,319,216,103
48,113,22,55,207,129,78
48,113,22,61,114,0,114
48,113,22,67,62,0,62
48,113,22,71,350,314,36
48,113,22,73,430,206,224
48,113,22,79,131,55,76
48,113,22,103,77,86,-9
48,113,22,105,53,0,53
48,113,22,119,67,0,67
48,113,24,3,107,84,23
48,113,24,5,161,86,75
48,113,24,27,85,69,16
48,113,24,31,249,262,-13
48,113,24,33,216,143,73
48,113,24,510,120,93,27
48,113,25,9,62,0,62
48,113,25,17,306,286,20
48,113,25,21,167,96,71
48,113,25,25,231,219,12
48,113,25,27,92,0,92
48,113,26,49,59,77,-18
48,113,26,65,104,0,104
48,113,26,77,51,0,51
48,113,26,81,118,91,27
48,113,26,99,79,54,25
48,113,26,125,242,248,-6
48,113,26,161,95,87,8
48,113,26,163,282,196,86
48,113,27,37,78,80,-2
48,113,27,53,453,330,123
48,113,27,123,104,102,2
48,113,28,1,57,0,57
48,113,28,33,70,96,-26
48,113,28,35,52,0,52
48,113,28,47,77,0,77
48,113,28,49,366,126,240
48,113,28,89,113,0,113
48,113,28,121,56,0,56
48,113,28,149,95,0,95
48,113,28,151,111,86,25
48,113,29,19,94,0,94
48,113,29,47,74,0,74
48,113,29,77,76,70,6
48,113,29,95,365,261,104
48,113,29,183,126,88,38
48,113,29,189,554,311,243
48,113,29,510,236,139,97
48,113,31,55,237,156,81
48,113,31,109,96,0,96
48,113,32,3,734,661,73
48,113,32,31,71,101,-30
48,113,33,11,64,56,8
48,113,34,3,200,106,94
48,113,34,5,91,0,91
48,113,34,13,130,49,81
48,113,34,17,340,219,121
48,113,34,21,78,0,78
48,113,34,23,368,201,167
48,113,34,25,92,0,92
48,113,34,27,156,0,156
48,113,34,31,67,0,67
48,113,34,35,91,67,24
48,113,34,39,71,0,71
48,113,35,1,280,222,58
48,113,35,13,96,79,17
48,113,35,25,63,0,63
48,113,35,43,0,59,-59
48,113,35,49,59,134,-75
48,113,36,5,184,70,114
48,113,36,29,104,73,31
48,113,36,47,426,341,85
48,113,36,55,81,92,-11
48,113,36,59,151,79,72
48,113,36,61,786,822,-36
48,113,36,67,66,0,66
48,113,36,81,461,245,216
48,113,36,103,183,93,90
48,113,36,119,143,59,84
48,113,37,21,0,63,-63
48,113,37,51,99,90,9
48,113,37,63,109,73,36
48,113,37,67,74,69,5
48,113,37,81,105,73,32
48,113,37,119,583,477,106
48,113,37,133,92,0,92
48,113,37,183,292,279,13
48,113,38,17,65,0,65
48,113,39,17,58,0,58
48,113,39,35,245,185,60
48,113,39,41,0,49,-49
48,113,39,49,366,286,80
48,113,39,61,163,187,-24
48,113,39,95,71,0,71
48,113,39,113,83,71,12
48,113,39,153,61,63,-2
48,113,40,13,68,98,-30
48,113,40,17,84,57,27
48,113,40,19,0,83,-83
48,113,40,27,273,190,83
48,113,40,31,205,129,76
48,113,40,109,997,825,172
48,113,40,119,121,0,121
48,113,40,123,58,0,58
48,113,40,143,667,555,112
48,113,41,5,0,85,-85
48,113,41,51,159,216,-57
48,113,41,67,158,188,-30
48,113,42,3,188,215,-27
48,113,42,17,56,0,56
48,113,42,29,75,77,-2
48,113,42,45,0,59,-59
48,113,42,91,123,143,-20
48,113,42,101,247,179,68
48,113,44,7,115,80,35
48,113,45,13,0,60,-60
48,113,45,19,79,67,12
48,113,45,45,121,111,10
48,113,45,79,64,66,-2
48,113,47,37,492,503,-11
48,113,47,65,84,63,21
48,113,47,93,94,73,21
48,113,47,125,60,85,-25
48,113,47,149,63,64,-1
48,113,47,157,673,419,254
48,113,47,187,101,120,-19
48,113,48,1,135,190,-55
48,113,48,5,153,95,58
48,113,48,21,58,61,-3
48,113,48,27,725,768,-43
48,113,48,29,2448,2060,388
48,113,48,35,0,97,-97
48,113,48,37,285,239,46
48,113,48,39,237,199,38
48,113,48,41,564,356,208
48,113,48,53,0,54,-54
48,113,48,61,312,299,13
48,113,48,63,0,68,-68
48,113,48,67,0,86,-86
48,113,48,73,90,93,-3
48,113,48,85,24108,35545,-11437
48,113,48,91,146,177,-31
48,113,48,97,96,161,-65
48,113,48,99,121,85,36
48,113,48,119,0,63,-63
48,113,48,121,17488,25495,-8007
48,113,48,135,254,306,-52
48,113,48,139,3820,7597,-3777
48,113,48,141,827,693,134
48,113,48,143,78,81,-3
48,113,48,147,136,257,-121
48,113,48,157,720,588,132
48,113,48,159,0,70,-70
48,113,48,161,68,69,-1
48,113,48,167,278,337,-59
48,113,48,171,0,64,-64
48,113,48,181,575,910,-335
48,113,48,183,578,455,123
48,113,48,187,131,120,11
48,113,48,201,5911,4809,1102
48,113,48,203,240,209,31
48,113,48,209,261,318,-57
48,113,48,213,526,1023,-497
48,113,48,215,581,492,89
48,113,48,217,112,254,-142
48,113,48,221,143,332,-189
48,113,48,223,146,271,-125
48,113,48,231,1225,2379,-1154
48,113,48,245,345,169,176
48,113,48,251,661,1362,-701
48,113,48,257,3702,10502,-6800
48,113,48,259,52,96,-44
48,113,48,265,52,61,-9
48,113,48,277,215,198,17
48,113,48,293,57,61,-4
48,113,48,303,824,582,242
48,113,48,309,816,674,142
48,113,48,329,403,423,-20
48,113,48,337,0,91,-91
48,113,48,339,533,721,-188
48,113,48,343,59,0,59
48,113,48,347,180,138,42
48,113,48,349,465,861,-396
48,113,48,355,305,280,25
48,113,48,361,88,0,88
48,113,48,363,0,60,-60
48,113,48,367,277,552,-275
48,113,48,373,0,92,-92
48,113,48,375,235,174,61
48,113,48,379,62,198,-136
48,113,48,381,201,170,31
48,113,48,397,3005,5475,-2470
48,113,48,401,114,79,35
48,113,48,409,0,55,-55
48,113,48,419,0,72,-72
48,113,48,423,1131,1078,53
48,113,48,439,30925,37566,-6641
48,113,48,441,411,298,113
48,113,48,449,135,128,7
48,113,48,451,216,163,53
48,113,48,453,3075,3460,-385
48,113,48,459,76,112,-36
48,113,48,465,0,73,-73
48,113,48,467,424,852,-428
48,113,48,469,74,0,74
48,113,48,471,123,104,19
48,113,48,473,51,0,51
48,113,48,479,355,264,91
48,113,48,485,374,345,29
48,113,48,491,785,962,-177
48,113,48,497,144,241,-97
48,113,48,499,122,341,-219
48,113,49,35,335,312,23
48,113,49,49,173,103,70
48,113,51,13,154,166,-12
48,113,51,59,431,390,41
48,113,51,87,99,112,-13
48,113,51,107,106,102,4
48,113,51,153,111,69,42
48,113,51,510,123,65,58
48,113,51,710,133,74,59
48,113,51,760,57,0,57
48,113,51,810,138,109,29
48,113,53,11,106,66,40
48,113,53,33,774,1058,-284
48,113,53,35,0,74,-74
48,113,53,53,229,139,90
48,113,53,61,148,181,-33
48,113,53,63,0,77,-77
48,113,55,25,133,93,40
48,113,55,79,439,164,275
48,113,55,133,64,0,64
48,115,48,303,99,224,-125
48,115,48,329,94,114,-20
48,117,48,69,72,0,72
48,117,48,369,81,88,-7
48,117,48,375,95,155,-60
48,117,48,381,109,271,-162
48,119,48,113,63,0,63
48,119,48,223,0,81,-81
48,119,48,231,117,57,60
48,119,48,277,0,89,-89
48,121,1,73,72,0,72
48,121,4,13,703,662,41
48,121,4,19,177,86,91
48,121,5,7,165,140,25
48,121,5,51,0,60,-60
48,121,5,119,203,138,65
48,121,5,143,92,66,26
48,121,6,1,217,118,99
48,121,6,13,138,78,60
48,121,6,19,71,0,71
48,121,6,37,1344,534,810
48,121,6,59,720,272,448
48,121,6,65,357,134,223
48,121,6,67,129,61,68
48,121,6,71,227,62,165
48,121,6,73,401,333,68
48,121,6,81,72,0,72
48,121,6,85,264,167,97
48,121,6,111,145,0,145
48,121,8,1,89,142,-53
48,121,8,5,152,237,-85
48,121,8,13,0,77,-77
48,121,8,31,136,167,-31
48,121,8,35,167,144,23
48,121,8,41,275,275,0
48,121,8,59,84,138,-54
48,121,8,69,77,81,-4
48,121,8,123,0,66,-66
48,121,9,1,116,78,38
48,121,9,9,68,0,68
48,121,11,1,0,57,-57
48,121,12,9,0,60,-60
48,121,12,11,214,142,72
48,121,12,31,90,93,-3
48,121,12,57,180,171,9
48,121,12,71,117,67,50
48,121,12,86,232,127,105
48,121,12,95,198,159,39
48,121,12,99,176,139,37
48,121,12,103,100,138,-38
48,121,12,117,94,74,20
48,121,13,67,147,86,61
48,121,13,89,84,65,19
48,121,13,121,158,148,10
48,121,13,135,159,105,54
48,121,15,3,136,75,61
48,121,17,31,593,292,301
48,121,17,43,166,67,99
48,121,17,89,61,0,61
48,121,17,97,186,0,186
48,121,17,111,64,0,64
48,121,17,197,113,60,53
48,121,18,57,94,89,5
48,121,18,89,93,0,93
48,121,18,97,73,119,-46
48,121,19,153,0,56,-56
48,121,20,91,152,146,6
48,121,20,173,91,109,-18
48,121,21,111,72,72,0
48,121,22,15,87,0,87
48,121,22,17,244,113,131
48,121,22,33,139,66,73
48,121,22,51,138,55,83
48,121,22,55,72,0,72
48,121,22,71,90,0,90
48,121,22,73,122,0,122
48,121,22,103,78,0,78
48,121,24,5,53,0,53
48,121,24,31,80,72,8
48,121,25,17,103,65,38
48,121,25,27,93,0,93
48,121,26,99,72,0,72
48,121,26,125,159,118,41
48,121,26,163,134,66,68
48,121,27,37,86,0,86
48,121,27,53,145,127,18
48,121,28,49,150,0,150
48,121,28,89,86,0,86
48,121,29,19,0,55,-55
48,121,29,77,0,58,-58
48,121,29,95,137,100,37
48,121,29,183,85,0,85
48,121,29,189,177,124,53
48,121,29,510,61,0,61
48,121,31,55,109,97,12
48,121,32,3,330,256,74
48,121,34,3,104,0,104
48,121,34,17,107,0,107
48,121,34,23,121,0,121
48,121,34,35,63,0,63
48,121,35,1,119,89,30
48,121,36,5,67,0,67
48,121,36,47,109,76,33
48,121,36,59,109,0,109
48,121,36,61,112,107,5
48,121,36,81,147,0,147
48,121,36,103,77,0,77
48,121,36,119,67,0,67
48,121,37,119,156,112,44
48,121,37,183,119,158,-39
48,121,39,35,0,58,-58
48,121,39,49,176,111,65
48,121,39,61,76,0,76
48,121,40,13,58,0,58
48,121,40,17,100,75,25
48,121,40,19,0,81,-81
48,121,40,27,151,136,15
48,121,40,31,80,72,8
48,121,40,85,0,75,-75
48,121,40,109,461,306,155
48,121,40,143,249,274,-25
48,121,41,51,0,62,-62
48,121,41,67,0,72,-72
48,121,42,3,91,77,14
48,121,42,29,0,54,-54
48,121,42,101,66,51,15
48,121,44,7,62,0,62
48,121,45,45,0,69,-69
48,121,47,37,84,96,-12
48,121,47,93,0,58,-58
48,121,47,157,251,126,125
48,121,47,187,0,81,-81
48,121,48,27,382,238,144
48,121,48,29,878,655,223
48,121,48,37,98,77,21
48,121,48,39,143,85,58
48,121,48,41,218,153,65
48,121,48,61,111,80,31
48,121,48,73,0,68,-68
48,121,48,85,18145,17692,453
48,121,48,91,75,104,-29
48,121,48,97,702,1283,-581
48,121,48,99,67,0,67
48,121,48,113,25495,17488,8007
48,121,48,135,98,103,-5
48,121,48,139,413,562,-149
48,121,48,141,302,222,80
48,121,48,143,67,0,67
48,121,48,147,99,180,-81
48,121,48,157,376,267,109
48,121,48,167,129,149,-20
48,121,48,181,677,1275,-598
48,121,48,183,116,135,-19
48,121,48,187,102,76,26
48,121,48,201,1655,1144,511
48,121,48,203,52,70,-18
48,121,48,209,171,169,2
48,121,48,213,111,179,-68
48,121,48,215,130,97,33
48,121,48,217,0,95,-95
48,121,48,221,118,258,-140
48,121,48,223,0,69,-69
48,121,48,231,208,303,-95
48,121,48,245,83,0,83
48,121,48,251,349,298,51
48,121,48,257,315,680,-365
48,121,48,277,88,109,-21
48,121,48,303,406,244,162
48,121,48,309,240,231,9
48,121,48,329,317,204,113
48,121,48,337,140,263,-123
48,121,48,339,315,416,-101
48,121,48,347,77,0,77
48,121,48,349,57,75,-18
48,121,48,355,193,142,51
48,121,48,363,63,68,-5
48,121,48,367,295,564,-269
48,121,48,373,0,78,-78
48,121,48,375,71,0,71
48,121,48,381,140,126,14
48,121,48,397,349,476,-127
48,121,48,423,386,314,72
48,121,48,439,14031,11779,2252
48,121,48,441,174,150,24
48,121,48,451,111,88,23
48,121,48,453,1034,1062,-28
48,121,48,459,52,0,52
48,121,48,467,70,140,-70
48,121,48,485,311,172,139
48,121,48,491,472,530,-58
48,121,48,497,643,1373,-730
48,121,48,499,72,123,-51
48,121,49,35,157,144,13
48,121,49,49,177,104,73
48,121,51,59,190,123,67
48,121,51,107,76,82,-6
48,121,51,810,76,0,76
48,121,53,11,79,63,16
48,121,53,33,412,344,68
48,121,53,53,125,78,47
48,121,53,61,106,121,-15
48,121,55,25,0,69,-69
48,121,55,79,117,0,117
48,121,55,133,72,0,72
48,123,48,29,66,101,-35
48,123,48,201,0,59,-59
48,123,48,285,289,289,0
48,123,48,469,350,334,16
48,127,48,29,87,126,-39
48,127,48,507,119,79,40
48,129,48,381,0,54,-54
48,131,48,29,0,73,-73
48,131,48,249,271,248,23
48,131,48,355,101,79,22
48,133,48,49,0,64,-64
48,133,48,59,0,84,-84
48,133,48,143,95,63,32
48,133,48,367,84,0,84
48,133,48,439,78,52,26
48,133,48,441,97,83,14
48,135,4,13,117,86,31
48,135,6,29,78,0,78
48,135,6,37,87,0,87
48,135,12,57,67,0,67
48,135,12,86,321,0,321
48,135,35,1,74,0,74
48,135,35,13,169,72,97
48,135,35,15,80,0,80
48,135,35,25,258,92,166
48,135,35,45,113,0,113
48,135,40,109,72,0,72
48,135,48,3,170,190,-20
48,135,48,27,84,68,16
48,135,48,29,391,353,38
48,135,48,39,82,0,82
48,135,48,49,56,0,56
48,135,48,85,51,84,-33
48,135,48,103,99,102,-3
48,135,48,113,306,254,52
48,135,48,121,103,98,5
48,135,48,141,1011,572,439
48,135,48,201,439,292,147
48,135,48,215,121,74,47
48,135,48,221,0,73,-73
48,135,48,227,104,88,16
48,135,48,303,265,353,-88
48,135,48,309,0,70,-70
48,135,48,329,2685,2706,-21
48,135,48,339,0,90,-90
48,135,48,355,78,0,78
48,135,48,371,136,71,65
48,135,48,377,340,74,266
48,135,48,389,174,85,89
48,135,48,439,326,310,16
48,135,48,441,99,173,-74
48,135,48,451,190,203,-13
48,135,48,453,141,153,-12
48,135,48,475,175,138,37
48,135,48,491,54,160,-106
48,135,48,495,106,65,41
48,139,6,37,75,0,75
48,139,6,65,115,0,115
48,139,6,73,81,0,81
48,139,48,27,147,104,43
48,139,48,29,127,100,27
48,139,48,41,61,0,61
48,139,48,85,541,352,189
48,139,48,113,7597,3820,3777
48,139,48,121,562,413,149
48,139,48,201,216,183,33
48,139,48,213,98,172,-74
48,139,48,217,126,232,-106
48,139,48,221,0,68,-68
48,139,48,231,0,69,-69
48,139,48,251,569,686,-117
48,139,48,257,284,314,-30
48,139,48,309,132,128,4
48,139,48,339,77,105,-28
48,139,48,349,509,680,-171
48,139,48,367,64,89,-25
48,139,48,397,101,63,38
48,139,48,423,0,74,-74
48,139,48,439,3504,1885,1619
48,139,48,453,105,106,-1
48,139,48,467,68,0,68
48,139,48,491,57,76,-19
48,141,1,31,76,0,76
48,141,1,45,164,106,58
48,141,1,89,0,102,-102
48,141,1,113,0,92,-92
48,141,2,20,87,128,-41
48,141,2,90,293,152,141
48,141,4,3,185,187,-2
48,141,4,13,930,1441,-511
48,141,4,19,247,361,-114
48,141,4,21,68,115,-47
48,141,4,27,115,0,115
48,141,6,1,91,100,-9
48,141,6,13,74,47,27
48,141,6,19,75,92,-17
48,141,6,29,100,0,100
48,141,6,37,1100,780,320
48,141,6,59,222,175,47
48,141,6,65,331,247,84
48,141,6,67,117,104,13
48,141,6,71,490,405,85
48,141,6,73,660,500,160
48,141,6,77,0,77,-77
48,141,6,85,77,91,-14
48,141,6,95,59,0,59
48,141,6,111,63,65,-2
48,141,8,1,382,308,74
48,141,8,5,223,227,-4
48,141,8,13,0,64,-64
48,141,8,31,278,280,-2
48,141,8,41,726,872,-146
48,141,8,59,101,113,-12
48,141,8,69,0,107,-107
48,141,8,123,101,79,22
48,141,11,1,0,82,-82
48,141,12,9,0,70,-70
48,141,12,11,125,148,-23
48,141,12,31,87,83,4
48,141,12,57,121,175,-54
48,141,12,86,173,161,12
48,141,12,91,90,76,14
48,141,12,95,137,140,-3
48,141,12,99,0,62,-62
48,141,12,103,0,94,-94
48,141,13,29,0,102,-102
48,141,13,51,123,164,-41
48,141,13,53,92,81,11
48,141,13,73,134,148,-14
48,141,13,179,344,353,-9
48,141,13,215,274,325,-51
48,141,13,245,140,89,51
48,141,15,3,976,944,32
48,141,17,31,203,188,15
48,141,18,97,66,64,2
48,141,20,61,247,351,-104
48,141,20,103,186,137,49
48,141,20,161,133,70,63
48,141,20,175,162,0,162
48,141,21,47,126,147,-21
48,141,21,93,129,128,1
48,141,22,115,226,163,63
48,141,24,3,112,113,-1
48,141,24,25,109,87,22
48,141,24,31,131,90,41
48,141,24,33,0,70,-70
48,141,25,17,0,68,-68
48,141,26,125,0,110,-110
48,141,26,163,48,0,48
48,141,29,169,182,175,7
48,141,29,189,66,0,66
48,141,31,55,0,65,-65
48,141,32,3,452,453,-1
48,141,32,31,0,78,-78
48,141,35,1,542,498,44
48,141,35,5,0,79,-79
48,141,35,9,0,78,-78
48,141,35,13,2956,3384,-428
48,141,35,15,169,211,-42
48,141,35,25,162,195,-33
48,141,35,27,73,63,10
48,141,35,29,87,60,27
48,141,35,35,444,654,-210
48,141,35,43,71,83,-12
48,141,35,49,70,72,-2
48,141,36,45,263,370,-107
48,141,36,47,85,57,28
48,141,36,61,0,76,-76
48,141,36,71,65,0,65
48,141,36,81,111,57,54
48,141,37,51,506,465,41
48,141,37,85,144,190,-46
48,141,37,93,0,121,-121
48,141,37,119,0,81,-81
48,141,37,133,86,0,86
48,141,37,183,0,108,-108
48,141,39,49,58,61,-3
48,141,40,31,381,385,-4
48,141,40,109,127,182,-55
48,141,40,143,97,114,-17
48,141,41,67,0,86,-86
48,141,45,79,143,232,-89
48,141,47,125,401,463,-62
48,141,47,157,76,0,76
48,141,48,27,715,789,-74
48,141,48,29,1443,2182,-739
48,141,48,39,0,95,-95
48,141,48,41,83,71,12
48,141,48,43,68,0,68
48,141,48,61,112,173,-61
48,141,48,85,250,424,-174
48,141,48,91,64,93,-29
48,141,48,99,218,214,4
48,141,48,113,693,827,-134
48,141,48,121,222,302,-80
48,141,48,135,572,1011,-439
48,141,48,157,95,78,17
48,141,48,167,54,89,-35
48,141,48,187,64,131,-67
48,141,48,201,770,899,-129
48,141,48,209,83,114,-31
48,141,48,215,161,200,-39
48,141,48,229,262,463,-201
48,141,48,303,199,248,-49
48,141,48,309,68,97,-29
48,141,48,329,481,939,-458
48,141,48,339,71,118,-47
48,141,48,355,97,128,-31
48,141,48,371,0,80,-80
48,141,48,375,93,0,93
48,141,48,439,620,932,-312
48,141,48,451,93,77,16
48,141,48,453,659,827,-168
48,141,48,479,77,66,11
48,141,48,485,0,68,-68
48,141,48,491,280,391,-111
48,141,49,35,78,138,-60
48,141,49,49,0,70,-70
48,141,51,13,0,69,-69
48,141,51,41,0,84,-84
48,141,51,59,194,284,-90
48,141,51,107,0,82,-82
48,141,51,149,105,197,-92
48,141,51,153,78,144,-66
48,141,51,700,138,136,2
48,141,51,810,0,71,-71
48,141,53,33,133,200,-67
48,141,53,53,594,655,-61
48,141,53,67,141,262,-121
48,143,48,93,138,211,-73
48,143,48,113,81,78,3
48,143,48,121,0,67,-67
48,143,48,133,63,95,-32
48,143,48,193,163,150,13
48,143,48,201,68,0,68
48,143,48,221,310,283,27
48,143,48,251,95,0,95
48,143,48,309,66,68,-2
48,143,48,363,72,88,-16
48,143,48,367,142,152,-10
48,143,48,439,354,308,46
48,143,48,441,0,87,-87
48,145,48,27,146,159,-13
48,145,48,309,512,462,50
48,147,48,85,876,364,512
48,147,48,113,257,136,121
48,147,48,121,180,99,81
48,147,48,181,639,483,156
48,147,48,231,204,182,22
48,147,48,277,156,184,-28
48,147,48,439,108,117,-9
48,149,48,21,120,127,-7
48,149,48,89,161,103,58
48,149,48,157,60,0,60
48,149,48,201,337,181,156
48,149,48,285,79,87,-8
48,149,48,287,67,59,8
48,149,48,453,85,86,-1
48,149,48,477,0,66,-66
48,151,48,353,75,99,-24
48,153,48,189,113,99,14
48,153,48,303,109,62,47
48,157,2,20,113,0,113
48,157,4,13,354,266,88
48,157,4,19,0,67,-67
48,157,6,1,189,103,86
48,157,6,13,322,180,142
48,157,6,37,540,391,149
48,157,6,59,318,181,137
48,157,6,65,82,80,2
48,157,6,71,117,67,50
48,157,6,73,252,223,29
48,157,6,75,0,55,-55
48,157,6,85,169,148,21
48,157,8,5,103,110,-7
48,157,8,31,0,117,-117
48,157,8,35,0,108,-108
48,157,8,41,0,114,-114
48,157,8,59,68,74,-6
48,157,9,1,101,0,101
48,157,11,1,0,66,-66
48,157,12,11,172,125,47
48,157,12,57,139,76,63
48,157,12,86,295,128,167
48,157,12,95,117,88,29
48,157,12,99,131,90,41
48,157,13,67,86,97,-11
48,157,13,89,0,69,-69
48,157,13,121,122,113,9
48,157,13,135,78,102,-24
48,157,15,3,68,0,68
48,157,17,31,412,238,174
48,157,17,43,128,71,57
48,157,17,197,69,0,69
48,157,22,19,162,109,53
48,157,22,33,235,127,108
48,157,22,51,158,62,96
48,157,22,55,161,75,86
48,157,22,71,143,100,43
48,157,22,103,102,79,23
48,157,24,31,93,0,93
48,157,24,33,107,0,107
48,157,25,17,0,62,-62
48,157,26,125,69,64,5
48,157,27,53,73,75,-2
48,157,29,189,115,0,115
48,157,32,3,151,172,-21
48,157,34,3,82,0,82
48,157,34,13,73,0,73
48,157,34,17,101,0,101
48,157,34,23,156,0,156
48,157,36,5,61,0,61
48,157,36,47,182,77,105
48,157,36,59,123,0,123
48,157,36,61,86,156,-70
48,157,36,81,254,85,169
48,157,36,119,97,0,97
48,157,37,119,95,121,-26
48,157,37,183,80,94,-14
48,157,39,49,116,0,116
48,157,40,109,145,127,18
48,157,40,143,79,144,-65
48,157,40,147,79,0,79
48,157,42,3,58,107,-49
48,157,47,37,0,59,-59
48,157,47,157,67,0,67
48,157,47,187,0,78,-78
48,157,48,15,273,301,-28
48,157,48,27,184,129,55
48,157,48,29,842,790,52
48,157,48,39,2659,3017,-358
48,157,48,41,344,235,109
48,157,48,61,165,95,70
48,157,48,85,387,619,-232
48,157,48,89,104,148,-44
48,157,48,91,90,194,-104
48,157,48,113,588,720,-132
48,157,48,121,267,376,-109
48,157,48,141,78,95,-17
48,157,48,149,0,60,-60
48,157,48,167,598,573,25
48,157,48,187,99,77,22
48,157,48,201,44146,30148,13998
48,157,48,209,129,194,-65
48,157,48,215,226,133,93
48,157,48,245,370,248,122
48,157,48,259,0,79,-79
48,157,48,291,0,101,-101
48,157,48,303,137,57,80
48,157,48,309,113,88,25
48,157,48,321,226,173,53
48,157,48,329,192,195,-3
48,157,48,339,787,1275,-488
48,157,48,355,261,174,87
48,157,48,373,65,70,-5
48,157,48,423,131,83,48
48,157,48,439,509,520,-11
48,157,48,453,777,1155,-378
48,157,48,469,192,106,86
48,157,48,471,108,87,21
48,157,48,473,260,679,-419
48,157,48,477,56,107,-51
48,157,48,479,75,0,75
48,157,48,481,575,624,-49
48,157,48,491,275,446,-171
48,157,51,59,118,115,3
48,157,53,33,168,241,-73
48,159,48,113,70,0,70
48,159,48,223,75,99,-24
48,159,48,449,136,182,-46
48,159,48,499,119,170,-51
48,161,48,1,0,64,-64
48,161,48,113,69,68,1
48,161,48,201,0,73,-73
48,161,48,289,139,72,67
48,161,48,293,215,190,25
48,161,48,309,0,105,-105
48,161,48,349,87,102,-15
48,161,48,439,104,0,104
48,163,48,29,248,297,-49
48,163,48,325,107,158,-51
48,165,35,25,143,82,61
48,165,48,303,72,206,-134
48,165,48,445,69,0,69
48,165,48,501,169,152,17
48,167,4,13,120,120,0
48,167,6,37,149,106,43
48,167,6,59,112,0,112
48,167,6,73,119,100,19
48,167,8,41,0,74,-74
48,167,12,11,61,0,61
48,167,12,86,58,54,4
48,167,17,31,66,0,66
48,167,22,19,104,59,45
48,167,32,3,106,80,26
48,167,40,109,65,64,1
48,167,48,5,75,0,75
48,167,48,27,77,138,-61
48,167,48,29,326,382,-56
48,167,48,39,2640,2549,91
48,167,48,41,128,129,-1
48,167,48,57,0,74,-74
48,167,48,61,135,87,48
48,167,48,71,114,212,-98
48,167,48,85,146,128,18
48,167,48,91,61,140,-79
48,167,48,113,337,278,59
48,167,48,121,149,129,20
48,167,48,141,89,54,35
48,167,48,157,573,598,-25
48,167,48,199,68,0,68
48,167,48,201,13130,10371,2759
48,167,48,209,66,126,-60
48,167,48,215,145,95,50
48,167,48,245,350,230,120
48,167,48,291,119,175,-56
48,167,48,303,67,0,67
48,167,48,309,93,0,93
48,167,48,339,602,709,-107
48,167,48,355,141,78,63
48,167,48,361,92,80,12
48,167,48,373,97,129,-32
48,167,48,423,92,69,23
48,167,48,439,296,254,42
48,167,48,453,345,440,-95
48,167,48,471,87,67,20
48,167,48,491,168,231,-63
48,167,53,33,0,74,-74
48,169,48,303,91,128,-37
48,171,48,29,190,223,-33
48,171,48,113,64,0,64
48,171,48,201,102,0,102
48,171,48,209,0,54,-54
48,171,48,259,84,99,-15
48,171,48,265,303,285,18
48,171,48,453,156,105,51
48,171,48,491,75,0,75
48,175,48,469,243,209,34
48,177,48,29,114,104,10
48,177,48,55,134,127,7
48,177,48,91,0,72,-72
48,177,48,187,121,189,-68
48,177,48,201,81,57,24
48,177,48,285,79,104,-25
48,177,48,453,88,75,13
48,179,48,65,96,89,7
48,179,48,375,91,143,-52
48,179,48,381,97,234,-137
48,181,40,13,450,648,-198
48,181,40,19,0,79,-79
48,181,40,109,0,70,-70
48,181,40,143,73,0,73
48,181,48,85,2898,1416,1482
48,181,48,97,535,477,58
48,181,48,113,910,575,335
48,181,48,121,1275,677,598
48,181,48,147,483,639,-156
48,181,48,201,126,119,7
48,181,48,231,140,120,20
48,181,48,277,122,60,62
48,181,48,329,0,59,-59
48,181,48,439,430,390,40
48,181,48,453,78,62,16
48,181,48,485,71,0,71
48,183,12,105,147,0,147
48,183,22,15,81,78,3
48,183,22,17,140,106,34
48,183,48,29,57,103,-46
48,183,48,37,70,0,70
48,183,48,67,90,0,90
48,183,48,85,122,205,-83
48,183,48,113,455,578,-123
48,183,48,121,135,116,19
48,183,48,201,252,285,-33
48,183,48,203,1623,1626,-3
48,183,48,213,58,0,58
48,183,48,315,115,80,35
48,183,48,339,0,63,-63
48,183,48,343,85,85,0
48,183,48,347,62,0,62
48,183,48,365,142,145,-3
48,183,48,401,1149,1269,-120
48,183,48,423,857,927,-70
48,183,48,439,286,334,-48
48,183,48,449,99,0,99
48,183,48,453,86,98,-12
48,183,48,459,1391,1438,-47
48,183,48,491,0,94,-94
48,183,48,499,142,87,55
48,185,48,41,627,621,6
48,185,48,201,619,331,288
48,185,48,313,0,68,-68
48,185,48,339,527,318,209
48,185,48,471,65,63,2
48,185,48,473,108,61,47
48,187,4,13,80,91,-11
48,187,6,37,115,0,115
48,187,6,59,81,0,81
48,187,6,65,89,0,89
48,187,6,73,104,0,104
48,187,8,41,164,115,49
48,187,15,3,165,0,165
48,187,32,3,98,113,-15
48,187,48,13,81,0,81
48,187,48,27,190,145,45
48,187,48,29,7493,4826,2667
48,187,48,39,0,54,-54
48,187,48,55,297,227,70
48,187,48,85,84,68,16
48,187,48,91,3144,3950,-806
48,187,48,113,120,131,-11
48,187,48,121,76,102,-26
48,187,48,141,131,64,67
48,187,48,157,77,99,-22
48,187,48,177,189,121,68
48,187,48,201,375,335,40
48,187,48,209,1209,942,267
48,187,48,215,106,0,106
48,187,48,259,0,69,-69
48,187,48,303,71,0,71
48,187,48,329,75,77,-2
48,187,48,339,81,85,-4
48,187,48,355,167,114,53
48,187,48,409,69,0,69
48,187,48,439,179,189,-10
48,187,48,451,82,0,82
48,187,48,453,498,425,73
48,187,48,469,68,0,68
48,187,48,491,196,189,7
48,187,48,493,341,388,-47
48,187,53,53,97,72,25
48,189,48,153,99,113,-14
48,189,48,303,585,710,-125
48,189,48,375,0,61,-61
48,189,48,381,72,129,-57
48,189,48,437,93,110,-17
48,193,48,99,111,0,111
48,193,48,143,150,163,-13
48,197,48,487,0,70,-70
48,199,48,5,0,65,-65
48,199,48,167,0,68,-68
48,199,48,201,298,287,11
48,199,48,241,315,329,-14
48,199,48,245,1729,1340,389
48,199,48,291,155,119,36
48,199,48,339,83,116,-33
48,199,48,361,485,335,150
48,199,48,453,0,55,-55
48,199,48,457,223,221,2
48,201,1,3,101,110,-9
48,201,1,73,257,258,-1
48,201,1,81,47,0,47
48,201,1,89,120,136,-16
48,201,1,97,308,248,60
48,201,1,101,76,66,10
48,201,1,117,66,74,-8
48,201,1,125,86,87,-1
48,201,2,20,278,206,72
48,201,2,90,62,62,0
48,201,4,13,1231,1571,-340
48,201,4,15,0,54,-54
48,201,4,19,232,376,-144
48,201,4,21,109,110,-1
48,201,4,25,0,78,-78
48,201,5,7,131,209,-78
48,201,5,31,0,71,-71
48,201,5,45,0,67,-67
48,201,5,51,0,71,-71
48,201,5,69,71,0,71
48,201,5,119,273,220,53
48,201,5,125,0,69,-69
48,201,5,131,62,83,-21
48,201,5,143,83,128,-45
48,201,6,1,477,638,-161
48,201,6,13,921,808,113
48,201,6,19,91,146,-55
48,201,6,29,370,168,202
48,201,6,37,3155,2653,502
48,201,6,53,95,60,35
48,201,6,59,987,889,98
48,201,6,61,75,73,2
48,201,6,65,568,378,190
48,201,6,67,393,380,13
48,201,6,71,701,533,168
48,201,6,73,1425,1351,74
48,201,6,75,317,385,-68
48,201,6,77,117,105,12
48,201,6,81,238,223,15
48,201,6,83,83,113,-30
48,201,6,85,782,826,-44
48,201,6,95,135,131,4
48,201,6,97,85,60,25
48,201,6,99,84,95,-11
48,201,6,111,187,159,28
48,201,8,1,238,292,-54
48,201,8,5,512,544,-32
48,201,8,13,84,241,-157
48,201,8,14,0,122,-122
48,201,8,31,528,1142,-614
48,201,8,35,192,295,-103
48,201,8,41,446,717,-271
48,201,8,59,250,515,-265
48,201,8,67,0,53,-53
48,201,8,69,130,254,-124
48,201,8,77,59,0,59
48,201,8,117,0,51,-51
48,201,8,123,87,105,-18
48,201,9,1,361,206,155
48,201,9,3,174,177,-3
48,201,9,9,192,144,48
48,201,10,3,142,135,7
48,201,11,1,338,413,-75
48,201,12,1,113,65,48
48,201,12,5,142,96,46
48,201,12,9,180,174,6
48,201,12,11,985,736,249
48,201,12,19,84,99,-15
48,201,12,21,132,169,-37
48,201,12,31,442,372,70
48,201,12,33,215,200,15
48,201,12,57,657,779,-122
48,201,12,69,59,82,-23
48,201,12,71,230,249,-19
48,201,12,73,148,95,53
48,201,12,81,90,155,-65
48,201,12,83,91,101,-10
48,201,12,86,2461,1397,1064
48,201,12,91,92,111,-19
48,201,12,95,689,617,72
48,201,12,97,134,179,-45
48,201,12,99,550,457,93
48,201,12,101,144,150,-6
48,201,12,103,240,340,-100
48,201,12,105,155,230,-75
48,201,12,109,0,90,-90
48,201,12,111,130,98,32
48,201,12,113,0,82,-82
48,201,12,115,98,110,-12
48,201,12,117,177,203,-26
48,201,12,127,95,163,-68
48,201,12,131,0,60,-60
48,201,13,21,0,67,-67
48,201,13,51,103,129,-26
48,201,13,57,65,94,-29
48,201,13,63,130,120,10
48,201,13,67,402,467,-65
48,201,13,89,435,431,4
48,201,13,113,67,0,67
48,201,13,117,73,115,-42
48,201,13,121,613,879,-266
48,201,13,135,418,445,-27
48,201,13,139,0,99,-99
48,201,13,151,71,84,-13
48,201,13,179,0,77,-77
48,201,13,215,85,77,8
48,201,13,245,97,105,-8
48,201,15,1,59,0,59
48,201,15,3,490,316,174
48,201,15,9,0,66,-66
48,201,16,1,101,167,-66
48,201,17,19,97,0,97
48,201,17,31,2330,1812,518
48,201,17,43,313,300,13
48,201,17,89,144,134,10
48,201,17,97,239,208,31
48,201,17,111,54,0,54
48,201,17,119,70,0,70
48,201,17,143,89,72,17
48,201,17,163,73,85,-12
48,201,17,167,69,0,69
48,201,17,197,281,193,88
48,201,17,201,133,59,74
48,201,18,3,0,102,-102
48,201,18,57,102,135,-33
48,201,18,63,60,0,60
48,201,18,89,184,134,50
48,201,18,97,341,364,-23
48,201,18,141,0,77,-77
48,201,18,157,109,0,109
48,201,19,103,85,0,85
48,201,19,113,0,48,-48
48,201,19,153,124,186,-62
48,201,20,45,67,0,67
48,201,20,57,52,0,52
48,201,20,61,0,71,-71
48,201,20,91,280,256,24
48,201,20,161,61,0,61
48,201,20,173,240,182,58
48,201,20,209,60,75,-15
48,201,21,47,0,58,-58
48,201,21,67,121,62,59
48,201,21,111,245,310,-65
48,201,22,1,111,74,37
48,201,22,5,177,256,-79
48,201,22,15,220,181,39
48,201,22,17,427,332,95
48,201,22,19,826,807,19
48,201,22,33,1410,742,668
48,201,22,39,66,0,66
48,201,22,45,203,117,86
48,201,22,51,1033,707,326
48,201,22,53,0,80,-80
48,201,22,55,1162,556,606
48,201,22,57,139,64,75
48,201,22,61,105,0,105
48,201,22,63,112,110,2
48,201,22,69,132,73,59
48,201,22,71,1245,921,324
48,201,22,73,306,177,129
48,201,22,79,399,196,203
48,201,22,87,72,0,72
48,201,22,89,58,0,58
48,201,22,95,75,70,5
48,201,22,97,246,161,85
48,201,22,99,148,72,76
48,201,22,101,171,77,94
48,201,22,103,375,370,5
48,201,22,105,242,123,119
48,201,22,109,266,111,155
48,201,22,113,91,0,91
48,201,22,115,169,94,75
48,201,23,5,66,0,66
48,201,24,3,191,140,51
48,201,24,5,186,158,28
48,201,24,27,79,148,-69
48,201,24,31,437,486,-49
48,201,24,33,323,299,24
48,201,24,510,229,141,88
48,201,25,5,59,0,59
48,201,25,9,138,89,49
48,201,25,13,0,64,-64
48,201,25,17,482,474,8
48,201,25,21,136,158,-22
48,201,25,23,63,0,63
48,201,25,25,284,357,-73
48,201,25,27,150,112,38
48,201,26,49,89,107,-18
48,201,26,65,102,55,47
48,201,26,77,0,59,-59
48,201,26,81,144,137,7
48,201,26,99,175,128,47
48,201,26,125,314,356,-42
48,201,26,139,0,65,-65
48,201,26,161,147,97,50
48,201,26,163,387,368,19
48,201,27,3,67,0,67
48,201,27,37,0,79,-79
48,201,27,53,458,412,46
48,201,27,109,0,59,-59
48,201,27,123,136,145,-9
48,201,27,163,65,0,65
48,201,28,1,58,0,58
48,201,28,33,70,68,2
48,201,28,35,82,0,82
48,201,28,47,244,166,78
48,201,28,49,306,100,206
48,201,28,59,175,135,40
48,201,28,75,63,0,63
48,201,28,89,116,76,40
48,201,28,121,56,69,-13
48,201,29,19,75,74,1
48,201,29,47,78,103,-25
48,201,29,77,105,112,-7
48,201,29,95,355,355,0
48,201,29,183,158,129,29
48,201,29,189,473,363,110
48,201,29,510,247,145,102
48,201,30,31,0,65,-65
48,201,30,111,87,0,87
48,201,31,55,304,198,106
48,201,31,109,90,68,22
48,201,31,153,58,75,-17
48,201,32,3,1002,1080,-78
48,201,32,31,165,209,-44
48,201,33,11,73,75,-2
48,201,34,3,200,120,80
48,201,34,5,62,71,-9
48,201,34,7,87,77,10
48,201,34,13,292,139,153
48,201,34,17,373,311,62
48,201,34,21,98,114,-16
48,201,34,23,296,238,58
48,201,34,25,109,84,25
48,201,34,27,143,99,44
48,201,34,31,109,0,109
48,201,34,35,141,74,67
48,201,34,39,200,128,72
48,201,35,1,330,329,1
48,201,35,13,137,111,26
48,201,35,15,0,91,-91
48,201,35,25,61,49,12
48,201,35,43,0,75,-75
48,201,35,49,0,111,-111
48,201,36,5,528,233,295
48,201,36,29,179,161,18
48,201,36,45,92,0,92
48,201,36,47,787,628,159
48,201,36,55,178,142,36
48,201,36,59,358,154,204
48,201,36,61,1011,1127,-116
48,201,36,67,87,75,12
48,201,36,71,95,69,26
48,201,36,81,768,417,351
48,201,36,85,64,0,64
48,201,36,103,399,214,185
48,201,36,119,312,177,135
48,201,37,21,0,130,-130
48,201,37,25,0,78,-78
48,201,37,51,222,198,24
48,201,37,63,148,168,-20
48,201,37,67,91,77,14
48,201,37,81,128,166,-38
48,201,37,119,444,610,-166
48,201,37,133,152,145,7
48,201,37,135,0,83,-83
48,201,37,183,311,431,-120
48,201,38,101,83,0,83
48,201,38,105,0,81,-81
48,201,39,17,72,63,9
48,201,39,35,327,288,39
48,201,39,49,449,549,-100
48,201,39,61,213,376,-163
48,201,39,95,93,102,-9
48,201,39,113,93,113,-20
48,201,39,153,92,158,-66
48,201,40,17,71,94,-23
48,201,40,27,215,194,21
48,201,40,31,103,0,103
48,201,40,109,761,701,60
48,201,40,119,70,0,70
48,201,40,143,718,561,157
48,201,40,147,152,0,152
48,201,41,5,71,84,-13
48,201,41,39,0,87,-87
48,201,41,51,236,311,-75
48,201,41,67,130,226,-96
48,201,42,3,403,602,-199
48,201,42,7,0,118,-118
48,201,42,11,88,0,88
48,201,42,17,86,81,5
48,201,42,19,0,109,-109
48,201,42,27,0,48,-48
48,201,42,29,108,85,23
48,201,42,43,71,73,-2
48,201,42,45,73,105,-32
48,201,42,71,82,79,3
48,201,42,77,123,0,123
48,201,42,91,146,176,-30
48,201,42,95,85,0,85
48,201,42,101,406,350,56
48,201,44,7,125,136,-11
48,201,45,13,0,65,-65
48,201,45,15,84,63,21
48,201,45,19,174,162,12
48,201,45,45,138,241,-103
48,201,45,63,0,64,-64
48,201,45,79,169,87,82
48,201,45,91,57,80,-23
48,201,46,99,61,0,61
48,201,47,37,370,526,-156
48,201,47,65,96,146,-50
48,201,47,93,116,187,-71
48,201,47,125,74,72,2
48,201,47,149,86,106,-20
48,201,47,157,694,525,169
48,201,47,165,0,59,-59
48,201,47,187,108,178,-70
48,201,48,1,151,183,-32
48,201,48,5,675,499,176
48,201,48,7,139,146,-7
48,201,48,13,0,93,-93
48,201,48,15,560,803,-243
48,201,48,19,0,81,-81
48,201,48,21,183,296,-113
48,201,48,25,101,0,101
48,201,48,27,1145,1245,-100
48,201,48,29,4641,4896,-255
48,201,48,37,106,100,6
48,201,48,39,9842,14496,-4654
48,201,48,41,2107,1756,351
48,201,48,51,75,172,-97
48,201,48,53,111,213,-102
48,201,48,55,0,93,-93
48,201,48,57,145,129,16
48,201,48,61,1517,1236,281
48,201,48,71,1868,3033,-1165
48,201,48,73,97,138,-41
48,201,48,85,1455,2131,-676
48,201,48,89,256,320,-64
48,201,48,91,425,1030,-605
48,201,48,99,199,167,32
48,201,48,113,4809,5911,-1102
48,201,48,121,1144,1655,-511
48,201,48,123,59,0,59
48,201,48,135,292,439,-147
48,201,48,139,183,216,-33
48,201,48,141,899,770,129
48,201,48,143,0,68,-68
48,201,48,149,181,337,-156
48,201,48,157,30148,44146,-13998
48,201,48,161,73,0,73
48,201,48,167,10371,13130,-2759
48,201,48,171,0,102,-102
48,201,48,177,57,81,-24
48,201,48,181,119,126,-7
48,201,48,183,285,252,33
48,201,48,185,331,619,-288
48,201,48,187,335,375,-40
48,201,48,199,287,298,-11
48,201,48,203,152,144,8
48,201,48,209,688,977,-289
48,201,48,213,73,121,-48
48,201,48,215,2109,1616,493
48,201,48,221,53,96,-43
48,201,48,225,147,245,-98
48,201,48,227,0,64,-64
48,201,48,231,82,97,-15
48,201,48,239,102,82,20
48,201,48,241,209,149,60
48,201,48,245,3509,2197,1312
48,201,48,249,70,111,-41
48,201,48,251,164,154,10
48,201,48,257,150,127,23
48,201,48,259,81,231,-150
48,201,48,265,149,251,-102
48,201,48,273,149,78,71
48,201,48,285,91,152,-61
48,201,48,287,89,98,-9
48,201,48,289,127,212,-85
48,201,48,291,2409,5360,-2951
48,201,48,293,0,87,-87
48,201,48,299,0,138,-138
48,201,48,303,557,489,68
48,201,48,309,527,588,-61
48,201,48,313,66,106,-40
48,201,48,321,371,408,-37
48,201,48,323,94,116,-22
48,201,48,325,56,79,-23
48,201,48,329,794,1167,-373
48,201,48,331,85,102,-17
48,201,48,339,19178,31147,-11969
48,201,48,347,401,353,48
48,201,48,349,92,105,-13
48,201,48,355,1531,1199,332
48,201,48,361,467,387,80
48,201,48,367,97,225,-128
48,201,48,373,618,1195,-577
48,201,48,375,108,92,16
48,201,48,381,131,93,38
48,201,48,395,65,110,-45
48,201,48,397,107,198,-91
48,201,48,401,89,110,-21
48,201,48,403,0,71,-71
48,201,48,407,482,812,-330
48,201,48,409,335,313,22
48,201,48,419,62,119,-57
48,201,48,423,511,563,-52
48,201,48,427,195,153,42
48,201,48,439,3363,3702,-339
48,201,48,441,193,171,22
48,201,48,451,198,140,58
48,201,48,453,5143,6962,-1819
48,201,48,455,121,212,-91
48,201,48,457,133,198,-65
48,201,48,459,0,79,-79
48,201,48,465,72,64,8
48,201,48,469,528,361,167
48,201,48,471,1116,1019,97
48,201,48,473,2364,3787,-1423
48,201,48,477,418,706,-288
48,201,48,479,510,371,139
48,201,48,481,438,374,64
48,201,48,485,155,136,19
48,201,48,491,1324,2270,-946
48,201,48,493,68,0,68
48,201,48,499,0,80,-80
48,201,49,11,0,104,-104
48,201,49,35,353,435,-82
48,201,49,49,241,272,-31
48,201,51,13,165,177,-12
48,201,51,41,81,95,-14
48,201,51,59,481,550,-69
48,201,51,87,107,81,26
48,201,51,107,170,226,-56
48,201,51,153,233,177,56
48,201,51,179,62,0,62
48,201,51,510,91,124,-33
48,201,51,550,98,70,28
48,201,51,650,63,52,11
48,201,51,700,83,83,0
48,201,51,710,166,109,57
48,201,51,760,57,73,-16
48,201,51,810,176,205,-29
48,201,53,5,71,0,71
48,201,53,11,78,173,-95
48,201,53,29,0,46,-46
48,201,53,33,931,1536,-605
48,201,53,35,77,155,-78
48,201,53,53,296,271,25
48,201,53,61,230,246,-16
48,201,53,63,52,100,-48
48,201,53,67,69,85,-16
48,201,53,73,0,68,-68
48,201,54,61,63,0,63
48,201,55,25,182,144,38
48,201,55,79,359,289,70
48,201,55,133,85,72,13
48,203,22,15,88,0,88
48,203,22,17,206,236,-30
48,203,48,113,209,240,-31
48,203,48,121,70,52,18
48,203,48,183,1626,1623,3
48,203,48,201,144,152,-8
48,203,48,315,231,128,103
48,203,48,365,162,176,-14
48,203,48,401,171,162,9
48,203,48,423,145,272,-127
48,203,48,439,131,163,-32
48,203,48,459,259,220,39
48,205,48,111,253,198,55
48,207,48,253,82,64,18
48,207,48,441,0,75,-75
48,209,4,13,105,152,-47
48,209,6,1,70,0,70
48,209,6,37,181,72,109
48,209,6,59,112,0,112
48,209,6,65,89,0,89
48,209,6,71,55,0,55
48,209,6,73,125,65,60
48,209,6,85,84,0,84
48,209,8,41,0,87,-87
48,209,17,31,102,50,52
48,209,32,3,79,0,79
48,209,48,21,358,448,-90
48,209,48,27,242,258,-16
48,209,48,29,1088,1241,-153
48,209,48,31,71,181,-110
48,209,48,39,104,79,25
48,209,48,41,182,110,72
48,209,48,53,80,130,-50
48,209,48,55,1097,1061,36
48,209,48,61,179,70,109
48,209,48,85,176,157,19
48,209,48,91,779,1427,-648
48,209,48,113,318,261,57
48,209,48,121,169,171,-2
48,209,48,141,114,83,31
48,209,48,157,194,129,65
48,209,48,167,126,66,60
48,209,48,171,54,0,54
48,209,48,187,942,1209,-267
48,209,48,201,977,688,289
48,209,48,215,138,160,-22
48,209,48,245,55,0,55
48,209,48,251,56,0,56
48,209,48,299,0,58,-58
48,209,48,303,103,61,42
48,209,48,309,98,99,-1
48,209,48,329,80,0,80
48,209,48,339,184,125,59
48,209,48,355,193,174,19
48,209,48,439,307,289,18
48,209,48,441,63,0,63
48,209,48,451,0,58,-58
48,209,48,453,11372,6275,5097
48,209,48,469,69,0,69
48,209,48,479,98,56,42
48,209,48,491,1084,1312,-228
48,209,53,33,77,0,77
48,213,48,1,330,255,75
48,213,48,29,58,0,58
48,213,48,73,115,115,0
48,213,48,85,200,148,52
48,213,48,113,1023,526,497
48,213,48,121,179,111,68
48,213,48,139,172,98,74
48,213,48,183,0,58,-58
48,213,48,201,121,73,48
48,213,48,251,54,0,54
48,213,48,257,1105,883,222
48,213,48,349,129,127,2
48,213,48,423,969,1053,-84
48,213,48,439,422,293,129
48,213,48,453,55,0,55
48,213,48,467,344,422,-78
48,213,48,491,70,0,70
48,215,4,13,109,90,19
48,215,4,19,0,73,-73
48,215,6,37,152,130,22
48,215,6,73,150,144,6
48,215,8,41,0,77,-77
48,215,12,86,122,86,36
48,215,12,99,64,0,64
48,215,17,31,140,130,10
48,215,22,19,0,78,-78
48,215,32,3,76,64,12
48,215,48,25,58,57,1
48,215,48,27,162,145,17
48,215,48,29,1337,2400,-1063
48,215,48,39,217,367,-150
48,215,48,41,87,107,-20
48,215,48,61,2603,2201,402
48,215,48,85,78,146,-68
48,215,48,91,0,146,-146
48,215,48,113,492,581,-89
48,215,48,121,97,130,-33
48,215,48,135,74,121,-47
48,215,48,141,200,161,39
48,215,48,157,133,226,-93
48,215,48,167,95,145,-50
48,215,48,187,0,106,-106
48,215,48,201,1616,2109,-493
48,215,48,209,160,138,22
48,215,48,245,106,155,-49
48,215,48,273,98,92,6
48,215,48,303,81,68,13
48,215,48,329,0,95,-95
48,215,48,339,103,160,-57
48,215,48,355,460,553,-93
48,215,48,409,99,108,-9
48,215,48,427,1139,705,434
48,215,48,439,309,425,-116
48,215,48,453,563,991,-428
48,215,48,469,72,78,-6
48,215,48,479,489,332,157
48,215,48,489,202,193,9
48,215,48,491,148,326,-178
48,217,48,35,103,114,-11
48,217,48,113,254,112,142
48,217,48,121,95,0,95
48,217,48,139,232,126,106
48,217,48,251,560,362,198
48,217,48,309,539,547,-8
48,217,48,349,70,98,-28
48,217,48,439,426,263,163
48,219,48,79,71,0,71
48,219,48,279,0,85,-85
48,219,48,303,702,838,-136
48,219,48,445,58,0,58
48,221,4,13,0,59,-59
48,221,48,29,78,61,17
48,221,48,85,145,0,145
48,221,48,113,332,143,189
48,221,48,121,258,118,140
48,221,48,135,73,0,73
48,221,48,139,68,0,68
48,221,48,143,283,310,-27
48,221,48,201,96,53,43
48,221,48,251,503,331,172
48,221,48,329,138,0,138
48,221,48,363,91,90,1
48,221,48,367,695,471,224
48,221,48,425,166,215,-49
48,221,48,439,1945,1100,845
48,221,48,453,0,50,-50
48,223,48,85,139,94,45
48,223,48,113,271,146,125
48,223,48,119,81,0,81
48,223,48,121,69,0,69
48,223,48,159,99,75,24
48,223,48,231,380,327,53
48,223,48,277,70,95,-25
48,223,48,379,116,101,15
48,223,48,397,0,58,-58
48,223,48,423,0,79,-79
48,223,48,439,103,76,27
48,223,48,499,293,338,-45
48,225,48,1,117,123,-6
48,225,48,5,91,81,10
48,225,48,201,245,147,98
48,225,48,339,112,0,112
48,225,48,455,56,72,-16
48,225,48,471,89,76,13
48,227,48,135,88,104,-16
48,227,48,201,64,0,64
48,227,48,303,101,142,-41
48,227,48,329,272,230,42
48,227,48,439,77,93,-16
48,227,48,441,69,65,4
48,227,48,451,112,95,17
48,229,48,141,463,262,201
48,231,48,85,1518,934,584
48,231,48,113,2379,1225,1154
48,231,48,119,57,117,-60
48,231,48,121,303,208,95
48,231,48,139,69,0,69
48,231,48,147,182,204,-22
48,231,48,181,120,140,-20
48,231,48,201,97,82,15
48,231,48,223,327,380,-53
48,231,48,257,482,369,113
48,231,48,277,102,67,35
48,231,48,379,169,286,-117
48,231,48,397,1502,818,684
48,231,48,423,67,75,-8
48,231,48,439,447,272,175
48,231,48,467,182,231,-49
48,231,48,499,75,81,-6
48,233,48,65,91,118,-27
48,233,48,341,84,0,84
48,233,48,375,129,129,0
48,233,48,381,154,245,-91
48,235,48,451,83,67,16
48,237,48,363,0,62,-62
48,237,48,367,111,92,19
48,237,48,439,78,67,11
48,237,48,497,82,0,82
48,237,48,503,0,85,-85
48,239,48,57,96,84,12
48,239,48,201,82,102,-20
48,239,48,321,91,0,91
48,239,48,469,272,344,-72
48,241,48,5,83,94,-11
48,241,48,199,329,315,14
48,241,48,201,149,209,-60
48,241,48,245,298,235,63
48,241,48,351,310,295,15
48,241,48,361,386,245,141
48,241,48,403,104,134,-30
48,241,48,457,107,108,-1
48,245,4,13,0,70,-70
48,245,6,37,95,97,-2
48,245,22,19,213,302,-89
48,245,22,33,112,81,31
48,245,22,51,74,0,74
48,245,22,55,68,0,68
48,245,48,5,78,64,14
48,245,48,27,0,117,-117
48,245,48,29,127,250,-123
48,245,48,39,190,256,-66
48,245,48,41,0,109,-109
48,245,48,71,280,278,2
48,245,48,85,0,76,-76
48,245,48,113,169,345,-176
48,245,48,121,0,83,-83
48,245,48,157,248,370,-122
48,245,48,167,230,350,-120
48,245,48,199,1340,1729,-389
48,245,48,201,2197,3509,-1312
48,245,48,209,0,55,-55
48,245,48,215,155,106,49
48,245,48,241,235,298,-63
48,245,48,291,88,121,-33
48,245,48,339,219,463,-244
48,245,48,351,66,86,-20
48,245,48,355,100,70,30
48,245,48,361,1792,1735,57
48,245,48,403,0,58,-58
48,245,48,423,0,93,-93
48,245,48,439,109,379,-270
48,245,48,453,180,379,-199
48,245,48,457,111,141,-30
48,245,48,491,60,175,-115
48,249,48,29,155,355,-200
48,249,48,47,149,99,50
48,249,48,131,248,271,-23
48,249,48,201,111,70,41
48,249,48,273,112,128,-16
48,249,48,297,0,63,-63
48,249,48,355,663,752,-89
48,249,48,409,158,141,17
48,251,4,13,66,0,66
48,251,6,37,68,0,68
48,251,6,73,83,0,83
48,251,48,27,87,72,15
48,251,48,29,141,87,54
48,251,48,35,98,196,-98
48,251,48,85,174,171,3
48,251,48,113,1362,661,701
48,251,48,121,298,349,-51
48,251,48,139,686,569,117
48,251,48,143,0,95,-95
48,251,48,201,154,164,-10
48,251,48,209,0,56,-56
48,251,48,213,0,54,-54
48,251,48,217,362,560,-198
48,251,48,221,331,503,-172
48,251,48,303,61,0,61
48,251,48,309,187,130,57
48,251,48,329,0,114,-114
48,251,48,339,77,0,77
48,251,48,367,298,472,-174
48,251,48,425,69,143,-74
48,251,48,439,10291,6084,4207
48,251,48,441,82,0,82
48,251,48,453,87,87,0
48,251,48,491,0,58,-58
48,251,48,497,82,77,5
48,253,48,207,64,82,-18
48,253,48,441,714,766,-52
48,255,48,25,68,118,-50
48,255,48,29,112,167,-55
48,255,48,493,76,117,-41
48,257,4,13,64,0,64
48,257,6,37,75,0,75
48,257,32,3,75,0,75
48,257,48,27,92,0,92
48,257,48,29,85,77,8
48,257,48,85,1013,659,354
48,257,48,113,10502,3702,6800
48,257,48,121,680,315,365
48,257,48,139,314,284,30
48,257,48,201,127,150,-23
48,257,48,213,883,1105,-222
48,257,48,231,369,482,-113
48,257,48,309,63,0,63
48,257,48,349,0,95,-95
48,257,48,379,0,71,-71
48,257,48,397,784,775,9
48,257,48,423,174,193,-19
48,257,48,439,811,540,271
48,257,48,453,103,59,44
48,257,48,467,497,900,-403
48,257,48,491,0,76,-76
48,257,48,499,0,65,-65
48,259,48,19,117,120,-3
48,259,48,29,2783,1696,1087
48,259,48,85,69,0,69
48,259,48,91,178,282,-104
48,259,48,113,96,52,44
48,259,48,157,79,0,79
48,259,48,171,99,84,15
48,259,48,187,69,0,69
48,259,48,201,231,81,150
48,259,48,265,258,245,13
48,259,48,355,93,0,93
48,259,48,453,131,116,15
48,259,48,491,0,63,-63
48,265,48,19,150,173,-23
48,265,48,29,509,536,-27
48,265,48,113,61,52,9
48,265,48,171,285,303,-18
48,265,48,201,251,149,102
48,265,48,259,245,258,-13
48,265,48,267,58,0,58
48,265,48,329,75,0,75
48,265,48,339,64,0,64
48,265,48,355,67,0,67
48,265,48,439,0,76,-76
48,265,48,451,73,0,73
48,265,48,453,149,176,-27
48,265,48,491,71,86,-15
48,267,48,265,0,58,-58
48,273,6,73,0,74,-74
48,273,48,29,129,218,-89
48,273,48,47,59,0,59
48,273,48,61,81,89,-8
48,273,48,201,78,149,-71
48,273,48,215,92,98,-6
48,273,48,249,128,112,16
48,273,48,355,591,591,0
48,273,48,453,0,51,-51
48,277,40,23,93,98,-5
48,277,48,85,101,82,19
48,277,48,113,198,215,-17
48,277,48,119,89,0,89
48,277,48,121,109,88,21
48,277,48,147,184,156,28
48,277,48,181,60,122,-62
48,277,48,223,95,70,25
48,277,48,231,67,102,-35
48,277,48,387,331,245,86
48,277,48,423,56,0,56
48,277,48,439,131,113,18
48,277,48,449,72,0,72
48,279,48,219,85,0,85
48,279,48,303,210,358,-148
48,281,48,27,445,344,101
48,281,48,53,163,124,39
48,281,48,99,383,412,-29
48,281,48,453,87,82,5
48,281,48,491,220,119,101
48,283,48,29,72,64,8
48,285,48,123,289,289,0
48,285,48,149,87,79,8
48,285,48,177,104,79,25
48,285,48,201,152,91,61
48,285,48,469,115,113,2
48,287,48,21,236,154,82
48,287,48,41,0,100,-100
48,287,48,149,59,67,-8
48,287,48,201,98,89,9
48,287,48,453,164,173,-9
48,287,48,477,0,62,-62
48,287,48,491,174,120,54
48,289,48,1,87,0,87
48,289,48,41,103,121,-18
48,289,48,161,72,139,-67
48,289,48,201,212,127,85
48,289,48,313,106,96,10
48,289,48,339,137,0,137
48,291,48,39,100,70,30
48,291,48,71,455,336,119
48,291,48,157,101,0,101
48,291,48,167,175,119,56
48,291,48,199,119,155,-36
48,291,48,201,5360,2409,2951
48,291,48,245,121,88,33
48,291,48,339,1330,1161,169
48,291,48,373,136,195,-59
48,291,48,407,509,354,155
48,293,48,113,61,57,4
48,293,48,161,190,215,-25
48,293,48,201,87,0,87
48,293,48,309,305,301,4
48,297,48,25,84,111,-27
48,297,48,249,63,0,63
48,297,48,355,141,142,-1
48,297,48,409,70,0,70
48,299,48,29,67,69,-2
48,299,48,53,650,544,106
48,299,48,201,138,0,138
48,299,48,209,58,0,58
48,299,48,453,239,152,87
48,299,48,491,185,125,60
48,303,4,13,187,126,61
48,303,6,37,128,76,52
48,303,6,73,96,94,2
48,303,8,31,0,65,-65
48,303,8,41,105,94,11
48,303,32,3,0,76,-76
48,303,35,1,94,114,-20
48,303,35,5,80,0,80
48,303,35,9,230,138,92
48,303,35,15,116,98,18
48,303,35,25,243,214,29
48,303,35,41,80,0,80
48,303,40,109,108,100,8
48,303,40,143,68,69,-1
48,303,48,3,0,68,-68
48,303,48,17,82,0,82
48,303,48,27,153,124,29
48,303,48,29,400,614,-214
48,303,48,39,0,65,-65
48,303,48,41,92,79,13
48,303,48,79,55,0,55
48,303,48,85,266,473,-207
48,303,48,91,63,118,-55
48,303,48,107,264,252,12
48,303,48,113,582,824,-242
48,303,48,115,224,99,125
48,303,48,121,244,406,-162
48,303,48,135,353,265,88
48,303,48,141,248,199,49
48,303,48,153,62,109,-47
48,303,48,157,57,137,-80
48,303,48,165,206,72,134
48,303,48,167,0,67,-67
48,303,48,169,128,91,37
48,303,48,187,0,71,-71
48,303,48,189,710,585,125
48,303,48,201,489,557,-68
48,303,48,209,61,103,-42
48,303,48,215,68,81,-13
48,303,48,219,838,702,136
48,303,48,227,142,101,41
48,303,48,251,0,61,-61
48,303,48,279,358,210,148
48,303,48,305,272,374,-102
48,303,48,309,109,149,-40
48,303,48,329,596,514,82
48,303,48,339,94,150,-56
48,303,48,341,64,0,64
48,303,48,355,98,81,17
48,303,48,367,67,113,-46
48,303,48,375,316,195,121
48,303,48,381,524,410,114
48,303,48,415,121,0,121
48,303,48,423,84,69,15
48,303,48,439,640,968,-328
48,303,48,441,281,250,31
48,303,48,445,303,240,63
48,303,48,451,166,183,-17
48,303,48,453,301,509,-208
48,303,48,485,106,102,4
48,303,48,491,248,282,-34
48,303,48,501,111,0,111
48,303,49,49,72,0,72
48,303,53,33,0,57,-57
48,305,48,303,374,272,102
48,307,48,451,71,78,-7
48,309,4,13,106,89,17
48,309,6,37,155,114,41
48,309,6,59,95,0,95
48,309,6,65,152,0,152
48,309,6,71,81,0,81
48,309,6,73,189,0,189
48,309,17,31,65,0,65
48,309,32,3,75,59,16
48,309,40,109,0,56,-56
48,309,48,27,1033,1201,-168
48,309,48,29,307,353,-46
48,309,48,35,433,426,7
48,309,48,41,196,200,-4
48,309,48,85,198,256,-58
48,309,48,91,53,67,-14
48,309,48,99,331,318,13
48,309,48,113,674,816,-142
48,309,48,121,231,240,-9
48,309,48,135,70,0,70
48,309,48,139,128,132,-4
48,309,48,141,97,68,29
48,309,48,143,68,66,2
48,309,48,145,462,512,-50
48,309,48,157,88,113,-25
48,309,48,161,105,0,105
48,309,48,167,0,93,-93
48,309,48,201,588,527,61
48,309,48,209,99,98,1
48,309,48,217,547,539,8
48,309,48,251,130,187,-57
48,309,48,257,0,63,-63
48,309,48,293,301,305,-4
48,309,48,303,149,109,40
48,309,48,329,59,69,-10
48,309,48,339,119,81,38
48,309,48,349,130,77,53
48,309,48,355,95,92,3
48,309,48,395,63,0,63
48,309,48,423,84,122,-38
48,309,48,439,750,754,-4
48,309,48,441,65,78,-13
48,309,48,453,485,616,-131
48,309,48,491,310,367,-57
48,313,48,41,111,163,-52
48,313,48,185,68,0,68
48,313,48,201,106,66,40
48,313,48,289,96,106,-10
48,313,48,339,65,0,65
48,313,48,471,79,103,-24
48,315,22,17,65,0,65
48,315,48,67,78,0,78
48,315,48,183,80,115,-35
48,315,48,203,128,231,-103
48,315,48,459,0,91,-91
48,317,48,329,195,196,-1
48,321,48,39,346,528,-182
48,321,48,157,173,226,-53
48,321,48,201,408,371,37
48,321,48,239,0,91,-91
48,321,48,469,0,89,-89
48,321,48,481,192,203,-11
48,323,48,29,531,837,-306
48,323,48,201,116,94,22
48,323,48,439,0,75,-75
48,323,48,453,52,100,-48
48,323,48,463,69,0,69
48,323,48,465,129,148,-19
48,323,48,479,0,104,-104
48,325,48,13,262,219,43
48,325,48,29,2396,1704,692
48,325,48,91,0,62,-62
48,325,48,163,158,107,51
48,325,48,201,79,56,23
48,325,48,453,55,0,55
48,325,48,463,84,58,26
48,329,4,13,137,116,21
48,329,6,29,270,0,270
48,329,6,37,92,64,28
48,329,6,73,60,53,7
48,329,8,31,0,74,-74
48,329,12,57,65,0,65
48,329,12,86,159,0,159
48,329,22,55,93,0,93
48,329,32,3,108,89,19
48,329,35,1,68,0,68
48,329,35,13,166,0,166
48,329,35,15,124,79,45
48,329,35,25,184,107,77
48,329,35,45,158,0,158
48,329,38,105,81,0,81
48,329,40,109,123,80,43
48,329,40,143,89,0,89
48,329,48,3,145,203,-58
48,329,48,27,99,117,-18
48,329,48,29,454,534,-80
48,329,48,39,63,0,63
48,329,48,41,60,0,60
48,329,48,43,65,0,65
48,329,48,49,0,64,-64
48,329,48,53,0,61,-61
48,329,48,85,162,210,-48
48,329,48,91,0,85,-85
48,329,48,113,423,403,20
48,329,48,115,114,94,20
48,329,48,121,204,317,-113
48,329,48,135,2706,2685,21
48,329,48,141,939,481,458
48,329,48,157,195,192,3
48,329,48,181,59,0,59
48,329,48,187,77,75,2
48,329,48,201,1167,794,373
48,329,48,209,0,80,-80
48,329,48,215,95,0,95
48,329,48,221,0,138,-138
48,329,48,227,230,272,-42
48,329,48,251,114,0,114
48,329,48,265,0,75,-75
48,329,48,303,514,596,-82
48,329,48,309,69,59,10
48,329,48,317,196,195,1
48,329,48,339,341,262,79
48,329,48,355,133,79,54
48,329,48,367,79,102,-23
48,329,48,371,103,95,8
48,329,48,375,76,70,6
48,329,48,377,114,0,114
48,329,48,381,73,68,5
48,329,48,389,78,0,78
48,329,48,423,111,107,4
48,329,48,439,547,665,-118
48,329,48,441,129,191,-62
48,329,48,451,307,326,-19
48,329,48,453,282,287,-5
48,329,48,465,0,69,-69
48,329,48,475,130,73,57
48,329,48,485,57,0,57
48,329,48,491,98,217,-119
48,329,48,495,72,65,7
48,329,48,497,82,0,82
48,331,48,27,250,371,-121
48,331,48,41,102,134,-32
48,331,48,201,102,85,17
48,331,48,453,158,108,50
48,331,48,491,438,279,159
48,335,48,353,0,65,-65
48,335,48,415,58,0,58
48,335,48,441,0,68,-68
48,337,48,77,68,0,68
48,337,48,97,112,122,-10
48,337,48,113,91,0,91
48,337,48,121,263,140,123
48,337,48,439,234,151,83
48,337,48,485,90,126,-36
48,337,48,497,311,174,137
48,339,2,20,92,0,92
48,339,4,13,314,273,41
48,339,5,7,0,66,-66
48,339,6,1,87,0,87
48,339,6,13,187,128,59
48,339,6,29,78,0,78
48,339,6,37,434,161,273
48,339,6,59,225,90,135
48,339,6,65,183,73,110
48,339,6,67,83,0,83
48,339,6,71,87,92,-5
48,339,6,73,277,213,64
48,339,6,85,77,0,77
48,339,6,111,71,0,71
48,339,8,1,0,66,-66
48,339,8,5,102,105,-3
48,339,8,31,92,157,-65
48,339,8,35,76,136,-60
48,339,8,41,144,163,-19
48,339,8,59,0,123,-123
48,339,8,69,0,69,-69
48,339,12,11,232,89,143
48,339,12,31,79,0,79
48,339,12,57,77,0,77
48,339,12,71,0,69,-69
48,339,12,86,139,98,41
48,339,12,95,112,78,34
48,339,12,99,115,0,115
48,339,12,103,77,0,77
48,339,13,67,60,0,60
48,339,13,121,50,0,50
48,339,15,3,120,53,67
48,339,17,31,224,91,133
48,339,17,43,89,0,89
48,339,17,97,96,0,96
48,339,17,197,84,0,84
48,339,18,97,77,0,77
48,339,20,173,63,0,63
48,339,22,19,99,114,-15
48,339,22,33,193,105,88
48,339,22,51,146,0,146
48,339,22,55,213,85,128
48,339,22,71,75,61,14
48,339,22,79,58,0,58
48,339,22,103,120,75,45
48,339,27,53,69,0,69
48,339,29,189,68,0,68
48,339,32,3,141,147,-6
48,339,36,61,67,52,15
48,339,37,119,63,0,63
48,339,39,49,64,0,64
48,339,40,27,67,0,67
48,339,40,109,180,138,42
48,339,40,143,108,88,20
48,339,47,37,49,62,-13
48,339,47,157,85,0,85
48,339,48,1,0,63,-63
48,339,48,5,188,124,64
48,339,48,15,72,0,72
48,339,48,27,227,181,46
48,339,48,29,595,619,-24
48,339,48,39,612,390,222
48,339,48,41,508,447,61
48,339,48,61,119,111,8
48,339,48,71,88,79,9
48,339,48,85,356,298,58
48,339,48,91,115,236,-121
48,339,48,113,721,533,188
48,339,48,121,416,315,101
48,339,48,135,90,0,90
48,339,48,139,105,77,28
48,339,48,141,118,71,47
48,339,48,157,1275,787,488
48,339,48,167,709,602,107
48,339,48,183,63,0,63
48,339,48,185,318,527,-209
48,339,48,187,85,81,4
48,339,48,199,116,83,33
48,339,48,201,31147,19178,11969
48,339,48,209,125,184,-59
48,339,48,215,160,103,57
48,339,48,225,0,112,-112
48,339,48,245,463,219,244
48,339,48,251,0,77,-77
48,339,48,265,0,64,-64
48,339,48,289,0,137,-137
48,339,48,291,1161,1330,-169
48,339,48,303,150,94,56
48,339,48,309,81,119,-38
48,339,48,313,0,65,-65
48,339,48,329,262,341,-79
48,339,48,347,81,87,-6
48,339,48,355,217,188,29
48,339,48,361,89,0,89
48,339,48,367,169,0,169
48,339,48,373,407,510,-103
48,339,48,407,558,645,-87
48,339,48,409,69,0,69
48,339,48,423,166,156,10
48,339,48,439,1365,603,762
48,339,48,453,631,819,-188
48,339,48,455,120,176,-56
48,339,48,469,54,0,54
48,339,48,471,1515,1067,448
48,339,48,473,369,449,-80
48,339,48,477,111,77,34
48,339,48,479,77,0,77
48,339,48,491,312,430,-118
48,339,49,35,103,73,30
48,339,49,49,70,0,70
48,339,51,59,116,0,116
48,339,53,33,153,110,43
48,339,53,53,102,78,24
48,339,53,61,71,0,71
48,341,40,139,85,0,85
48,341,48,233,0,84,-84
48,341,48,303,0,64,-64
48,341,48,375,197,312,-115
48,341,48,381,175,302,-127
48,343,48,37,0,68,-68
48,343,48,67,173,192,-19
48,343,48,113,0,59,-59
48,343,48,183,85,85,0
48,343,48,449,203,185,18
48,343,48,459,67,0,67
48,347,48,5,577,552,25
48,347,48,29,70,0,70
48,347,48,73,118,102,16
48,347,48,85,0,60,-60
48,347,48,113,138,180,-42
48,347,48,121,0,77,-77
48,347,48,183,0,62,-62
48,347,48,201,353,401,-48
48,347,48,339,87,81,6
48,347,48,373,55,0,55
48,347,48,401,160,232,-72
48,347,48,405,98,0,98
48,347,48,419,289,243,46
48,347,48,423,80,202,-122
48,347,48,439,101,125,-24
48,347,48,453,53,90,-37
48,347,48,491,0,64,-64
48,349,48,27,63,0,63
48,349,48,85,71,72,-1
48,349,48,113,861,465,396
48,349,48,121,75,57,18
48,349,48,139,680,509,171
48,349,48,161,102,87,15
48,349,48,201,105,92,13
48,349,48,213,127,129,-2
48,349,48,217,98,70,28
48,349,48,257,95,0,95
48,349,48,309,77,130,-53
48,349,48,423,0,73,-73
48,349,48,439,273,193,80
48,351,48,241,295,310,-15
48,351,48,245,86,66,20
48,351,48,361,197,191,6
48,353,48,151,99,75,24
48,353,48,335,65,0,65
48,353,48,415,0,66,-66
48,353,48,441,181,192,-11
48,355,4,13,92,123,-31
48,355,6,37,83,80,3
48,355,6,73,249,268,-19
48,355,8,41,0,112,-112
48,355,12,31,0,122,-122
48,355,12,33,230,57,173
48,355,12,57,0,61,-61
48,355,12,86,78,0,78
48,355,12,113,120,100,20
48,355,15,3,111,0,111
48,355,17,31,60,51,9
48,355,22,19,0,66,-66
48,355,28,75,0,69,-69
48,355,32,3,77,54,23
48,355,37,133,0,104,-104
48,355,40,109,0,103,-103
48,355,48,7,594,242,352
48,355,48,13,70,64,6
48,355,48,25,232,252,-20
48,355,48,27,170,147,23
48,355,48,29,1499,2574,-1075
48,355,48,39,125,157,-32
48,355,48,41,63,104,-41
48,355,48,61,563,435,128
48,355,48,85,99,160,-61
48,355,48,91,118,244,-126
48,355,48,113,280,305,-25
48,355,48,121,142,193,-51
48,355,48,131,79,101,-22
48,355,48,135,0,78,-78
48,355,48,141,128,97,31
48,355,48,157,174,261,-87
48,355,48,167,78,141,-63
48,355,48,187,114,167,-53
48,355,48,201,1199,1531,-332
48,355,48,209,174,193,-19
48,355,48,215,553,460,93
48,355,48,245,70,100,-30
48,355,48,249,752,663,89
48,355,48,259,0,93,-93
48,355,48,265,0,67,-67
48,355,48,273,591,591,0
48,355,48,297,142,141,1
48,355,48,303,81,98,-17
48,355,48,309,92,95,-3
48,355,48,329,79,133,-54
48,355,48,339,188,217,-29
48,355,48,391,110,105,5
48,355,48,409,2397,1898,499
48,355,48,423,0,89,-89
48,355,48,439,288,326,-38
48,355,48,441,73,0,73
48,355,48,451,90,83,7
48,355,48,453,467,758,-291
48,355,48,469,268,247,21
48,355,48,479,158,168,-10
48,355,48,491,279,439,-160
48,355,48,493,87,71,16
48,355,51,710,0,65,-65
48,355,51,810,69,74,-5
48,355,53,33,0,66,-66
48,355,53,53,79,0,79
48,357,48,381,0,63,-63
48,361,22,19,311,421,-110
48,361,48,39,0,76,-76
48,361,48,113,0,88,-88
48,361,48,167,80,92,-12
48,361,48,199,335,485,-150
48,361,48,201,387,467,-80
48,361,48,241,245,386,-141
48,361,48,245,1735,1792,-57
48,361,48,339,0,89,-89
48,361,48,351,191,197,-6
48,361,48,403,0,106,-106
48,361,48,439,75,0,75
48,361,48,453,0,65,-65
48,361,48,457,0,93,-93
48,363,48,113,60,0,60
48,363,48,121,68,63,5
48,363,48,143,88,72,16
48,363,48,221,90,91,-1
48,363,48,237,62,0,62
48,363,48,367,676,531,145
48,363,48,439,427,286,141
48,365,22,17,80,66,14
48,365,48,183,145,142,3
48,365,48,203,176,162,14
48,365,48,401,121,183,-62
48,365,48,419,160,118,42
48,367,4,13,100,0,100
48,367,6,37,126,0,126
48,367,6,65,77,0,77
48,367,6,73,126,0,126
48,367,48,29,142,62,80
48,367,48,41,74,0,74
48,367,48,85,226,168,58
48,367,48,113,552,277,275
48,367,48,121,564,295,269
48,367,48,133,0,84,-84
48,367,48,139,89,64,25
48,367,48,143,152,142,10
48,367,48,201,225,97,128
48,367,48,221,471,695,-224
48,367,48,237,92,111,-19
48,367,48,251,472,298,174
48,367,48,303,113,67,46
48,367,48,329,102,79,23
48,367,48,339,0,169,-169
48,367,48,363,531,676,-145
48,367,48,439,8491,4439,4052
48,367,48,441,84,63,21
48,367,48,453,122,95,27
48,367,48,485,84,81,3
48,367,48,491,83,62,21
48,367,48,497,541,588,-47
48,367,48,503,0,80,-80
48,369,35,9,115,137,-22
48,369,48,117,88,81,7
48,369,48,381,0,63,-63
48,371,48,135,71,136,-65
48,371,48,141,80,0,80
48,371,48,329,95,103,-8
48,373,4,13,0,137,-137
48,373,4,19,0,66,-66
48,373,4,21,0,50,-50
48,373,6,37,59,0,59
48,373,6,73,80,0,80
48,373,12,119,0,191,-191
48,373,46,103,0,62,-62
48,373,48,5,166,265,-99
48,373,48,29,90,0,90
48,373,48,39,103,0,103
48,373,48,85,79,0,79
48,373,48,113,92,0,92
48,373,48,121,78,0,78
48,373,48,157,70,65,5
48,373,48,167,129,97,32
48,373,48,201,1195,618,577
48,373,48,291,195,136,59
48,373,48,339,510,407,103
48,373,48,347,0,55,-55
48,373,48,407,235,231,4
48,373,48,439,142,58,84
48,373,48,453,109,70,39
48,373,48,455,84,128,-44
48,373,48,457,0,111,-111
48,373,48,471,64,67,-3
48,373,48,491,93,0,93
48,375,6,37,80,59,21
48,375,8,41,67,58,9
48,375,40,109,0,73,-73
48,375,48,29,91,107,-16
48,375,48,65,82,74,8
48,375,48,85,0,77,-77
48,375,48,113,174,235,-61
48,375,48,117,155,95,60
48,375,48,121,0,71,-71
48,375,48,141,0,93,-93
48,375,48,179,143,91,52
48,375,48,189,61,0,61
48,375,48,201,92,108,-16
48,375,48,233,129,129,0
48,375,48,303,195,316,-121
48,375,48,329,70,76,-6
48,375,48,341,312,197,115
48,375,48,381,5898,6979,-1081
48,375,48,439,207,254,-47
48,375,48,453,0,103,-103
48,377,48,135,74,340,-266
48,377,48,329,0,114,-114
48,379,48,85,102,0,102
48,379,48,113,198,62,136
48,379,48,223,101,116,-15
48,379,48,231,286,169,117
48,379,48,257,71,0,71
48,379,48,499,89,122,-33
48,381,4,13,73,102,-29
48,381,8,41,89,0,89
48,381,32,3,0,55,-55
48,381,35,1,61,66,-5
48,381,35,9,97,0,97
48,381,40,109,0,99,-99
48,381,48,11,62,0,62
48,381,48,29,132,163,-31
48,381,48,65,130,114,16
48,381,48,85,117,187,-70
48,381,48,111,68,0,68
48,381,48,113,170,201,-31
48,381,48,117,271,109,162
48,381,48,121,126,140,-14
48,381,48,129,54,0,54
48,381,48,179,234,97,137
48,381,48,189,129,72,57
48,381,48,201,93,131,-38
48,381,48,233,245,154,91
48,381,48,303,410,524,-114
48,381,48,329,68,73,-5
48,381,48,341,302,175,127
48,381,48,357,63,0,63
48,381,48,369,63,0,63
48,381,48,375,6979,5898,1081
48,381,48,437,96,100,-4
48,381,48,439,251,363,-112
48,381,48,441,0,68,-68
48,381,48,453,67,101,-34
48,381,48,485,0,57,-57
48,381,48,491,0,108,-108
48,387,48,37,93,113,-20
48,387,48,277,245,331,-86
48,389,48,135,85,174,-89
48,389,48,329,0,78,-78
48,391,48,355,105,110,-5
48,391,48,409,0,66,-66
48,391,48,469,63,0,63
48,395,48,41,664,661,3
48,395,48,201,110,65,45
48,395,48,309,0,63,-63
48,397,6,37,109,0,109
48,397,6,59,64,0,64
48,397,6,65,94,0,94
48,397,6,73,75,0,75
48,397,48,29,91,58,33
48,397,48,85,1659,1384,275
48,397,48,113,5475,3005,2470
48,397,48,121,476,349,127
48,397,48,139,63,101,-38
48,397,48,201,198,107,91
48,397,48,223,58,0,58
48,397,48,231,818,1502,-684
48,397,48,257,775,784,-9
48,397,48,423,65,74,-9
48,397,48,439,447,272,175
48,397,48,453,106,94,12
48,397,48,467,93,98,-5
48,399,48,441,73,116,-43
48,399,48,451,186,265,-79
48,401,48,73,125,133,-8
48,401,48,113,79,114,-35
48,401,48,183,1269,1149,120
48,401,48,201,110,89,21
48,401,48,203,162,171,-9
48,401,48,347,232,160,72
48,401,48,365,183,121,62
48,401,48,423,456,508,-52
48,401,48,439,89,58,31
48,401,48,459,100,100,0
48,403,48,5,0,57,-57
48,403,48,201,71,0,71
48,403,48,241,134,104,30
48,403,48,245,58,0,58
48,403,48,361,106,0,106
48,403,48,405,62,0,62
48,405,48,5,66,112,-46
48,405,48,347,0,98,-98
48,405,48,403,0,62,-62
48,407,48,201,812,482,330
48,407,48,291,354,509,-155
48,407,48,339,645,558,87
48,407,48,373,231,235,-4
48,407,48,471,212,158,54
48,409,48,7,824,614,210
48,409,48,25,124,156,-32
48,409,48,29,213,441,-228
48,409,48,61,275,189,86
48,409,48,91,0,63,-63
48,409,48,113,55,0,55
48,409,48,187,0,69,-69
48,409,48,201,313,335,-22
48,409,48,215,108,99,9
48,409,48,249,141,158,-17
48,409,48,297,0,70,-70
48,409,48,339,0,69,-69
48,409,48,355,1898,2397,-499
48,409,48,391,66,0,66
48,409,48,439,0,89,-89
48,409,48,453,78,122,-44
48,409,48,469,66,73,-7
48,413,48,451,0,99,-99
48,415,48,303,0,121,-121
48,415,48,335,0,58,-58
48,415,48,353,66,0,66
48,415,48,441,0,72,-72
48,417,48,441,63,74,-11
48,419,22,31,70,63,7
48,419,48,113,72,0,72
48,419,48,201,119,62,57
48,419,48,347,243,289,-46
48,419,48,365,118,160,-42
48,423,4,13,81,72,9
48,423,6,37,113,62,51
48,423,6,65,96,0,96
48,423,6,73,106,0,106
48,423,8,41,68,68,0
48,423,22,15,0,54,-54
48,423,22,17,84,0,84
48,423,40,109,77,75,2
48,423,48,1,474,284,190
48,423,48,5,145,89,56
48,423,48,27,109,93,16
48,423,48,29,219,194,25
48,423,48,37,76,74,2
48,423,48,39,69,59,10
48,423,48,41,102,65,37
48,423,48,73,1003,959,44
48,423,48,85,374,538,-164
48,423,48,113,1078,1131,-53
48,423,48,121,314,386,-72
48,423,48,139,74,0,74
48,423,48,157,83,131,-48
48,423,48,167,69,92,-23
48,423,48,183,927,857,70
48,423,48,201,563,511,52
48,423,48,203,272,145,127
48,423,48,213,1053,969,84
48,423,48,223,79,0,79
48,423,48,231,75,67,8
48,423,48,245,93,0,93
48,423,48,257,193,174,19
48,423,48,277,0,56,-56
48,423,48,303,69,84,-15
48,423,48,309,122,84,38
48,423,48,329,107,111,-4
48,423,48,339,156,166,-10
48,423,48,347,202,80,122
48,423,48,349,73,0,73
48,423,48,355,89,0,89
48,423,48,397,74,65,9
48,423,48,401,508,456,52
48,423,48,439,635,750,-115
48,423,48,441,76,0,76
48,423,48,453,204,277,-73
48,423,48,459,229,287,-58
48,423,48,467,529,570,-41
48,423,48,491,134,196,-62
48,423,48,499,641,598,43
48,425,48,35,0,75,-75
48,425,48,221,215,166,49
48,425,48,251,143,69,74
48,425,48,439,178,81,97
48,427,48,29,0,91,-91
48,427,48,61,80,0,80
48,427,48,201,153,195,-42
48,427,48,215,705,1139,-434
48,435,48,451,0,72,-72
48,437,48,189,110,93,17
48,437,48,381,100,96,4
48,439,1,3,0,82,-82
48,439,1,73,131,90,41
48,439,1,89,102,110,-8
48,439,1,97,128,63,65
48,439,2,20,93,0,93
48,439,4,13,1231,1136,95
48,439,4,19,376,222,154
48,439,4,21,108,74,34
48,439,5,7,145,238,-93
48,439,5,31,57,0,57
48,439,5,45,88,0,88
48,439,5,51,78,95,-17
48,439,5,69,96,0,96
48,439,5,119,389,310,79
48,439,5,125,75,69,6
48,439,5,131,96,92,4
48,439,5,143,87,146,-59
48,439,6,1,307,199,108
48,439,6,13,276,144,132
48,439,6,19,169,95,74
48,439,6,29,216,119,97
48,439,6,37,2023,1164,859
48,439,6,53,69,0,69
48,439,6,59,948,458,490
48,439,6,61,101,0,101
48,439,6,65,643,358,285
48,439,6,67,358,220,138
48,439,6,71,716,432,284
48,439,6,73,1218,780,438
48,439,6,75,99,88,11
48,439,6,77,92,84,8
48,439,6,81,92,103,-11
48,439,6,83,74,0,74
48,439,6,85,315,268,47
48,439,6,95,112,67,45
48,439,6,97,54,0,54
48,439,6,99,107,0,107
48,439,6,111,240,135,105
48,439,8,1,132,154,-22
48,439,8,5,323,294,29
48,439,8,13,66,124,-58
48,439,8,31,255,337,-82
48,439,8,35,173,216,-43
48,439,8,41,396,537,-141
48,439,8,59,125,210,-85
48,439,8,69,96,200,-104
48,439,8,123,0,115,-115
48,439,9,1,135,78,57
48,439,9,3,69,91,-22
48,439,9,9,95,71,24
48,439,10,3,104,0,104
48,439,11,1,93,135,-42
48,439,12,5,0,84,-84
48,439,12,9,166,133,33
48,439,12,11,408,236,172
48,439,12,19,0,63,-63
48,439,12,21,61,74,-13
48,439,12,31,253,213,40
48,439,12,33,152,116,36
48,439,12,57,304,390,-86
48,439,12,69,0,68,-68
48,439,12,71,139,122,17
48,439,12,81,54,79,-25
48,439,12,86,535,231,304
48,439,12,91,164,99,65
48,439,12,95,407,373,34
48,439,12,97,75,100,-25
48,439,12,99,234,218,16
48,439,12,101,101,105,-4
48,439,12,103,132,169,-37
48,439,12,105,170,115,55
48,439,12,109,0,90,-90
48,439,12,111,78,0,78
48,439,12,113,0,75,-75
48,439,12,115,0,81,-81
48,439,12,117,123,94,29
48,439,12,127,62,77,-15
48,439,13,51,59,69,-10
48,439,13,63,59,63,-4
48,439,13,67,263,176,87
48,439,13,89,207,172,35
48,439,13,121,267,273,-6
48,439,13,135,200,153,47
48,439,13,151,0,78,-78
48,439,13,215,63,0,63
48,439,15,3,346,253,93
48,439,16,1,63,92,-29
48,439,17,19,67,0,67
48,439,17,31,1132,756,376
48,439,17,43,215,119,96
48,439,17,89,139,0,139
48,439,17,97,167,99,68
48,439,17,113,78,0,78
48,439,17,119,51,0,51
48,439,17,143,77,0,77
48,439,17,163,71,0,71
48,439,17,197,152,107,45
48,439,18,3,54,64,-10
48,439,18,5,0,55,-55
48,439,18,57,0,97,-97
48,439,18,89,110,0,110
48,439,18,97,218,143,75
48,439,19,153,69,68,1
48,439,20,91,274,226,48
48,439,20,161,63,0,63
48,439,20,173,398,262,136
48,439,20,177,73,62,11
48,439,21,67,62,0,62
48,439,21,111,120,138,-18
48,439,22,15,210,152,58
48,439,22,17,645,298,347
48,439,22,19,90,86,4
48,439,22,33,263,181,82
48,439,22,35,69,0,69
48,439,22,51,170,71,99
48,439,22,55,120,114,6
48,439,22,61,92,0,92
48,439,22,71,227,132,95
48,439,22,73,371,144,227
48,439,22,79,144,0,144
48,439,22,103,67,76,-9
48,439,23,5,66,0,66
48,439,24,3,131,107,24
48,439,24,5,102,0,102
48,439,24,27,0,69,-69
48,439,24,31,200,141,59
48,439,24,33,193,119,74
48,439,25,17,145,132,13
48,439,25,21,80,0,80
48,439,25,25,114,68,46
48,439,25,27,84,63,21
48,439,26,49,172,100,72
48,439,26,65,59,0,59
48,439,26,77,62,0,62
48,439,26,81,94,94,0
48,439,26,99,105,93,12
48,439,26,125,241,220,21
48,439,26,161,69,60,9
48,439,26,163,250,215,35
48,439,27,37,81,105,-24
48,439,27,53,236,235,1
48,439,27,123,92,74,18
48,439,28,33,88,0,88
48,439,28,35,64,0,64
48,439,28,47,92,68,24
48,439,28,49,387,110,277
48,439,28,89,81,0,81
48,439,28,121,58,0,58
48,439,28,149,103,0,103
48,439,28,151,89,0,89
48,439,29,19,63,0,63
48,439,29,47,113,103,10
48,439,29,77,77,92,-15
48,439,29,95,292,207,85
48,439,29,165,86,0,86
48,439,29,183,126,99,27
48,439,29,189,395,179,216
48,439,29,510,103,0,103
48,439,31,55,188,192,-4
48,439,31,109,76,66,10
48,439,32,3,720,578,142
48,439,32,31,108,76,32
48,439,33,11,91,74,17
48,439,34,3,83,0,83
48,439,34,5,104,0,104
48,439,34,13,70,69,1
48,439,34,17,119,79,40
48,439,34,23,134,72,62
48,439,34,27,68,0,68
48,439,34,39,65,0,65
48,439,35,1,340,178,162
48,439,35,13,97,93,4
48,439,35,15,0,73,-73
48,439,35,25,0,76,-76
48,439,35,43,104,76,28
48,439,35,49,79,76,3
48,439,36,5,165,65,100
48,439,36,29,117,0,117
48,439,36,47,247,130,117
48,439,36,55,76,0,76
48,439,36,59,132,0,132
48,439,36,61,162,184,-22
48,439,36,67,71,0,71
48,439,36,71,69,0,69
48,439,36,81,266,135,131
48,439,36,103,145,58,87
48,439,36,119,113,0,113
48,439,37,21,0,61,-61
48,439,37,49,103,0,103
48,439,37,51,148,85,63
48,439,37,63,78,71,7
48,439,37,81,82,77,5
48,439,37,119,227,241,-14
48,439,37,133,163,69,94
48,439,37,179,62,0,62
48,439,37,183,141,168,-27
48,439,39,17,0,73,-73
48,439,39,35,131,112,19
48,439,39,49,207,326,-119
48,439,39,61,88,162,-74
48,439,39,95,74,0,74
48,439,39,113,75,101,-26
48,439,39,153,0,113,-113
48,439,40,13,0,84,-84
48,439,40,17,146,125,21
48,439,40,19,77,58,19
48,439,40,27,261,279,-18
48,439,40,31,198,142,56
48,439,40,109,823,707,116
48,439,40,119,51,0,51
48,439,40,143,647,513,134
48,439,41,39,0,47,-47
48,439,41,51,117,152,-35
48,439,41,67,88,115,-27
48,439,42,3,157,143,14
48,439,42,43,0,96,-96
48,439,42,91,71,0,71
48,439,42,101,119,89,30
48,439,44,7,59,0,59
48,439,45,15,86,0,86
48,439,45,19,69,114,-45
48,439,45,45,66,99,-33
48,439,45,79,64,0,64
48,439,45,91,65,0,65
48,439,47,37,190,208,-18
48,439,47,93,107,78,29
48,439,47,125,104,103,1
48,439,47,149,85,80,5
48,439,47,157,500,328,172
48,439,47,187,0,97,-97
48,439,48,1,117,155,-38
48,439,48,5,228,68,160
48,439,48,21,72,59,13
48,439,48,27,1091,730,361
48,439,48,29,1889,1782,107
48,439,48,35,100,133,-33
48,439,48,37,230,158,72
48,439,48,39,224,239,-15
48,439,48,41,446,365,81
48,439,48,49,119,104,15
48,439,48,53,0,69,-69
48,439,48,61,293,204,89
48,439,48,73,65,105,-40
48,439,48,85,3989,5189,-1200
48,439,48,91,139,198,-59
48,439,48,93,0,66,-66
48,439,48,97,123,191,-68
48,439,48,99,148,104,44
48,439,48,113,37566,30925,6641
48,439,48,121,11779,14031,-2252
48,439,48,133,52,78,-26
48,439,48,135,310,326,-16
48,439,48,139,1885,3504,-1619
48,439,48,141,932,620,312
48,439,48,143,308,354,-46
48,439,48,147,117,108,9
48,439,48,157,520,509,11
48,439,48,161,0,104,-104
48,439,48,167,254,296,-42
48,439,48,181,390,430,-40
48,439,48,183,334,286,48
48,439,48,187,189,179,10
48,439,48,201,3702,3363,339
48,439,48,203,163,131,32
48,439,48,209,289,307,-18
48,439,48,213,293,422,-129
48,439,48,215,425,309,116
48,439,48,217,263,426,-163
48,439,48,221,1100,1945,-845
48,439,48,223,76,103,-27
48,439,48,227,93,77,16
48,439,48,231,272,447,-175
48,439,48,237,67,78,-11
48,439,48,245,379,109,270
48,439,48,251,6084,10291,-4207
48,439,48,257,540,811,-271
48,439,48,265,76,0,76
48,439,48,277,113,131,-18
48,439,48,303,968,640,328
48,439,48,309,754,750,4
48,439,48,323,75,0,75
48,439,48,329,665,547,118
48,439,48,337,151,234,-83
48,439,48,339,603,1365,-762
48,439,48,347,125,101,24
48,439,48,349,193,273,-80
48,439,48,355,326,288,38
48,439,48,361,0,75,-75
48,439,48,363,286,427,-141
48,439,48,367,4439,8491,-4052
48,439,48,373,58,142,-84
48,439,48,375,254,207,47
48,439,48,381,363,251,112
48,439,48,397,272,447,-175
48,439,48,401,58,89,-31
48,439,48,409,89,0,89
48,439,48,423,750,635,115
48,439,48,425,81,178,-97
48,439,48,441,636,521,115
48,439,48,449,63,0,63
48,439,48,451,285,198,87
48,439,48,453,1681,1952,-271
48,439,48,459,55,95,-40
48,439,48,465,68,94,-26
48,439,48,467,151,244,-93
48,439,48,469,70,0,70
48,439,48,471,82,74,8
48,439,48,479,165,98,67
48,439,48,485,600,537,63
48,439,48,491,789,895,-106
48,439,48,497,1474,2888,-1414
48,439,48,499,106,286,-180
48,439,48,503,78,111,-33
48,439,49,11,81,83,-2
48,439,49,35,252,218,34
48,439,49,49,181,133,48
48,439,49,57,0,68,-68
48,439,51,13,53,78,-25
48,439,51,41,68,0,68
48,439,51,59,280,227,53
48,439,51,107,104,110,-6
48,439,51,153,146,81,65
48,439,51,510,52,0,52
48,439,51,550,71,0,71
48,439,51,710,86,83,3
48,439,51,810,171,164,7
48,439,53,11,86,101,-15
48,439,53,33,526,560,-34
48,439,53,35,69,0,69
48,439,53,53,317,204,113
48,439,53,61,183,220,-37
48,439,53,63,94,62,32
48,439,53,67,82,65,17
48,439,55,25,68,94,-26
48,439,55,79,325,174,151
48,439,55,133,56,0,56
48,441,4,13,81,72,9
48,441,6,37,83,75,8
48,441,8,41,0,118,-118
48,441,12,91,0,57,-57
48,441,32,3,60,0,60
48,441,40,109,0,61,-61
48,441,46,103,0,66,-66
48,441,48,27,75,94,-19
48,441,48,29,293,374,-81
48,441,48,49,190,74,116
48,441,48,59,588,712,-124
48,441,48,83,75,79,-4
48,441,48,85,120,147,-27
48,441,48,113,298,411,-113
48,441,48,121,150,174,-24
48,441,48,133,83,97,-14
48,441,48,135,173,99,74
48,441,48,143,87,0,87
48,441,48,201,171,193,-22
48,441,48,207,75,0,75
48,441,48,209,0,63,-63
48,441,48,227,65,69,-4
48,441,48,251,0,82,-82
48,441,48,253,766,714,52
48,441,48,303,250,281,-31
48,441,48,309,78,65,13
48,441,48,329,191,129,62
48,441,48,335,68,0,68
48,441,48,353,192,181,11
48,441,48,355,0,73,-73
48,441,48,367,63,84,-21
48,441,48,381,68,0,68
48,441,48,399,116,73,43
48,441,48,415,72,0,72
48,441,48,417,74,63,11
48,441,48,423,0,76,-76
48,441,48,439,521,636,-115
48,441,48,451,248,236,12
48,441,48,453,123,178,-55
48,441,48,485,125,141,-16
48,441,48,491,87,139,-52
48,445,48,165,0,69,-69
48,445,48,219,0,58,-58
48,445,48,303,240,303,-63
48,449,48,63,248,305,-57
48,449,48,113,128,135,-7
48,449,48,159,182,136,46
48,449,48,183,0,99,-99
48,449,48,277,0,72,-72
48,449,48,343,185,203,-18
48,449,48,439,0,63,-63
48,451,2,20,0,61,-61
48,451,4,13,68,81,-13
48,451,4,19,0,68,-68
48,451,6,37,0,56,-56
48,451,6,53,182,0,182
48,451,6,73,63,66,-3
48,451,8,41,87,67,20
48,451,12,91,0,56,-56
48,451,13,245,0,63,-63
48,451,15,3,83,150,-67
48,451,24,3,97,218,-121
48,451,31,153,0,86,-86
48,451,35,9,0,51,-51
48,451,37,133,0,60,-60
48,451,48,27,110,71,39
48,451,48,29,375,619,-244
48,451,48,49,96,0,96
48,451,48,81,87,127,-40
48,451,48,85,0,85,-85
48,451,48,95,100,84,16
48,451,48,113,163,216,-53
48,451,48,121,88,111,-23
48,451,48,135,203,190,13
48,451,48,141,77,93,-16
48,451,48,187,0,82,-82
48,451,48,201,140,198,-58
48,451,48,209,58,0,58
48,451,48,227,95,112,-17
48,451,48,235,67,83,-16
48,451,48,265,0,73,-73
48,451,48,303,183,166,17
48,451,48,307,78,71,7
48,451,48,329,326,307,19
48,451,48,355,83,90,-7
48,451,48,399,265,186,79
48,451,48,413,99,0,99
48,451,48,435,72,0,72
48,451,48,439,198,285,-87
48,451,48,441,236,248,-12
48,451,48,453,111,186,-75
48,451,48,465,151,118,33
48,451,48,491,70,190,-120
48,451,51,650,0,60,-60
48,453,1,73,75,131,-56
48,453,1,89,0,63,-63
48,453,1,97,55,76,-21
48,453,2,20,98,63,35
48,453,4,5,53,0,53
48,453,4,13,1070,1154,-84
48,453,4,19,224,217,7
48,453,5,7,110,85,25
48,453,5,119,133,108,25
48,453,5,143,78,76,2
48,453,6,1,863,474,389
48,453,6,13,466,180,286
48,453,6,19,113,82,31
48,453,6,29,102,212,-110
48,453,6,37,2615,1872,743
48,453,6,41,175,49,126
48,453,6,53,126,0,126
48,453,6,59,1067,551,516
48,453,6,65,372,462,-90
48,453,6,67,223,218,5
48,453,6,71,235,236,-1
48,453,6,73,1260,740,520
48,453,6,75,847,492,355
48,453,6,77,66,0,66
48,453,6,79,75,0,75
48,453,6,81,474,227,247
48,453,6,83,154,69,85
48,453,6,85,1591,856,735
48,453,6,87,81,0,81
48,453,6,95,79,0,79
48,453,6,97,126,0,126
48,453,6,107,0,167,-167
48,453,6,111,209,113,96
48,453,8,1,101,119,-18
48,453,8,5,261,252,9
48,453,8,13,188,279,-91
48,453,8,14,0,53,-53
48,453,8,31,422,721,-299
48,453,8,35,146,177,-31
48,453,8,41,289,334,-45
48,453,8,59,192,284,-92
48,453,8,67,0,58,-58
48,453,8,69,169,187,-18
48,453,9,1,278,131,147
48,453,9,3,114,102,12
48,453,9,9,172,106,66
48,453,10,3,67,81,-14
48,453,11,1,528,378,150
48,453,12,1,98,79,19
48,453,12,9,101,93,8
48,453,12,11,451,492,-41
48,453,12,21,92,80,12
48,453,12,31,210,210,0
48,453,12,33,78,73,5
48,453,12,57,370,462,-92
48,453,12,69,0,55,-55
48,453,12,71,142,173,-31
48,453,12,73,100,114,-14
48,453,12,81,65,86,-21
48,453,12,83,0,68,-68
48,453,12,86,772,809,-37
48,453,12,91,57,64,-7
48,453,12,95,311,405,-94
48,453,12,97,65,92,-27
48,453,12,99,416,422,-6
48,453,12,101,70,106,-36
48,453,12,103,179,254,-75
48,453,12,105,112,114,-2
48,453,12,109,53,67,-14
48,453,12,111,0,79,-79
48,453,12,115,106,86,20
48,453,12,117,77,93,-16
48,453,12,127,96,121,-25
48,453,13,51,47,91,-44
48,453,13,59,48,0,48
48,453,13,63,0,70,-70
48,453,13,67,213,205,8
48,453,13,89,153,269,-116
48,453,13,121,368,475,-107
48,453,13,135,120,163,-43
48,453,15,3,317,159,158
48,453,16,1,114,123,-9
48,453,17,19,96,0,96
48,453,17,31,1512,1084,428
48,453,17,43,261,121,140
48,453,17,89,82,0,82
48,453,17,97,184,132,52
48,453,17,111,83,0,83
48,453,17,113,57,0,57
48,453,17,143,79,0,79
48,453,17,197,98,0,98
48,453,18,57,82,70,12
48,453,18,89,66,0,66
48,453,18,97,147,138,9
48,453,18,105,68,0,68
48,453,18,141,43,0,43
48,453,18,157,50,0,50
48,453,19,103,49,0,49
48,453,19,153,0,87,-87
48,453,20,45,53,0,53
48,453,20,91,207,111,96
48,453,20,173,88,70,18
48,453,21,67,103,60,43
48,453,21,111,115,121,-6
48,453,22,17,97,0,97
48,453,22,19,61,62,-1
48,453,22,33,225,115,110
48,453,22,51,146,132,14
48,453,22,55,131,74,57
48,453,22,71,278,271,7
48,453,22,73,69,0,69
48,453,22,103,68,0,68
48,453,23,5,67,0,67
48,453,24,3,116,60,56
48,453,24,5,128,56,72
48,453,24,27,87,0,87
48,453,24,31,280,247,33
48,453,24,33,102,122,-20
48,453,24,510,136,116,20
48,453,25,9,95,108,-13
48,453,25,17,495,386,109
48,453,25,21,151,94,57
48,453,25,25,315,221,94
48,453,25,27,131,69,62
48,453,26,65,91,0,91
48,453,26,81,105,86,19
48,453,26,99,107,81,26
48,453,26,125,197,163,34
48,453,26,161,146,120,26
48,453,26,163,220,400,-180
48,453,27,37,0,133,-133
48,453,27,53,438,297,141
48,453,27,123,114,79,35
48,453,28,47,72,0,72
48,453,28,49,61,67,-6
48,453,29,19,57,0,57
48,453,29,77,66,0,66
48,453,29,95,182,156,26
48,453,29,183,51,0,51
48,453,29,189,187,219,-32
48,453,29,510,70,91,-21
48,453,31,55,130,104,26
48,453,31,109,77,0,77
48,453,32,3,495,558,-63
48,453,32,31,112,119,-7
48,453,33,11,79,0,79
48,453,33,15,79,0,79
48,453,34,3,144,0,144
48,453,34,5,55,0,55
48,453,34,13,106,56,50
48,453,34,17,193,131,62
48,453,34,21,83,0,83
48,453,34,23,191,111,80
48,453,34,25,70,0,70
48,453,34,27,145,50,95
48,453,34,31,51,0,51
48,453,34,35,74,0,74
48,453,34,39,61,0,61
48,453,35,1,300,241,59
48,453,35,13,110,60,50
48,453,35,43,0,65,-65
48,453,35,49,90,161,-71
48,453,36,5,110,186,-76
48,453,36,27,55,0,55
48,453,36,29,109,96,13
48,453,36,47,791,641,150
48,453,36,55,134,68,66
48,453,36,59,166,68,98
48,453,36,61,1024,788,236
48,453,36,67,75,0,75
48,453,36,71,56,0,56
48,453,36,81,375,198,177
48,453,36,91,114,59,55
48,453,36,103,156,80,76
48,453,36,119,162,103,59
48,453,37,21,80,117,-37
48,453,37,51,62,68,-6
48,453,37,63,121,142,-21
48,453,37,67,64,0,64
48,453,37,81,76,98,-22
48,453,37,119,317,266,51
48,453,37,129,49,0,49
48,453,37,133,47,0,47
48,453,37,135,60,0,60
48,453,37,183,411,292,119
48,453,39,35,180,197,-17
48,453,39,49,294,257,37
48,453,39,61,142,147,-5
48,453,39,113,66,91,-25
48,453,39,153,64,0,64
48,453,40,27,123,70,53
48,453,40,109,287,253,34
48,453,40,119,54,0,54
48,453,40,143,198,147,51
48,453,41,5,83,72,11
48,453,41,17,82,93,-11
48,453,41,39,86,95,-9
48,453,41,51,315,384,-69
48,453,41,67,298,210,88
48,453,42,3,263,167,96
48,453,42,17,69,61,8
48,453,42,29,97,0,97
48,453,42,45,50,54,-4
48,453,42,71,58,0,58
48,453,42,91,128,82,46
48,453,42,101,239,284,-45
48,453,44,7,87,75,12
48,453,45,19,130,87,43
48,453,45,45,0,128,-128
48,453,45,51,53,63,-10
48,453,45,79,112,66,46
48,453,47,37,284,341,-57
48,453,47,65,0,84,-84
48,453,47,93,81,82,-1
48,453,47,157,229,245,-16
48,453,47,187,67,90,-23
48,453,48,5,73,0,73
48,453,48,7,87,81,6
48,453,48,15,71,0,71
48,453,48,21,2470,4545,-2075
48,453,48,25,62,0,62
48,453,48,27,1751,2352,-601
48,453,48,29,4491,3691,800
48,453,48,31,116,195,-79
48,453,48,39,329,259,70
48,453,48,41,769,422,347
48,453,48,49,76,62,14
48,453,48,51,53,0,53
48,453,48,53,627,964,-337
48,453,48,55,728,1743,-1015
48,453,48,61,701,396,305
48,453,48,85,1390,1167,223
48,453,48,91,559,774,-215
48,453,48,99,239,262,-23
48,453,48,113,3460,3075,385
48,453,48,121,1062,1034,28
48,453,48,135,153,141,12
48,453,48,139,106,105,1
48,453,48,141,827,659,168
48,453,48,149,86,85,1
48,453,48,157,1155,777,378
48,453,48,167,440,345,95
48,453,48,171,105,156,-51
48,453,48,177,75,88,-13
48,453,48,181,62,78,-16
48,453,48,183,98,86,12
48,453,48,187,425,498,-73
48,453,48,199,55,0,55
48,453,48,201,6962,5143,1819
48,453,48,209,6275,11372,-5097
48,453,48,213,0,55,-55
48,453,48,215,991,563,428
48,453,48,221,50,0,50
48,453,48,245,379,180,199
48,453,48,251,87,87,0
48,453,48,257,59,103,-44
48,453,48,259,116,131,-15
48,453,48,265,176,149,27
48,453,48,273,51,0,51
48,453,48,281,82,87,-5
48,453,48,287,173,164,9
48,453,48,299,152,239,-87
48,453,48,303,509,301,208
48,453,48,309,616,485,131
48,453,48,323,100,52,48
48,453,48,325,0,55,-55
48,453,48,329,287,282,5
48,453,48,331,108,158,-50
48,453,48,339,819,631,188
48,453,48,347,90,53,37
48,453,48,355,758,467,291
48,453,48,361,65,0,65
48,453,48,367,95,122,-27
48,453,48,373,70,109,-39
48,453,48,375,103,0,103
48,453,48,381,101,67,34
48,453,48,397,94,106,-12
48,453,48,409,122,78,44
48,453,48,423,277,204,73
48,453,48,439,1952,1681,271
48,453,48,441,178,123,55
48,453,48,451,186,111,75
48,453,48,465,81,59,22
48,453,48,467,0,62,-62
48,453,48,469,265,121,144
48,453,48,471,83,0,83
48,453,48,473,58,0,58
48,453,48,477,73,53,20
48,453,48,479,362,202,160
48,453,48,485,170,74,96
48,453,48,491,21471,31165,-9694
48,453,48,493,0,55,-55
48,453,49,35,303,289,14
48,453,49,49,145,59,86
48,453,50,7,43,0,43
48,453,51,13,194,121,73
48,453,51,59,450,248,202
48,453,51,107,124,83,41
48,453,51,153,102,0,102
48,453,51,510,102,86,16
48,453,51,710,53,0,53
48,453,51,760,84,0,84
48,453,51,810,101,58,43
48,453,53,11,103,136,-33
48,453,53,33,1058,1316,-258
48,453,53,35,80,80,0
48,453,53,53,143,189,-46
48,453,53,61,164,163,1
48,453,53,63,63,105,-42
48,453,53,67,60,92,-32
48,453,53,73,0,72,-72
48,453,55,25,217,115,102
48,453,55,79,200,147,53
48,453,55,133,57,0,57
48,455,48,5,111,104,7
48,455,48,201,212,121,91
48,455,48,225,72,56,16
48,455,48,339,176,120,56
48,455,48,373,128,84,44
48,455,48,471,180,253,-73
48,457,48,5,63,75,-12
48,457,48,199,221,223,-2
48,457,48,201,198,133,65
48,457,48,241,108,107,1
48,457,48,245,141,111,30
48,457,48,361,93,0,93
48,457,48,373,111,0,111
48,459,48,63,126,76,50
48,459,48,113,112,76,36
48,459,48,121,0,52,-52
48,459,48,183,1438,1391,47
48,459,48,201,79,0,79
48,459,48,203,220,259,-39
48,459,48,315,91,0,91
48,459,48,343,0,67,-67
48,459,48,401,100,100,0
48,459,48,423,287,229,58
48,459,48,439,95,55,40
48,459,48,499,193,157,36
48,463,48,29,245,370,-125
48,463,48,323,0,69,-69
48,463,48,325,58,84,-26
48,463,48,507,136,72,64
48,465,8,41,73,0,73
48,465,48,29,471,561,-90
48,465,48,113,73,0,73
48,465,48,201,64,72,-8
48,465,48,323,148,129,19
48,465,48,329,69,0,69
48,465,48,439,94,68,26
48,465,48,451,118,151,-33
48,465,48,453,59,81,-22
48,467,48,85,142,99,43
48,467,48,113,852,424,428
48,467,48,121,140,70,70
48,467,48,139,0,68,-68
48,467,48,213,422,344,78
48,467,48,231,231,182,49
48,467,48,257,900,497,403
48,467,48,397,98,93,5
48,467,48,423,570,529,41
48,467,48,439,244,151,93
48,467,48,453,62,0,62
48,467,48,499,109,215,-106
48,469,48,7,68,0,68
48,469,48,25,68,0,68
48,469,48,27,0,74,-74
48,469,48,29,217,396,-179
48,469,48,39,114,144,-30
48,469,48,41,0,62,-62
48,469,48,57,431,314,117
48,469,48,91,0,83,-83
48,469,48,113,0,74,-74
48,469,48,123,334,350,-16
48,469,48,157,106,192,-86
48,469,48,175,209,243,-34
48,469,48,187,0,68,-68
48,469,48,201,361,528,-167
48,469,48,209,0,69,-69
48,469,48,215,78,72,6
48,469,48,239,344,272,72
48,469,48,285,113,115,-2
48,469,48,321,89,0,89
48,469,48,339,0,54,-54
48,469,48,355,247,268,-21
48,469,48,391,0,63,-63
48,469,48,409,73,66,7
48,469,48,439,0,70,-70
48,469,48,453,121,265,-144
48,469,48,481,95,71,24
48,469,48,491,59,108,-49
48,471,48,29,0,79,-79
48,471,48,39,0,80,-80
48,471,48,41,132,229,-97
48,471,48,113,104,123,-19
48,471,48,157,87,108,-21
48,471,48,167,67,87,-20
48,471,48,185,63,65,-2
48,471,48,201,1019,1116,-97
48,471,48,225,76,89,-13
48,471,48,313,103,79,24
48,471,48,339,1067,1515,-448
48,471,48,373,67,64,3
48,471,48,407,158,212,-54
48,471,48,439,74,82,-8
48,471,48,453,0,83,-83
48,471,48,455,253,180,73
48,471,48,491,0,66,-66
48,473,48,15,155,264,-109
48,473,48,39,63,0,63
48,473,48,41,73,113,-40
48,473,48,113,0,51,-51
48,473,48,157,679,260,419
48,473,48,185,61,108,-47
48,473,48,201,3787,2364,1423
48,473,48,339,449,369,80
48,473,48,453,0,58,-58
48,473,48,477,0,108,-108
48,475,48,135,138,175,-37
48,475,48,329,73,130,-57
48,477,48,15,203,120,83
48,477,48,41,163,250,-87
48,477,48,51,107,87,20
48,477,48,149,66,0,66
48,477,48,157,107,56,51
48,477,48,201,706,418,288
48,477,48,287,62,0,62
48,477,48,339,77,111,-34
48,477,48,453,53,73,-20
48,477,48,473,108,0,108
48,479,6,37,56,69,-13
48,479,6,73,56,67,-11
48,479,12,95,0,84,-84
48,479,17,31,0,63,-63
48,479,48,29,995,2123,-1128
48,479,48,61,195,181,14
48,479,48,91,0,60,-60
48,479,48,113,264,355,-91
48,479,48,141,66,77,-11
48,479,48,157,0,75,-75
48,479,48,201,371,510,-139
48,479,48,209,56,98,-42
48,479,48,215,332,489,-157
48,479,48,323,104,0,104
48,479,48,339,0,77,-77
48,479,48,355,168,158,10
48,479,48,439,98,165,-67
48,479,48,453,202,362,-160
48,479,48,491,0,155,-155
48,479,48,505,148,146,2
48,479,53,5,109,0,109
48,479,53,77,420,0,420
48,481,48,29,60,0,60
48,481,48,39,111,161,-50
48,481,48,89,56,78,-22
48,481,48,157,624,575,49
48,481,48,201,374,438,-64
48,481,48,321,203,192,11
48,481,48,469,71,95,-24
48,485,4,13,72,135,-63
48,485,4,19,65,128,-63
48,485,6,37,77,0,77
48,485,8,41,82,79,3
48,485,12,91,0,114,-114
48,485,32,3,125,108,17
48,485,35,35,0,67,-67
48,485,37,191,0,69,-69
48,485,40,31,143,199,-56
48,485,40,109,132,155,-23
48,485,48,9,330,455,-125
48,485,48,23,58,0,58
48,485,48,27,0,81,-81
48,485,48,29,160,198,-38
48,485,48,77,390,492,-102
48,485,48,85,136,181,-45
48,485,48,113,345,374,-29
48,485,48,121,172,311,-139
48,485,48,141,68,0,68
48,485,48,181,0,71,-71
48,485,48,201,136,155,-19
48,485,48,303,102,106,-4
48,485,48,329,0,57,-57
48,485,48,337,126,90,36
48,485,48,367,81,84,-3
48,485,48,381,57,0,57
48,485,48,439,537,600,-63
48,485,48,441,141,125,16
48,485,48,453,74,170,-96
48,485,48,487,205,135,70
48,485,48,491,0,62,-62
48,485,48,503,115,69,46
48,487,48,197,70,0,70
48,487,48,485,135,205,-70
48,489,48,29,0,65,-65
48,489,48,61,250,368,-118
48,489,48,215,193,202,-9
48,491,2,20,70,0,70
48,491,4,13,548,411,137
48,491,4,19,116,66,50
48,491,4,21,52,0,52
48,491,6,1,392,91,301
48,491,6,13,198,0,198
48,491,6,29,74,0,74
48,491,6,37,992,317,675
48,491,6,59,601,200,401
48,491,6,61,74,0,74
48,491,6,65,328,71,257
48,491,6,67,153,79,74
48,491,6,71,245,80,165
48,491,6,73,749,257,492
48,491,6,77,93,0,93
48,491,6,81,154,0,154
48,491,6,85,825,265,560
48,491,6,111,192,0,192
48,491,8,1,76,0,76
48,491,8,5,103,73,30
48,491,8,31,97,91,6
48,491,8,35,90,114,-24
48,491,8,41,186,160,26
48,491,8,59,76,100,-24
48,491,8,69,63,74,-11
48,491,9,1,52,0,52
48,491,9,3,80,0,80
48,491,12,9,64,0,64
48,491,12,11,193,91,102
48,491,12,31,71,0,71
48,491,12,57,89,97,-8
48,491,12,81,62,0,62
48,491,12,86,217,59,158
48,491,12,95,136,88,48
48,491,12,99,143,74,69
48,491,12,103,57,71,-14
48,491,13,67,80,0,80
48,491,13,121,66,0,66
48,491,15,3,203,77,126
48,491,17,31,438,147,291
48,491,17,43,144,0,144
48,491,17,89,68,0,68
48,491,17,97,96,0,96
48,491,17,197,76,0,76
48,491,18,57,80,0,80
48,491,20,91,98,82,16
48,491,22,33,79,0,79
48,491,24,31,104,0,104
48,491,25,17,111,69,42
48,491,26,163,57,0,57
48,491,27,53,128,68,60
48,491,29,189,95,0,95
48,491,31,55,81,0,81
48,491,32,3,272,132,140
48,491,32,31,103,67,36
48,491,33,11,82,0,82
48,491,34,3,73,0,73
48,491,34,17,68,0,68
48,491,34,23,97,0,97
48,491,35,1,153,86,67
48,491,36,47,97,0,97
48,491,36,59,80,0,80
48,491,36,61,60,60,0
48,491,36,81,137,0,137
48,491,36,103,75,0,75
48,491,36,119,77,0,77
48,491,37,119,100,104,-4
48,491,37,183,100,127,-27
48,491,39,49,105,0,105
48,491,40,109,110,95,15
48,491,40,143,59,90,-31
48,491,41,51,82,0,82
48,491,41,67,133,73,60
48,491,42,3,75,0,75
48,491,47,37,90,62,28
48,491,47,157,94,71,23
48,491,48,7,68,0,68
48,491,48,21,686,838,-152
48,491,48,27,2376,2538,-162
48,491,48,29,1479,1173,306
48,491,48,39,227,103,124
48,491,48,41,414,267,147
48,491,48,49,0,81,-81
48,491,48,53,579,895,-316
48,491,48,55,130,185,-55
48,491,48,61,240,181,59
48,491,48,85,714,635,79
48,491,48,91,215,338,-123
48,491,48,99,303,234,69
48,491,48,113,962,785,177
48,491,48,121,530,472,58
48,491,48,135,160,54,106
48,491,48,139,76,57,19
48,491,48,141,391,280,111
48,491,48,157,446,275,171
48,491,48,167,231,168,63
48,491,48,171,0,75,-75
48,491,48,183,94,0,94
48,491,48,187,189,196,-7
48,491,48,201,2270,1324,946
48,491,48,209,1312,1084,228
48,491,48,213,0,70,-70
48,491,48,215,326,148,178
48,491,48,245,175,60,115
48,491,48,251,58,0,58
48,491,48,257,76,0,76
48,491,48,259,63,0,63
48,491,48,265,86,71,15
48,491,48,281,119,220,-101
48,491,48,287,120,174,-54
48,491,48,299,125,185,-60
48,491,48,303,282,248,34
48,491,48,309,367,310,57
48,491,48,329,217,98,119
48,491,48,331,279,438,-159
48,491,48,339,430,312,118
48,491,48,347,64,0,64
48,491,48,355,439,279,160
48,491,48,367,62,83,-21
48,491,48,373,0,93,-93
48,491,48,381,108,0,108
48,491,48,423,196,134,62
48,491,48,439,895,789,106
48,491,48,441,139,87,52
48,491,48,451,190,70,120
48,491,48,453,31165,21471,9694
48,491,48,469,108,59,49
48,491,48,471,66,0,66
48,491,48,479,155,0,155
48,491,48,485,62,0,62
48,491,49,35,152,0,152
48,491,49,49,135,86,49
48,491,51,59,162,102,60
48,491,51,107,84,0,84
48,491,53,33,443,291,152
48,491,53,53,162,77,85
48,491,53,61,174,0,174
48,493,48,13,82,82,0
48,493,48,29,2157,1569,588
48,493,48,91,165,108,57
48,493,48,187,388,341,47
48,493,48,201,0,68,-68
48,493,48,255,117,76,41
48,493,48,355,71,87,-16
48,493,48,453,55,0,55
48,495,48,135,65,106,-41
48,495,48,329,65,72,-7
48,497,48,85,90,91,-1
48,497,48,113,241,144,97
48,497,48,121,1373,643,730
48,497,48,237,0,82,-82
48,497,48,251,77,82,-5
48,497,48,329,0,82,-82
48,497,48,337,174,311,-137
48,497,48,367,588,541,47
48,497,48,439,2888,1474,1414
48,499,48,85,197,95,102
48,499,48,113,341,122,219
48,499,48,121,123,72,51
48,499,48,159,170,119,51
48,499,48,183,87,142,-55
48,499,48,201,80,0,80
48,499,48,223,338,293,45
48,499,48,231,81,75,6
48,499,48,257,65,0,65
48,499,48,379,122,89,33
48,499,48,423,598,641,-43
48,499,48,439,286,106,180
48,499,48,459,157,193,-36
48,499,48,467,215,109,106
48,501,48,165,152,169,-17
48,501,48,303,0,111,-111
48,503,48,237,85,0,85
48,503,48,367,80,0,80
48,503,48,439,111,78,33
48,503,48,485,69,115,-46
48,505,48,479,146,148,-2
48,507,48,29,103,94,9
48,507,48,127,79,119,-40
48,507,48,463,72,136,-64
49,1,4,15,122,0,122
49,1,49,21,81,100,-19
49,1,49,53,110,0,110
49,3,16,71,0,98,-98
49,3,49,5,580,568,12
49,3,49,11,669,437,232
49,3,49,35,379,313,66
49,3,49,49,184,201,-17
49,3,49,53,0,69,-69
49,3,49,57,1490,1066,424
49,5,4,13,180,210,-30
49,5,6,37,97,85,12
49,5,6,73,74,0,74
49,5,16,1,71,148,-77
49,5,16,5,123,108,15
49,5,16,19,84,148,-64
49,5,16,41,352,392,-40
49,5,16,65,90,0,90
49,5,16,83,60,0,60
49,5,32,3,161,120,41
49,5,49,3,568,580,-12
49,5,49,11,717,861,-144
49,5,49,21,0,96,-96
49,5,49,35,1002,1374,-372
49,5,49,39,76,0,76
49,5,49,45,116,116,0
49,5,49,49,726,782,-56
49,5,49,53,222,389,-167
49,5,49,57,452,641,-189
49,5,53,33,0,52,-52
49,7,49,15,118,96,22
49,7,49,35,316,185,131
49,7,49,49,182,155,27
49,11,2,20,58,0,58
49,11,2,90,84,0,84
49,11,4,13,533,582,-49
49,11,4,19,113,113,0
49,11,6,29,92,0,92
49,11,6,37,400,148,252
49,11,6,59,173,90,83
49,11,6,65,147,91,56
49,11,6,67,80,64,16
49,11,6,71,148,0,148
49,11,6,73,211,156,55
49,11,6,85,96,0,96
49,11,6,111,74,0,74
49,11,8,5,99,0,99
49,11,8,41,125,99,26
49,11,8,59,0,54,-54
49,11,12,91,124,0,124
49,11,15,3,183,105,78
49,11,16,1,132,190,-58
49,11,16,5,77,136,-59
49,11,16,19,167,135,32
49,11,16,27,0,90,-90
49,11,16,65,216,77,139
49,11,32,3,387,469,-82
49,11,32,31,78,0,78
49,11,35,1,91,0,91
49,11,48,29,115,211,-96
49,11,48,85,0,85,-85
49,11,48,201,104,0,104
49,11,48,439,83,81,2
49,11,49,3,437,669,-232
49,11,49,5,861,717,144
49,11,49,21,89,103,-14
49,11,49,29,251,369,-118
49,11,49,35,8722,7018,1704
49,11,49,39,0,91,-91
49,11,49,43,108,120,-12
49,11,49,45,349,376,-27
49,11,49,49,1964,2020,-56
49,11,49,51,97,119,-22
49,11,49,53,452,647,-195
49,11,49,57,6973,8578,-1605
49,11,51,59,111,0,111
49,11,53,33,87,131,-44
49,11,53,53,110,103,7
49,11,53,61,82,0,82
49,11,53,63,76,91,-15
49,13,49,35,221,150,71
49,13,49,47,355,429,-74
49,13,49,49,188,137,51
49,15,49,7,96,118,-22
49,15,49,35,75,0,75
49,15,49,49,0,81,-81
49,17,49,21,0,76,-76
49,19,8,77,0,69,-69
49,19,49,35,114,79,35
49,19,49,37,0,113,-113
49,21,4,13,82,76,6
49,21,4,15,369,0,369
49,21,6,37,161,0,161
49,21,6,59,90,0,90
49,21,6,65,146,0,146
49,21,6,71,116,0,116
49,21,6,73,92,0,92
49,21,32,3,529,364,165
49,21,49,1,100,81,19
49,21,49,5,96,0,96
49,21,49,11,103,89,14
49,21,49,17,76,0,76
49,21,49,35,340,355,-15
49,21,49,39,79,0,79
49,21,49,41,72,0,72
49,21,49,45,64,0,64
49,21,49,49,312,222,90
49,21,49,53,1164,828,336
49,23,49,35,64,119,-55
49,23,49,39,86,0,86
49,23,49,49,671,401,270
49,25,4,5,70,62,8
49,25,49,53,85,120,-35
49,27,49,35,85,78,7
49,27,49,49,184,139,45
49,27,49,53,64,67,-3
49,29,49,11,369,251,118
49,29,49,35,98,123,-25
49,29,49,57,256,232,24
49,35,2,20,184,112,72
49,35,4,5,74,77,-3
49,35,4,13,1605,1818,-213
49,35,4,15,107,157,-50
49,35,4,17,0,68,-68
49,35,4,19,270,267,3
49,35,4,21,91,143,-52
49,35,4,25,92,71,21
49,35,6,1,371,252,119
49,35,6,13,294,104,190
49,35,6,19,102,111,-9
49,35,6,29,151,84,67
49,35,6,37,1625,1056,569
49,35,6,53,113,0,113
49,35,6,59,1005,589,416
49,35,6,61,66,79,-13
49,35,6,65,553,282,271
49,35,6,67,270,264,6
49,35,6,71,502,252,250
49,35,6,73,881,770,111
49,35,6,75,192,186,6
49,35,6,77,97,71,26
49,35,6,79,57,0,57
49,35,6,81,208,152,56
49,35,6,83,75,0,75
49,35,6,85,451,340,111
49,35,6,95,84,0,84
49,35,6,97,90,0,90
49,35,6,111,189,151,38
49,35,8,1,115,155,-40
49,35,8,5,286,233,53
49,35,8,13,140,136,4
49,35,8,31,262,304,-42
49,35,8,35,154,187,-33
49,35,8,41,278,229,49
49,35,8,59,228,154,74
49,35,8,69,108,135,-27
49,35,8,77,141,116,25
49,35,8,123,0,63,-63
49,35,9,1,77,0,77
49,35,9,3,83,0,83
49,35,9,9,81,79,2
49,35,11,1,77,86,-9
49,35,12,1,63,0,63
49,35,12,9,69,68,1
49,35,12,11,148,126,22
49,35,12,31,79,81,-2
49,35,12,57,139,110,29
49,35,12,71,54,0,54
49,35,12,86,186,102,84
49,35,12,95,163,160,3
49,35,12,99,86,77,9
49,35,12,103,72,131,-59
49,35,13,67,101,70,31
49,35,13,89,55,47,8
49,35,13,121,136,109,27
49,35,15,1,95,61,34
49,35,15,3,501,304,197
49,35,15,9,73,48,25
49,35,16,1,499,574,-75
49,35,16,5,253,331,-78
49,35,16,11,67,102,-35
49,35,16,19,346,288,58
49,35,16,27,131,234,-103
49,35,16,51,81,77,4
49,35,16,55,0,93,-93
49,35,16,65,443,191,252
49,35,16,83,133,127,6
49,35,17,31,472,355,117
49,35,17,43,77,56,21
49,35,17,97,80,56,24
49,35,17,197,73,0,73
49,35,18,97,87,84,3
49,35,20,91,105,0,105
49,35,20,173,52,0,52
49,35,21,111,58,0,58
49,35,24,3,60,0,60
49,35,24,5,72,60,12
49,35,24,31,114,103,11
49,35,25,9,45,0,45
49,35,25,17,177,149,28
49,35,25,25,95,89,6
49,35,26,81,54,0,54
49,35,26,125,81,89,-8
49,35,26,161,55,0,55
49,35,26,163,77,0,77
49,35,27,37,51,0,51
49,35,27,53,173,159,14
49,35,27,123,69,0,69
49,35,29,95,73,74,-1
49,35,29,189,97,79,18
49,35,30,29,68,57,11
49,35,30,31,82,77,5
49,35,30,49,61,0,61
49,35,30,63,77,71,6
49,35,30,111,86,67,19
49,35,31,55,121,91,30
49,35,32,3,1397,1616,-219
49,35,32,7,214,158,56
49,35,32,31,214,246,-32
49,35,34,17,73,90,-17
49,35,35,1,192,123,69
49,35,35,45,57,0,57
49,35,36,29,61,0,61
49,35,36,47,108,125,-17
49,35,36,61,177,239,-62
49,35,36,81,87,66,21
49,35,36,103,55,0,55
49,35,37,63,0,54,-54
49,35,37,119,107,129,-22
49,35,37,183,130,103,27
49,35,39,35,86,83,3
49,35,39,49,139,157,-18
49,35,39,61,79,0,79
49,35,39,153,57,0,57
49,35,40,109,93,69,24
49,35,40,143,59,76,-17
49,35,41,5,127,149,-22
49,35,41,17,83,85,-2
49,35,41,29,0,100,-100
49,35,41,39,113,162,-49
49,35,41,47,0,72,-72
49,35,41,51,272,357,-85
49,35,41,67,232,240,-8
49,35,42,3,108,128,-20
49,35,42,101,68,50,18
49,35,45,19,65,0,65
49,35,47,37,81,119,-38
49,35,47,93,71,0,71
49,35,47,157,61,0,61
49,35,48,29,247,278,-31
49,35,48,85,181,190,-9
49,35,48,113,312,335,-23
49,35,48,121,144,157,-13
49,35,48,141,138,78,60
49,35,48,201,435,353,82
49,35,48,339,73,103,-30
49,35,48,439,218,252,-34
49,35,48,453,289,303,-14
49,35,48,491,0,152,-152
49,35,49,3,313,379,-66
49,35,49,5,1374,1002,372
49,35,49,7,185,316,-131
49,35,49,11,7018,8722,-1704
49,35,49,13,150,221,-71
49,35,49,15,0,75,-75
49,35,49,19,79,114,-35
49,35,49,21,355,340,15
49,35,49,23,119,64,55
49,35,49,27,78,85,-7
49,35,49,29,123,98,25
49,35,49,37,93,85,8
49,35,49,39,221,376,-155
49,35,49,41,183,163,20
49,35,49,43,1331,1214,117
49,35,49,45,2038,4670,-2632
49,35,49,47,238,276,-38
49,35,49,49,12786,13016,-230
49,35,49,51,576,800,-224
49,35,49,53,1623,2314,-691
49,35,49,57,2021,2587,-566
49,35,50,7,49,0,49
49,35,51,13,46,66,-20
49,35,51,59,148,118,30
49,35,53,5,0,106,-106
49,35,53,11,180,210,-30
49,35,53,33,802,804,-2
49,35,53,35,55,81,-26
49,35,53,53,246,294,-48
49,35,53,61,237,243,-6
49,35,53,63,166,198,-32
49,35,53,67,0,91,-91
49,35,53,73,0,84,-84
49,35,53,77,0,66,-66
49,35,55,25,74,69,5
49,35,55,79,88,75,13
49,35,56,1,65,0,65
49,35,56,23,0,84,-84
49,35,56,37,171,100,71
49,35,56,39,95,57,38
49,35,56,41,136,97,39
49,37,4,1,123,102,21
49,37,35,45,173,71,102
49,37,49,19,113,0,113
49,37,49,35,85,93,-8
49,37,49,49,83,70,13
49,39,49,5,0,76,-76
49,39,49,11,91,0,91
49,39,49,21,0,79,-79
49,39,49,23,0,86,-86
49,39,49,35,376,221,155
49,39,49,41,96,103,-7
49,39,49,49,687,510,177
49,39,49,53,107,130,-23
49,41,49,21,0,72,-72
49,41,49,35,163,183,-20
49,41,49,39,103,96,7
49,41,49,49,291,213,78
49,41,49,53,95,178,-83
49,43,4,13,0,76,-76
49,43,6,37,98,49,49
49,43,6,59,95,0,95
49,43,6,73,93,78,15
49,43,6,75,67,0,67
49,43,32,3,69,71,-2
49,43,49,11,120,108,12
49,43,49,35,1214,1331,-117
49,43,49,49,208,153,55
49,43,49,51,478,922,-444
49,43,49,53,0,87,-87
49,43,53,33,56,55,1
49,45,4,13,0,99,-99
49,45,32,3,68,87,-19
49,45,32,7,137,200,-63
49,45,49,5,116,116,0
49,45,49,11,376,349,27
49,45,49,21,0,64,-64
49,45,49,35,4670,2038,2632
49,45,49,49,526,440,86
49,45,49,53,99,193,-94
49,45,49,57,139,142,-3
49,47,49,13,429,355,74
49,47,49,35,276,238,38
49,47,49,49,198,232,-34
49,47,49,53,0,93,-93
49,49,2,20,76,0,76
49,49,4,13,1090,1489,-399
49,49,4,15,0,68,-68
49,49,4,19,130,189,-59
49,49,4,21,104,130,-26
49,49,4,25,70,0,70
49,49,6,1,154,93,61
49,49,6,13,176,107,69
49,49,6,19,61,0,61
49,49,6,29,93,0,93
49,49,6,37,850,473,377
49,49,6,59,628,320,308
49,49,6,61,132,74,58
49,49,6,65,482,211,271
49,49,6,67,215,118,97
49,49,6,71,328,139,189
49,49,6,73,468,392,76
49,49,6,75,0,70,-70
49,49,6,79,75,0,75
49,49,6,81,91,58,33
49,49,6,85,257,222,35
49,49,6,111,158,68,90
49,49,8,5,156,114,42
49,49,8,31,65,68,-3
49,49,8,35,180,122,58
49,49,8,41,168,170,-2
49,49,8,59,90,0,90
49,49,8,69,72,0,72
49,49,8,77,88,0,88
49,49,12,11,71,0,71
49,49,12,95,0,112,-112
49,49,15,3,405,279,126
49,49,16,1,331,444,-113
49,49,16,5,110,136,-26
49,49,16,19,291,326,-35
49,49,16,27,107,132,-25
49,49,16,51,73,0,73
49,49,16,65,591,285,306
49,49,16,83,72,0,72
49,49,17,31,88,108,-20
49,49,25,17,110,105,5
49,49,27,53,0,73,-73
49,49,32,3,721,816,-95
49,49,32,7,73,0,73
49,49,32,31,93,77,16
49,49,35,1,83,97,-14
49,49,36,61,68,122,-54
49,49,37,119,84,0,84
49,49,37,183,87,92,-5
49,49,39,49,0,71,-71
49,49,41,5,99,0,99
49,49,41,51,69,106,-37
49,49,41,67,167,159,8
49,49,48,29,138,187,-49
49,49,48,85,159,141,18
49,49,48,113,103,173,-70
49,49,48,121,104,177,-73
49,49,48,141,70,0,70
49,49,48,201,272,241,31
49,49,48,303,0,72,-72
49,49,48,339,0,70,-70
49,49,48,439,133,181,-48
49,49,48,453,59,145,-86
49,49,48,491,86,135,-49
49,49,49,3,201,184,17
49,49,49,5,782,726,56
49,49,49,7,155,182,-27
49,49,49,11,2020,1964,56
49,49,49,13,137,188,-51
49,49,49,15,81,0,81
49,49,49,21,222,312,-90
49,49,49,23,401,671,-270
49,49,49,27,139,184,-45
49,49,49,35,13016,12786,230
49,49,49,37,70,83,-13
49,49,49,39,510,687,-177
49,49,49,41,213,291,-78
49,49,49,43,153,208,-55
49,49,49,45,440,526,-86
49,49,49,47,232,198,34
49,49,49,51,495,501,-6
49,49,49,53,1177,1789,-612
49,49,49,57,612,712,-100
49,49,51,13,0,52,-52
49,49,51,59,100,138,-38
49,49,53,5,77,0,77
49,49,53,11,104,100,4
49,49,53,33,374,449,-75
49,49,53,53,123,132,-9
49,49,53,61,171,131,40
49,49,53,63,93,149,-56
49,49,56,37,69,0,69
49,51,6,37,71,0,71
49,51,32,3,89,0,89
49,51,49,11,119,97,22
49,51,49,35,800,576,224
49,51,49,43,922,478,444
49,51,49,49,501,495,6
49,51,49,53,83,0,83
49,51,49,57,0,83,-83
49,53,4,5,113,63,50
49,53,4,13,350,402,-52
49,53,4,15,549,301,248
49,53,4,25,0,59,-59
49,53,6,1,62,0,62
49,53,6,29,75,0,75
49,53,6,37,399,142,257
49,53,6,59,339,56,283
49,53,6,65,414,97,317
49,53,6,67,91,0,91
49,53,6,71,239,54,185
49,53,6,73,267,83,184
49,53,6,111,61,0,61
49,53,8,35,68,0,68
49,53,8,69,58,0,58
49,53,15,3,80,0,80
49,53,16,1,0,108,-108
49,53,16,19,97,90,7
49,53,32,3,1237,947,290
49,53,49,1,0,110,-110
49,53,49,3,69,0,69
49,53,49,5,389,222,167
49,53,49,11,647,452,195
49,53,49,21,828,1164,-336
49,53,49,25,120,85,35
49,53,49,27,67,64,3
49,53,49,35,2314,1623,691
49,53,49,39,130,107,23
49,53,49,41,178,95,83
49,53,49,43,87,0,87
49,53,49,45,193,99,94
49,53,49,47,93,0,93
49,53,49,49,1789,1177,612
49,53,49,51,0,83,-83
49,53,49,57,342,220,122
49,53,53,33,88,0,88
49,53,53,53,77,0,77
49,57,4,13,268,371,-103
49,57,4,19,100,63,37
49,57,6,37,255,149,106
49,57,6,59,109,0,109
49,57,6,65,81,53,28
49,57,6,67,66,0,66
49,57,6,71,97,0,97
49,57,6,73,151,74,77
49,57,8,41,92,79,13
49,57,15,3,73,0,73
49,57,16,1,111,79,32
49,57,16,5,66,71,-5
49,57,16,19,114,83,31
49,57,16,65,97,0,97
49,57,32,3,262,352,-90
49,57,48,29,79,0,79
49,57,48,439,68,0,68
49,57,49,3,1066,1490,-424
49,57,49,5,641,452,189
49,57,49,11,8578,6973,1605
49,57,49,29,232,256,-24
49,57,49,35,2587,2021,566
49,57,49,45,142,139,3
49,57,49,49,712,612,100
49,57,49,51,83,0,83
49,57,49,53,220,342,-122
49,57,53,33,102,70,32
49,57,53,53,103,0,103
50,1,36,31,53,70,-17
50,1,50,7,783,719,64
50,1,50,11,50,75,-25
50,1,50,21,321,369,-48
50,1,50,23,107,107,0
50,1,50,27,0,82,-82
50,3,25,3,157,143,14
50,3,36,83,148,166,-18
50,3,36,115,0,97,-97
50,3,50,7,0,103,-103
50,3,50,21,103,164,-61
50,3,50,25,190,123,67
50,3,50,27,0,57,-57
50,5,33,9,113,127,-14
50,5,50,7,88,101,-13
50,5,50,9,129,122,7
50,5,50,15,111,81,30
50,5,50,17,124,87,37
50,5,50,19,181,217,-36
50,5,50,23,141,146,-5
50,7,4,13,78,99,-21
50,7,6,37,89,97,-8
50,7,6,73,0,68,-68
50,7,8,31,68,68,0
50,7,9,1,77,0,77
50,7,9,3,75,61,14
50,7,9,9,73,0,73
50,7,11,1,58,70,-12
50,7,12,11,0,57,-57
50,7,12,71,0,70,-70
50,7,12,99,0,59,-59
50,7,12,103,0,64,-64
50,7,17,31,58,77,-19
50,7,23,5,52,123,-71
50,7,23,31,0,65,-65
50,7,25,9,100,88,12
50,7,25,15,45,0,45
50,7,25,17,247,218,29
50,7,25,21,74,85,-11
50,7,25,23,0,82,-82
50,7,25,25,140,158,-18
50,7,25,27,82,69,13
50,7,33,9,79,72,7
50,7,33,11,85,91,-6
50,7,33,13,54,55,-1
50,7,33,15,0,76,-76
50,7,36,1,0,45,-45
50,7,36,19,100,106,-6
50,7,36,29,46,0,46
50,7,36,31,58,0,58
50,7,36,47,123,70,53
50,7,36,55,0,51,-51
50,7,36,61,89,91,-2
50,7,36,103,47,0,47
50,7,37,183,0,58,-58
50,7,39,49,0,127,-127
50,7,41,51,52,71,-19
50,7,42,101,0,47,-47
50,7,44,7,54,0,54
50,7,48,453,0,43,-43
50,7,49,35,0,49,-49
50,7,50,1,719,783,-64
50,7,50,3,103,0,103
50,7,50,5,101,88,13
50,7,50,11,1046,1543,-497
50,7,50,13,233,427,-194
50,7,50,15,357,402,-45
50,7,50,17,86,88,-2
50,7,50,19,99,93,6
50,7,50,21,210,156,54
50,7,50,23,636,717,-81
50,7,50,25,87,58,29
50,7,50,27,177,109,68
50,7,53,33,109,101,8
50,9,33,7,125,72,53
50,9,33,9,57,0,57
50,9,50,5,122,129,-7
50,9,50,19,65,75,-10
50,11,36,19,0,100,-100
50,11,50,1,75,50,25
50,11,50,7,1543,1046,497
50,11,50,13,172,173,-1
50,11,50,15,164,161,3
50,11,50,19,65,63,2
50,11,50,23,74,58,16
50,13,50,7,427,233,194
50,13,50,11,173,172,1
50,15,50,5,81,111,-30
50,15,50,7,402,357,45
50,15,50,11,161,164,-3
50,15,50,19,144,115,29
50,15,50,23,198,197,1
50,17,33,9,241,223,18
50,17,50,5,87,124,-37
50,17,50,7,88,86,2
50,17,50,23,615,527,88
50,17,50,27,415,382,33
50,19,50,5,217,181,36
50,19,50,7,93,99,-6
50,19,50,9,75,65,10
50,19,50,11,63,65,-2
50,19,50,15,115,144,-29
50,19,50,23,87,74,13
50,21,36,91,0,51,-51
50,21,36,115,138,175,-37
50,21,50,1,369,321,48
50,21,50,3,164,103,61
50,21,50,7,156,210,-54
50,21,50,23,0,60,-60
50,21,50,25,0,66,-66
50,21,50,27,219,218,1
50,23,25,17,65,52,13
50,23,50,1,107,107,0
50,23,50,5,146,141,5
50,23,50,7,717,636,81
50,23,50,11,58,74,-16
50,23,50,15,197,198,-1
50,23,50,17,527,615,-88
50,23,50,19,74,87,-13
50,23,50,21,60,0,60
50,23,50,27,108,73,35
50,25,9,1,57,0,57
50,25,9,3,71,0,71
50,25,25,11,116,143,-27
50,25,25,13,68,0,68
50,25,25,15,62,47,15
50,25,25,17,0,53,-53
50,25,25,27,77,0,77
50,25,33,5,269,411,-142
50,25,33,19,83,82,1
50,25,50,3,123,190,-67
50,25,50,7,58,87,-29
50,25,50,21,66,0,66
50,25,50,27,225,285,-60
50,27,25,17,74,54,20
50,27,25,21,53,0,53
50,27,25,25,54,0,54
50,27,33,5,85,84,1
50,27,33,9,605,596,9
50,27,33,13,0,58,-58
50,27,33,19,326,338,-12
50,27,50,1,82,0,82
50,27,50,3,57,0,57
50,27,50,7,109,177,-68
50,27,50,17,382,415,-33
50,27,50,21,218,219,-1
50,27,50,23,73,108,-35
50,27,50,25,285,225,60
51,1,10,5,0,104,-104
51,1,24,45,102,175,-73
51,1,24,47,126,178,-52
51,1,51,131,261,217,44
51,1,51,810,62,61,1
51,3,6,37,77,76,1
51,3,11,1,119,107,12
51,3,13,121,0,62,-62
51,3,17,31,71,59,12
51,3,24,31,72,100,-28
51,3,25,17,65,0,65
51,3,36,61,96,102,-6
51,3,37,119,50,83,-33
51,3,37,183,92,0,92
51,3,47,37,50,0,50
51,3,51,13,130,72,58
51,3,51,15,173,157,16
51,3,51,29,107,136,-29
51,3,51,41,87,148,-61
51,3,51,59,361,241,120
51,3,51,65,571,724,-153
51,3,51,79,402,540,-138
51,3,51,87,154,202,-48
51,3,51,95,58,0,58
51,3,51,107,136,81,55
51,3,51,109,255,365,-110
51,3,51,113,61,0,61
51,3,51,121,53,0,53
51,3,51,125,207,209,-2
51,3,51,137,197,190,7
51,3,51,153,78,90,-12
51,3,51,165,72,56,16
51,3,51,510,61,68,-7
51,3,51,540,2616,2067,549
51,3,51,660,53,0,53
51,3,51,680,0,59,-59
51,3,51,710,58,51,7
51,3,51,760,114,214,-100
51,3,51,790,59,67,-8
51,3,51,810,103,0,103
51,3,51,820,203,278,-75
51,3,53,33,0,54,-54
51,5,51,23,75,85,-10
51,5,51,580,338,298,40
51,5,51,770,0,54,-54
51,7,51,41,376,318,58
51,7,51,135,0,69,-69
51,7,51,145,107,70,37
51,7,51,760,0,70,-70
51,9,51,11,80,77,3
51,9,51,19,156,226,-70
51,9,51,31,276,332,-56
51,9,51,125,108,101,7
51,9,51,680,647,599,48
51,11,51,9,77,80,-3
51,11,51,19,0,63,-63
51,11,51,31,228,212,16
51,11,51,147,0,72,-72
51,11,51,680,184,202,-18
51,13,1,89,49,0,49
51,13,4,13,175,173,2
51,13,6,1,81,130,-49
51,13,6,13,47,58,-11
51,13,6,37,418,529,-111
51,13,6,53,63,0,63
51,13,6,59,155,115,40
51,13,6,65,0,49,-49
51,13,6,73,331,361,-30
51,13,6,75,92,196,-104
51,13,6,81,0,84,-84
51,13,6,85,114,148,-34
51,13,8,13,0,77,-77
51,13,8,31,64,231,-167
51,13,8,41,118,89,29
51,13,8,59,0,80,-80
51,13,9,1,92,95,-3
51,13,9,3,63,0,63
51,13,9,9,43,53,-10
51,13,10,3,54,54,0
51,13,10,5,0,56,-56
51,13,11,1,4374,5509,-1135
51,13,12,9,53,0,53
51,13,12,11,152,131,21
51,13,12,31,66,94,-28
51,13,12,57,163,130,33
51,13,12,71,0,62,-62
51,13,12,86,191,193,-2
51,13,12,95,116,117,-1
51,13,12,99,66,128,-62
51,13,12,103,70,91,-21
51,13,13,67,51,51,0
51,13,13,89,68,56,12
51,13,13,121,130,175,-45
51,13,15,3,162,156,6
51,13,17,31,276,396,-120
51,13,18,97,60,0,60
51,13,21,111,0,53,-53
51,13,24,3,269,301,-32
51,13,24,5,146,92,54
51,13,24,9,0,67,-67
51,13,24,17,103,50,53
51,13,24,21,87,96,-9
51,13,24,27,186,149,37
51,13,24,31,1914,1671,243
51,13,24,33,852,1104,-252
51,13,24,37,52,0,52
51,13,24,510,194,197,-3
51,13,25,17,308,218,90
51,13,25,21,103,75,28
51,13,25,25,170,172,-2
51,13,25,27,50,0,50
51,13,26,125,56,69,-13
51,13,26,161,56,0,56
51,13,27,53,69,88,-19
51,13,32,3,115,110,5
51,13,34,3,62,46,16
51,13,34,13,70,0,70
51,13,34,17,101,137,-36
51,13,34,23,47,54,-7
51,13,34,25,51,0,51
51,13,34,27,62,0,62
51,13,35,1,54,0,54
51,13,36,29,62,0,62
51,13,36,47,221,208,13
51,13,36,55,47,0,47
51,13,36,59,76,73,3
51,13,36,61,362,550,-188
51,13,36,81,157,136,21
51,13,36,103,85,0,85
51,13,36,119,81,0,81
51,13,37,51,62,0,62
51,13,37,63,105,80,25
51,13,37,119,135,234,-99
51,13,37,183,156,302,-146
51,13,39,35,93,79,14
51,13,39,49,85,103,-18
51,13,39,61,0,46,-46
51,13,41,51,0,66,-66
51,13,42,3,176,230,-54
51,13,42,17,50,0,50
51,13,42,29,65,67,-2
51,13,42,41,72,0,72
51,13,42,45,67,75,-8
51,13,42,91,65,99,-34
51,13,42,101,174,261,-87
51,13,45,19,71,108,-37
51,13,47,37,74,118,-44
51,13,48,29,125,141,-16
51,13,48,85,65,65,0
51,13,48,113,166,154,12
51,13,48,141,69,0,69
51,13,48,201,177,165,12
51,13,48,439,78,53,25
51,13,48,453,121,194,-73
51,13,49,35,66,46,20
51,13,49,49,52,0,52
51,13,51,3,72,130,-58
51,13,51,41,91,92,-1
51,13,51,59,7017,10163,-3146
51,13,51,61,57,53,4
51,13,51,87,100,133,-33
51,13,51,95,59,0,59
51,13,51,107,1037,1331,-294
51,13,51,121,69,0,69
51,13,51,153,902,1166,-264
51,13,51,177,97,101,-4
51,13,51,179,138,177,-39
51,13,51,510,2953,4237,-1284
51,13,51,540,81,84,-3
51,13,51,550,58,0,58
51,13,51,600,105,257,-152
51,13,51,610,188,361,-173
51,13,51,630,0,61,-61
51,13,51,683,74,63,11
51,13,51,710,101,102,-1
51,13,51,760,158,250,-92
51,13,51,810,149,120,29
51,13,53,33,193,338,-145
51,13,53,53,63,0,63
51,13,55,25,60,0,60
51,15,51,3,157,173,-16
51,15,51,59,56,0,56
51,15,51,125,56,64,-8
51,15,51,163,161,159,2
51,15,51,165,677,540,137
51,15,51,540,54,0,54
51,15,51,660,290,185,105
51,15,51,790,1281,1261,20
51,15,51,820,1222,826,396
51,19,51,9,226,156,70
51,19,51,11,63,0,63
51,19,51,23,158,173,-15
51,19,51,31,770,640,130
51,19,51,59,88,0,88
51,19,51,67,296,251,45
51,19,51,143,73,0,73
51,19,51,161,567,558,9
51,19,51,680,1433,1027,406
51,19,51,770,583,437,146
51,19,51,775,65,54,11
51,21,51,197,68,76,-8
51,21,54,55,0,60,-60
51,23,51,5,85,75,10
51,23,51,19,173,158,15
51,23,51,67,67,63,4
51,23,51,121,0,57,-57
51,23,51,161,727,528,199
51,23,51,163,65,0,65
51,23,51,770,607,446,161
51,23,51,775,83,99,-16
51,25,51,117,163,252,-89
51,27,51,51,71,0,71
51,27,51,167,91,106,-15
51,27,51,185,173,193,-20
51,27,51,191,0,82,-82
51,29,51,3,136,107,29
51,29,51,49,81,67,14
51,29,51,65,74,0,74
51,29,51,147,87,87,0
51,31,51,9,332,276,56
51,31,51,11,212,228,-16
51,31,51,19,640,770,-130
51,31,51,83,91,66,25
51,31,51,143,309,314,-5
51,31,51,680,1804,1501,303
51,31,51,770,0,73,-73
51,33,51,41,100,83,17
51,33,51,85,265,265,0
51,33,51,87,220,202,18
51,33,51,99,134,101,33
51,33,51,109,0,81,-81
51,33,51,153,152,65,87
51,33,51,177,866,793,73
51,33,51,179,344,199,145
51,33,51,630,229,124,105
51,33,51,760,58,67,-9
51,35,37,171,127,158,-31
51,35,51,77,266,267,-1
51,35,51,141,82,82,0
51,35,51,155,59,56,3
51,35,51,197,123,134,-11
51,35,51,640,327,273,54
51,36,51,87,147,133,14
51,36,51,127,99,67,32
51,37,51,83,0,63,-63
51,37,51,111,0,72,-72
51,37,51,117,63,78,-15
51,37,51,147,91,156,-65
51,41,1,89,0,62,-62
51,41,4,13,70,112,-42
51,41,6,37,100,101,-1
51,41,6,59,58,0,58
51,41,6,73,94,88,6
51,41,8,41,104,72,32
51,41,11,1,51,71,-20
51,41,12,9,0,78,-78
51,41,12,11,78,0,78
51,41,12,31,59,0,59
51,41,12,57,73,114,-41
51,41,12,71,0,73,-73
51,41,12,86,95,0,95
51,41,12,95,61,99,-38
51,41,12,99,67,65,2
51,41,12,103,0,68,-68
51,41,12,105,0,66,-66
51,41,12,127,0,52,-52
51,41,13,67,0,74,-74
51,41,13,89,0,73,-73
51,41,13,121,0,94,-94
51,41,13,135,62,0,62
51,41,15,3,88,75,13
51,41,17,31,52,0,52
51,41,24,3,107,55,52
51,41,24,5,87,0,87
51,41,24,31,143,111,32
51,41,24,33,131,117,14
51,41,32,3,0,63,-63
51,41,36,5,79,0,79
51,41,36,47,118,69,49
51,41,36,59,76,0,76
51,41,36,61,51,0,51
51,41,36,81,101,0,101
51,41,36,103,102,0,102
51,41,37,51,86,78,8
51,41,37,55,0,62,-62
51,41,37,63,51,0,51
51,41,37,81,63,67,-4
51,41,37,119,102,159,-57
51,41,37,183,205,219,-14
51,41,39,49,63,0,63
51,41,42,101,66,0,66
51,41,45,19,0,60,-60
51,41,45,51,0,84,-84
51,41,48,27,101,89,12
51,41,48,29,0,72,-72
51,41,48,141,84,0,84
51,41,48,201,95,81,14
51,41,48,439,0,68,-68
51,41,51,3,148,87,61
51,41,51,7,318,376,-58
51,41,51,13,92,91,1
51,41,51,33,83,100,-17
51,41,51,49,81,96,-15
51,41,51,53,529,626,-97
51,41,51,59,519,301,218
51,41,51,75,157,218,-61
51,41,51,85,634,717,-83
51,41,51,87,4859,3476,1383
51,41,51,95,163,127,36
51,41,51,101,0,80,-80
51,41,51,107,161,87,74
51,41,51,109,117,131,-14
51,41,51,117,68,69,-1
51,41,51,121,80,45,35
51,41,51,127,106,175,-69
51,41,51,135,122,114,8
51,41,51,145,725,1153,-428
51,41,51,147,156,70,86
51,41,51,149,748,654,94
51,41,51,153,257,203,54
51,41,51,161,67,0,67
51,41,51,177,176,140,36
51,41,51,179,149,0,149
51,41,51,510,59,49,10
51,41,51,550,125,154,-29
51,41,51,570,800,880,-80
51,41,51,650,113,67,46
51,41,51,670,582,603,-21
51,41,51,680,74,0,74
51,41,51,700,234,150,84
51,41,51,710,148,116,32
51,41,51,730,1038,822,216
51,41,51,740,53,0,53
51,41,51,760,6865,5585,1280
51,41,51,770,54,0,54
51,41,51,800,0,83,-83
51,41,51,810,372,252,120
51,41,53,53,94,0,94
51,43,51,59,116,0,116
51,43,51,69,234,273,-39
51,43,51,107,526,203,323
51,43,51,187,71,0,71
51,43,51,840,95,120,-25
51,43,54,3,0,53,-53
51,43,54,37,0,89,-89
51,45,51,161,85,74,11
51,47,51,59,314,142,172
51,47,51,61,857,518,339
51,47,51,107,134,96,38
51,47,51,113,171,234,-63
51,47,51,137,315,478,-163
51,47,51,153,696,252,444
51,47,51,157,161,123,38
51,47,51,177,201,206,-5
51,47,51,179,114,66,48
51,47,51,187,73,66,7
51,47,51,630,0,54,-54
51,47,51,683,174,0,174
51,47,51,760,0,51,-51
51,49,51,29,67,81,-14
51,49,51,41,96,81,15
51,49,51,145,128,96,32
51,49,51,147,187,134,53
51,51,51,27,0,71,-71
51,51,51,195,135,183,-48
51,53,51,41,626,529,97
51,53,51,87,79,75,4
51,53,51,149,237,170,67
51,53,51,183,73,0,73
51,53,51,570,187,141,46
51,53,51,670,168,101,67
51,53,51,730,473,397,76
51,53,51,760,90,84,6
51,57,51,85,0,66,-66
51,57,51,87,0,65,-65
51,57,51,97,112,67,45
51,57,51,159,0,149,-149
51,59,1,73,67,0,67
51,59,1,89,91,235,-144
51,59,1,101,157,91,66
51,59,2,20,116,125,-9
51,59,4,3,72,74,-2
51,59,4,13,536,600,-64
51,59,4,19,135,208,-73
51,59,5,119,82,59,23
51,59,6,1,293,341,-48
51,59,6,13,157,160,-3
51,59,6,37,1001,1056,-55
51,59,6,53,164,130,34
51,59,6,59,360,548,-188
51,59,6,65,117,188,-71
51,59,6,67,96,96,0
51,59,6,71,173,130,43
51,59,6,73,867,1019,-152
51,59,6,75,141,279,-138
51,59,6,81,135,182,-47
51,59,6,83,75,58,17
51,59,6,85,295,434,-139
51,59,6,95,71,0,71
51,59,6,111,117,89,28
51,59,8,1,0,56,-56
51,59,8,5,144,220,-76
51,59,8,13,69,150,-81
51,59,8,31,140,359,-219
51,59,8,35,0,168,-168
51,59,8,41,477,589,-112
51,59,8,59,63,160,-97
51,59,8,69,0,67,-67
51,59,9,1,226,122,104
51,59,9,3,139,111,28
51,59,9,9,129,102,27
51,59,9,11,73,0,73
51,59,10,1,65,62,3
51,59,10,3,214,169,45
51,59,10,5,113,348,-235
51,59,11,1,3717,3441,276
51,59,12,1,0,68,-68
51,59,12,9,171,294,-123
51,59,12,11,380,430,-50
51,59,12,15,0,46,-46
51,59,12,19,82,89,-7
51,59,12,21,85,169,-84
51,59,12,31,254,228,26
51,59,12,33,105,115,-10
51,59,12,57,442,723,-281
51,59,12,69,0,98,-98
51,59,12,71,110,208,-98
51,59,12,73,79,0,79
51,59,12,81,80,223,-143
51,59,12,83,0,77,-77
51,59,12,86,487,420,67
51,59,12,91,197,198,-1
51,59,12,95,287,440,-153
51,59,12,97,66,78,-12
51,59,12,99,302,333,-31
51,59,12,101,66,122,-56
51,59,12,103,203,401,-198
51,59,12,105,79,99,-20
51,59,12,109,75,216,-141
51,59,12,111,0,59,-59
51,59,12,113,99,75,24
51,59,12,115,68,196,-128
51,59,12,117,111,118,-7
51,59,12,119,0,97,-97
51,59,12,127,81,155,-74
51,59,13,51,112,97,15
51,59,13,67,168,189,-21
51,59,13,73,134,116,18
51,59,13,89,156,196,-40
51,59,13,117,0,76,-76
51,59,13,121,307,358,-51
51,59,13,135,122,211,-89
51,59,13,153,73,0,73
51,59,13,179,95,79,16
51,59,13,245,103,60,43
51,59,15,3,880,566,314
51,59,17,31,576,613,-37
51,59,17,43,124,128,-4
51,59,17,97,94,75,19
51,59,17,163,116,127,-11
51,59,18,57,0,69,-69
51,59,18,97,81,121,-40
51,59,20,91,105,75,30
51,59,20,103,136,135,1
51,59,20,173,82,0,82
51,59,21,67,70,57,13
51,59,21,93,129,0,129
51,59,21,111,0,125,-125
51,59,22,15,96,0,96
51,59,22,33,54,0,54
51,59,22,51,75,55,20
51,59,22,71,106,74,32
51,59,23,5,0,75,-75
51,59,24,3,714,975,-261
51,59,24,5,527,450,77
51,59,24,9,126,182,-56
51,59,24,13,50,85,-35
51,59,24,17,463,628,-165
51,59,24,21,341,440,-99
51,59,24,25,158,140,18
51,59,24,27,676,631,45
51,59,24,31,4386,3652,734
51,59,24,33,3940,4130,-190
51,59,24,35,0,52,-52
51,59,24,37,102,161,-59
51,59,24,43,87,122,-35
51,59,24,47,0,53,-53
51,59,24,510,393,366,27
51,59,25,1,0,67,-67
51,59,25,9,71,0,71
51,59,25,17,423,400,23
51,59,25,21,142,133,9
51,59,25,23,0,68,-68
51,59,25,25,206,171,35
51,59,25,27,117,64,53
51,59,26,99,54,0,54
51,59,26,125,137,132,5
51,59,26,161,86,67,19
51,59,26,163,109,141,-32
51,59,27,37,0,62,-62
51,59,27,53,166,184,-18
51,59,27,123,50,0,50
51,59,29,95,63,63,0
51,59,29,169,122,101,21
51,59,29,189,123,159,-36
51,59,29,510,58,0,58
51,59,31,55,65,62,3
51,59,32,3,378,369,9
51,59,32,31,57,0,57
51,59,33,11,65,69,-4
51,59,34,1,71,0,71
51,59,34,3,233,139,94
51,59,34,5,143,117,26
51,59,34,7,88,56,32
51,59,34,13,130,71,59
51,59,34,17,288,217,71
51,59,34,21,130,79,51
51,59,34,23,264,207,57
51,59,34,25,92,63,29
51,59,34,27,170,106,64
51,59,34,29,55,0,55
51,59,34,31,77,0,77
51,59,34,35,107,94,13
51,59,34,39,79,0,79
51,59,35,1,156,176,-20
51,59,36,1,106,0,106
51,59,36,5,104,55,49
51,59,36,29,138,102,36
51,59,36,45,90,91,-1
51,59,36,47,375,370,5
51,59,36,55,139,99,40
51,59,36,59,177,177,0
51,59,36,61,484,581,-97
51,59,36,67,92,59,33
51,59,36,71,163,91,72
51,59,36,81,483,280,203
51,59,36,103,212,106,106
51,59,36,119,199,122,77
51,59,37,19,0,259,-259
51,59,37,21,0,116,-116
51,59,37,31,0,66,-66
51,59,37,49,67,62,5
51,59,37,51,351,263,88
51,59,37,55,0,76,-76
51,59,37,63,146,206,-60
51,59,37,67,0,101,-101
51,59,37,81,118,116,2
51,59,37,85,154,95,59
51,59,37,119,407,631,-224
51,59,37,125,90,89,1
51,59,37,129,58,241,-183
51,59,37,133,276,159,117
51,59,37,135,55,84,-29
51,59,37,183,426,804,-378
51,59,39,35,139,167,-28
51,59,39,49,238,291,-53
51,59,39,57,150,121,29
51,59,39,61,107,98,9
51,59,39,113,105,84,21
51,59,39,153,61,61,0
51,59,40,109,99,74,25
51,59,41,51,50,130,-80
51,59,41,67,0,107,-107
51,59,42,3,340,329,11
51,59,42,17,84,86,-2
51,59,42,27,71,0,71
51,59,42,29,113,177,-64
51,59,42,41,114,164,-50
51,59,42,43,75,77,-2
51,59,42,45,120,110,10
51,59,42,49,52,0,52
51,59,42,71,83,93,-10
51,59,42,77,0,75,-75
51,59,42,91,163,252,-89
51,59,42,101,287,312,-25
51,59,42,133,60,0,60
51,59,44,5,107,74,33
51,59,44,7,87,52,35
51,59,45,13,68,205,-137
51,59,45,15,0,101,-101
51,59,45,19,173,258,-85
51,59,45,45,0,139,-139
51,59,45,51,80,246,-166
51,59,45,79,126,147,-21
51,59,45,91,0,104,-104
51,59,47,37,145,187,-42
51,59,47,65,0,59,-59
51,59,47,93,104,109,-5
51,59,47,125,179,124,55
51,59,47,157,129,141,-12
51,59,48,27,194,169,25
51,59,48,29,619,611,8
51,59,48,61,88,0,88
51,59,48,85,353,358,-5
51,59,48,113,390,431,-41
51,59,48,121,123,190,-67
51,59,48,141,284,194,90
51,59,48,157,115,118,-3
51,59,48,201,550,481,69
51,59,48,339,0,116,-116
51,59,48,439,227,280,-53
51,59,48,453,248,450,-202
51,59,48,491,102,162,-60
51,59,49,11,0,111,-111
51,59,49,35,118,148,-30
51,59,49,49,138,100,38
51,59,51,3,241,361,-120
51,59,51,13,10163,7017,3146
51,59,51,15,0,56,-56
51,59,51,19,0,88,-88
51,59,51,41,301,519,-218
51,59,51,43,0,116,-116
51,59,51,47,142,314,-172
51,59,51,61,394,757,-363
51,59,51,65,0,63,-63
51,59,51,69,151,449,-298
51,59,51,85,48,101,-53
51,59,51,87,578,528,50
51,59,51,95,161,257,-96
51,59,51,99,0,68,-68
51,59,51,107,7676,15503,-7827
51,59,51,109,0,96,-96
51,59,51,121,228,166,62
51,59,51,133,0,62,-62
51,59,51,137,86,181,-95
51,59,51,153,7802,14248,-6446
51,59,51,161,75,71,4
51,59,51,165,61,99,-38
51,59,51,171,87,158,-71
51,59,51,177,467,780,-313
51,59,51,179,902,1894,-992
51,59,51,187,160,373,-213
51,59,51,193,0,69,-69
51,59,51,199,140,137,3
51,59,51,510,10202,7029,3173
51,59,51,540,99,157,-58
51,59,51,550,270,209,61
51,59,51,600,2054,2114,-60
51,59,51,610,843,783,60
51,59,51,630,147,163,-16
51,59,51,650,156,161,-5
51,59,51,660,116,77,39
51,59,51,680,89,0,89
51,59,51,683,671,1065,-394
51,59,51,685,380,652,-272
51,59,51,700,194,152,42
51,59,51,710,345,330,15
51,59,51,740,82,0,82
51,59,51,760,370,665,-295
51,59,51,770,54,72,-18
51,59,51,800,68,67,1
51,59,51,810,569,639,-70
51,59,51,830,0,53,-53
51,59,51,840,81,114,-33
51,59,53,33,385,804,-419
51,59,53,35,125,101,24
51,59,53,53,239,248,-9
51,59,53,61,72,117,-45
51,59,53,63,75,0,75
51,59,53,67,87,0,87
51,59,54,3,98,138,-40
51,59,54,37,87,247,-160
51,59,54,61,71,0,71
51,59,55,25,68,66,2
51,59,55,79,60,0,60
51,61,11,1,69,72,-3
51,61,24,31,77,0,77
51,61,24,33,68,0,68
51,61,51,13,53,57,-4
51,61,51,47,518,857,-339
51,61,51,59,757,394,363
51,61,51,69,97,84,13
51,61,51,107,414,346,68
51,61,51,137,77,163,-86
51,61,51,153,2023,813,1210
51,61,51,157,84,108,-24
51,61,51,171,0,73,-73
51,61,51,177,86,148,-62
51,61,51,179,195,167,28
51,61,51,187,161,276,-115
51,61,51,510,59,58,1
51,61,51,683,340,143,197
51,61,51,685,136,0,136
51,61,51,760,0,56,-56
51,63,51,121,210,260,-50
51,63,51,161,80,0,80
51,63,51,770,50,0,50
51,65,51,3,724,571,153
51,65,51,29,0,74,-74
51,65,51,59,63,0,63
51,65,51,79,0,69,-69
51,65,51,87,0,64,-64
51,65,51,109,139,211,-72
51,65,51,137,74,0,74
51,65,51,540,222,132,90
51,65,51,760,0,57,-57
51,67,51,19,251,296,-45
51,67,51,23,63,67,-4
51,67,51,89,162,238,-76
51,67,51,121,0,56,-56
51,67,51,143,0,73,-73
51,67,51,161,311,435,-124
51,67,51,770,478,446,32
51,67,51,775,73,69,4
51,69,24,31,75,0,75
51,69,24,43,0,74,-74
51,69,51,43,273,234,39
51,69,51,59,449,151,298
51,69,51,61,84,97,-13
51,69,51,107,958,310,648
51,69,51,153,288,139,149
51,69,51,171,381,421,-40
51,69,51,187,651,374,277
51,69,51,660,50,0,50
51,69,51,840,2149,1461,688
51,69,54,3,488,866,-378
51,69,54,27,158,145,13
51,69,54,37,128,116,12
51,69,54,65,57,80,-23
51,71,51,121,272,268,4
51,71,51,155,56,87,-31
51,71,54,63,80,64,16
51,73,51,95,138,126,12
51,73,51,97,0,53,-53
51,73,51,115,128,204,-76
51,73,51,119,128,162,-34
51,73,51,199,347,207,140
51,73,51,650,246,124,122
51,73,51,700,479,367,112
51,73,51,760,0,61,-61
51,73,51,810,65,0,65
51,75,51,41,218,157,61
51,75,51,85,226,120,106
51,75,51,87,1006,495,511
51,75,51,109,123,110,13
51,75,51,145,0,55,-55
51,75,51,760,208,203,5
51,77,51,35,267,266,1
51,77,51,640,187,195,-8
51,79,51,3,540,402,138
51,79,51,65,69,0,69
51,79,51,109,0,79,-79
51,79,51,113,87,93,-6
51,79,51,137,137,129,8
51,79,51,540,172,103,69
51,81,51,183,75,0,75
51,81,51,595,369,255,114
51,83,37,145,0,59,-59
51,83,51,31,66,91,-25
51,83,51,37,63,0,63
51,83,51,117,117,94,23
51,83,51,143,103,104,-1
51,83,51,590,0,141,-141
51,85,51,33,265,265,0
51,85,51,41,717,634,83
51,85,51,57,66,0,66
51,85,51,59,101,48,53
51,85,51,75,120,226,-106
51,85,51,87,3476,2333,1143
51,85,51,101,284,442,-158
51,85,51,109,141,172,-31
51,85,51,127,145,231,-86
51,85,51,145,69,97,-28
51,85,51,153,76,0,76
51,85,51,177,131,88,43
51,85,51,179,89,0,89
51,85,51,700,64,0,64
51,85,51,760,876,803,73
51,85,51,810,0,68,-68
51,87,4,13,116,105,11
51,87,6,37,161,166,-5
51,87,6,73,82,87,-5
51,87,6,85,0,57,-57
51,87,9,1,66,0,66
51,87,10,3,0,62,-62
51,87,11,1,138,142,-4
51,87,12,11,99,65,34
51,87,12,31,69,75,-6
51,87,12,57,65,113,-48
51,87,12,71,65,0,65
51,87,12,86,73,76,-3
51,87,12,95,57,68,-11
51,87,12,99,81,64,17
51,87,12,103,0,58,-58
51,87,13,67,75,94,-19
51,87,13,89,76,117,-41
51,87,13,121,97,150,-53
51,87,13,135,65,66,-1
51,87,17,31,146,128,18
51,87,24,3,87,58,29
51,87,24,5,83,110,-27
51,87,24,31,158,158,0
51,87,24,33,162,125,37
51,87,24,510,59,48,11
51,87,32,3,63,0,63
51,87,34,13,76,0,76
51,87,34,17,68,0,68
51,87,34,23,123,69,54
51,87,36,5,79,0,79
51,87,36,47,179,77,102
51,87,36,59,55,0,55
51,87,36,61,114,84,30
51,87,36,81,144,75,69
51,87,36,103,83,0,83
51,87,37,63,88,0,88
51,87,37,67,62,0,62
51,87,37,81,78,74,4
51,87,37,119,153,237,-84
51,87,37,183,231,261,-30
51,87,39,49,76,69,7
51,87,42,3,52,91,-39
51,87,42,101,62,63,-1
51,87,47,37,76,68,8
51,87,48,29,80,69,11
51,87,48,85,71,123,-52
51,87,48,113,112,99,13
51,87,48,201,81,107,-26
51,87,51,3,202,154,48
51,87,51,13,133,100,33
51,87,51,33,202,220,-18
51,87,51,36,133,147,-14
51,87,51,41,3476,4859,-1383
51,87,51,53,75,79,-4
51,87,51,57,65,0,65
51,87,51,59,528,578,-50
51,87,51,65,64,0,64
51,87,51,75,495,1006,-511
51,87,51,85,2333,3476,-1143
51,87,51,95,178,145,33
51,87,51,101,189,327,-138
51,87,51,107,176,182,-6
51,87,51,109,266,297,-31
51,87,51,119,73,56,17
51,87,51,121,68,0,68
51,87,51,127,255,643,-388
51,87,51,145,172,276,-104
51,87,51,149,154,111,43
51,87,51,153,239,135,104
51,87,51,177,246,202,44
51,87,51,179,133,124,9
51,87,51,199,56,0,56
51,87,51,510,134,88,46
51,87,51,540,89,58,31
51,87,51,550,106,124,-18
51,87,51,570,108,95,13
51,87,51,630,67,53,14
51,87,51,650,123,112,11
51,87,51,660,52,0,52
51,87,51,670,103,172,-69
51,87,51,680,68,0,68
51,87,51,700,207,187,20
51,87,51,710,153,114,39
51,87,51,730,204,243,-39
51,87,51,760,9624,7103,2521
51,87,51,770,79,52,27
51,87,51,810,291,286,5
51,87,53,33,0,89,-89
51,89,37,81,67,122,-55
51,89,37,157,166,170,-4
51,89,51,67,238,162,76
51,89,51,141,174,192,-18
51,89,51,143,120,103,17
51,89,51,690,890,919,-29
51,89,51,770,82,0,82
51,93,51,175,119,146,-27
51,93,51,199,128,107,21
51,93,51,550,261,148,113
51,93,51,620,72,110,-38
51,93,51,650,396,256,140
51,93,51,700,465,394,71
51,93,51,710,127,80,47
51,93,51,740,202,122,80
51,93,51,800,535,552,-17
51,93,51,810,186,97,89
51,95,11,1,0,51,-51
51,95,24,31,59,0,59
51,95,37,119,0,54,-54
51,95,51,3,0,58,-58
51,95,51,13,0,59,-59
51,95,51,41,127,163,-36
51,95,51,59,257,161,96
51,95,51,73,126,138,-12
51,95,51,87,145,178,-33
51,95,51,101,69,60,9
51,95,51,107,103,86,17
51,95,51,127,204,381,-177
51,95,51,153,102,0,102
51,95,51,199,848,666,182
51,95,51,550,65,0,65
51,95,51,650,263,163,100
51,95,51,700,779,796,-17
51,95,51,710,82,61,21
51,95,51,760,97,166,-69
51,95,51,800,76,0,76
51,95,51,810,212,152,60
51,95,51,830,914,776,138
51,97,51,57,67,112,-45
51,97,51,73,53,0,53
51,97,51,101,136,105,31
51,99,6,73,0,62,-62
51,99,17,97,190,0,190
51,99,24,17,227,120,107
51,99,24,37,61,72,-11
51,99,51,33,101,134,-33
51,99,51,59,68,0,68
51,99,51,153,68,0,68
51,99,51,177,324,266,58
51,99,51,179,308,252,56
51,99,51,193,215,280,-65
51,99,51,630,142,109,33
51,99,51,810,0,68,-68
51,101,51,41,80,0,80
51,101,51,85,442,284,158
51,101,51,87,327,189,138
51,101,51,95,60,69,-9
51,101,51,97,105,136,-31
51,101,51,127,93,0,93
51,101,51,760,60,71,-11
51,103,51,133,167,132,35
51,105,51,195,160,188,-28
51,107,4,13,202,214,-12
51,107,4,19,0,86,-86
51,107,6,1,97,137,-40
51,107,6,13,99,0,99
51,107,6,37,317,303,14
51,107,6,59,138,164,-26
51,107,6,65,88,0,88
51,107,6,73,280,260,20
51,107,6,85,114,144,-30
51,107,8,5,0,130,-130
51,107,8,31,0,87,-87
51,107,8,35,0,92,-92
51,107,8,41,89,140,-51
51,107,9,1,78,52,26
51,107,9,3,66,0,66
51,107,10,3,90,0,90
51,107,10,5,0,99,-99
51,107,11,1,714,650,64
51,107,12,9,72,156,-84
51,107,12,11,166,159,7
51,107,12,31,96,92,4
51,107,12,57,157,215,-58
51,107,12,71,62,67,-5
51,107,12,81,0,102,-102
51,107,12,86,195,172,23
51,107,12,95,120,152,-32
51,107,12,99,108,121,-13
51,107,12,103,73,118,-45
51,107,12,109,0,76,-76
51,107,12,115,0,58,-58
51,107,13,89,65,75,-10
51,107,13,121,110,147,-37
51,107,13,135,84,0,84
51,107,15,3,114,80,34
51,107,17,31,201,140,61
51,107,17,43,79,0,79
51,107,24,3,250,190,60
51,107,24,5,159,118,41
51,107,24,17,0,84,-84
51,107,24,21,338,434,-96
51,107,24,27,276,151,125
51,107,24,31,1291,784,507
51,107,24,33,663,383,280
51,107,24,43,80,0,80
51,107,24,510,81,79,2
51,107,25,17,132,107,25
51,107,27,53,0,59,-59
51,107,29,189,95,0,95
51,107,32,3,84,133,-49
51,107,34,3,78,74,4
51,107,34,17,83,58,25
51,107,34,23,204,80,124
51,107,34,27,84,0,84
51,107,34,29,57,0,57
51,107,36,29,84,0,84
51,107,36,47,126,88,38
51,107,36,59,103,0,103
51,107,36,61,109,93,16
51,107,36,81,139,77,62
51,107,36,103,77,0,77
51,107,37,19,0,107,-107
51,107,37,119,130,209,-79
51,107,37,129,0,69,-69
51,107,37,133,0,71,-71
51,107,37,183,157,265,-108
51,107,39,49,77,64,13
51,107,42,3,93,110,-17
51,107,42,29,74,99,-25
51,107,42,91,59,0,59
51,107,42,101,74,83,-9
51,107,45,13,0,72,-72
51,107,45,19,0,120,-120
51,107,45,51,0,100,-100
51,107,48,29,105,146,-41
51,107,48,85,107,179,-72
51,107,48,113,102,106,-4
51,107,48,121,82,76,6
51,107,48,141,82,0,82
51,107,48,201,226,170,56
51,107,48,439,110,104,6
51,107,48,453,83,124,-41
51,107,48,491,0,84,-84
51,107,51,3,81,136,-55
51,107,51,13,1331,1037,294
51,107,51,41,87,161,-74
51,107,51,43,203,526,-323
51,107,51,47,96,134,-38
51,107,51,59,15503,7676,7827
51,107,51,61,346,414,-68
51,107,51,69,310,958,-648
51,107,51,87,182,176,6
51,107,51,95,86,103,-17
51,107,51,121,0,50,-50
51,107,51,153,2209,2243,-34
51,107,51,171,63,66,-3
51,107,51,177,77,189,-112
51,107,51,179,170,275,-105
51,107,51,187,92,190,-98
51,107,51,199,84,0,84
51,107,51,510,795,454,341
51,107,51,550,93,85,8
51,107,51,600,240,139,101
51,107,51,610,150,135,15
51,107,51,660,54,0,54
51,107,51,683,213,317,-104
51,107,51,685,190,158,32
51,107,51,700,67,0,67
51,107,51,710,96,53,43
51,107,51,760,140,179,-39
51,107,51,810,135,176,-41
51,107,51,840,129,192,-63
51,107,53,33,203,228,-25
51,107,54,3,128,352,-224
51,107,54,37,296,642,-346
51,109,51,3,365,255,110
51,109,51,33,81,0,81
51,109,51,41,131,117,14
51,109,51,59,96,0,96
51,109,51,65,211,139,72
51,109,51,75,110,123,-13
51,109,51,79,79,0,79
51,109,51,85,172,141,31
51,109,51,87,297,266,31
51,109,51,137,322,203,119
51,109,51,153,99,0,99
51,109,51,177,313,166,147
51,109,51,179,67,0,67
51,109,51,540,114,0,114
51,109,51,760,74,63,11
51,111,51,37,72,0,72
51,111,51,117,50,117,-67
51,111,51,135,90,96,-6
51,113,51,3,0,61,-61
51,113,51,47,234,171,63
51,113,51,79,93,87,6
51,113,51,137,98,172,-74
51,115,51,73,204,128,76
51,117,37,183,72,61,11
51,117,51,25,252,163,89
51,117,51,37,78,63,15
51,117,51,41,69,68,1
51,117,51,83,94,117,-23
51,117,51,111,117,50,67
51,117,51,760,0,50,-50
51,119,51,73,162,128,34
51,119,51,87,56,73,-17
51,121,6,37,0,49,-49
51,121,6,85,0,118,-118
51,121,24,31,0,52,-52
51,121,25,17,0,50,-50
51,121,37,81,0,69,-69
51,121,37,119,53,61,-8
51,121,37,183,58,103,-45
51,121,51,3,0,53,-53
51,121,51,13,0,69,-69
51,121,51,23,57,0,57
51,121,51,41,45,80,-35
51,121,51,59,166,228,-62
51,121,51,63,260,210,50
51,121,51,67,56,0,56
51,121,51,71,268,272,-4
51,121,51,87,0,68,-68
51,121,51,107,50,0,50
51,121,51,155,484,534,-50
51,121,51,161,313,342,-29
51,121,51,197,87,0,87
51,121,51,750,459,491,-32
51,121,51,760,0,92,-92
51,121,51,770,251,292,-41
51,121,51,775,90,168,-78
51,121,51,810,0,50,-50
51,121,53,33,0,54,-54
51,121,54,55,61,0,61
51,125,51,3,209,207,2
51,125,51,9,101,108,-7
51,125,51,15,64,56,8
51,125,51,540,61,50,11
51,125,51,820,0,74,-74
51,127,51,36,67,99,-32
51,127,51,41,175,106,69
51,127,51,85,231,145,86
51,127,51,87,643,255,388
51,127,51,95,381,204,177
51,127,51,101,0,93,-93
51,127,51,700,115,0,115
51,127,51,760,79,83,-4
51,131,51,1,217,261,-44
51,131,51,810,81,72,9
51,133,51,59,62,0,62
51,133,51,103,132,167,-35
51,133,51,159,70,100,-30
51,133,51,193,0,79,-79
51,135,51,7,69,0,69
51,135,51,41,114,122,-8
51,135,51,111,96,90,6
51,135,51,147,69,128,-59
51,137,51,3,190,197,-7
51,137,51,47,478,315,163
51,137,51,59,181,86,95
51,137,51,61,163,77,86
51,137,51,65,0,74,-74
51,137,51,79,129,137,-8
51,137,51,109,203,322,-119
51,137,51,113,172,98,74
51,137,51,153,267,79,188
51,137,51,177,517,584,-67
51,137,51,179,219,152,67
51,137,51,540,80,0,80
51,137,51,630,68,80,-12
51,139,51,165,320,300,20
51,139,51,171,72,102,-30
51,139,51,187,105,0,105
51,139,51,660,62,61,1
51,141,37,171,123,80,43
51,141,51,35,82,82,0
51,141,51,89,192,174,18
51,143,37,33,77,92,-15
51,143,37,81,54,86,-32
51,143,37,157,0,111,-111
51,143,51,19,0,73,-73
51,143,51,31,314,309,5
51,143,51,67,73,0,73
51,143,51,83,104,103,1
51,143,51,89,103,120,-17
51,143,51,590,1410,1041,369
51,143,51,680,81,117,-36
51,145,51,7,70,107,-37
51,145,51,41,1153,725,428
51,145,51,49,96,128,-32
51,145,51,75,55,0,55
51,145,51,85,97,69,28
51,145,51,87,276,172,104
51,145,51,760,137,192,-55
51,147,51,11,72,0,72
51,147,51,29,87,87,0
51,147,51,37,156,91,65
51,147,51,41,70,156,-86
51,147,51,49,134,187,-53
51,147,51,135,128,69,59
51,147,51,760,0,53,-53
51,149,8,41,169,0,169
51,149,13,179,84,0,84
51,149,15,3,115,96,19
51,149,20,61,102,0,102
51,149,36,45,96,0,96
51,149,37,51,130,100,30
51,149,47,125,97,0,97
51,149,48,27,126,132,-6
51,149,48,141,197,105,92
51,149,51,41,654,748,-94
51,149,51,53,170,237,-67
51,149,51,87,111,154,-43
51,149,51,183,76,75,1
51,149,51,570,238,173,65
51,149,51,670,599,449,150
51,149,51,730,607,481,126
51,149,51,760,117,106,11
51,149,53,53,121,0,121
51,153,1,89,0,89,-89
51,153,4,13,115,198,-83
51,153,4,19,0,61,-61
51,153,6,1,61,103,-42
51,153,6,37,208,236,-28
51,153,6,53,80,0,80
51,153,6,59,110,123,-13
51,153,6,65,87,119,-32
51,153,6,71,153,154,-1
51,153,6,73,641,651,-10
51,153,8,41,156,257,-101
51,153,10,5,0,58,-58
51,153,11,1,677,502,175
51,153,12,9,0,99,-99
51,153,12,11,122,162,-40
51,153,12,31,117,110,7
51,153,12,33,0,79,-79
51,153,12,57,148,324,-176
51,153,12,71,0,54,-54
51,153,12,81,0,76,-76
51,153,12,86,157,102,55
51,153,12,91,0,76,-76
51,153,12,95,96,176,-80
51,153,12,97,0,72,-72
51,153,12,99,88,159,-71
51,153,12,101,0,101,-101
51,153,12,103,0,101,-101
51,153,12,105,0,110,-110
51,153,12,113,0,68,-68
51,153,12,115,0,82,-82
51,153,12,117,0,91,-91
51,153,12,127,0,72,-72
51,153,13,51,0,54,-54
51,153,13,67,0,92,-92
51,153,13,89,0,62,-62
51,153,13,121,101,74,27
51,153,13,135,0,106,-106
51,153,15,3,344,226,118
51,153,17,31,110,78,32
51,153,24,3,259,353,-94
51,153,24,5,169,119,50
51,153,24,17,235,288,-53
51,153,24,21,123,151,-28
51,153,24,27,132,179,-47
51,153,24,31,815,743,72
51,153,24,33,1516,1281,235
51,153,24,37,0,85,-85
51,153,24,43,0,56,-56
51,153,24,510,77,90,-13
51,153,32,3,85,152,-67
51,153,34,5,71,0,71
51,153,36,5,72,79,-7
51,153,36,29,50,0,50
51,153,36,47,124,96,28
51,153,36,59,105,0,105
51,153,36,61,65,53,12
51,153,36,67,62,0,62
51,153,36,81,233,91,142
51,153,36,103,111,0,111
51,153,37,19,0,79,-79
51,153,37,49,85,0,85
51,153,37,51,123,164,-41
51,153,37,63,0,72,-72
51,153,37,119,106,135,-29
51,153,37,129,0,78,-78
51,153,37,133,465,460,5
51,153,37,183,146,246,-100
51,153,39,49,90,66,24
51,153,42,3,90,118,-28
51,153,42,101,99,69,30
51,153,45,13,114,126,-12
51,153,45,19,0,71,-71
51,153,45,51,71,179,-108
51,153,45,79,57,72,-15
51,153,47,125,0,59,-59
51,153,48,27,87,97,-10
51,153,48,29,185,272,-87
51,153,48,85,96,94,2
51,153,48,113,69,111,-42
51,153,48,141,144,78,66
51,153,48,201,177,233,-56
51,153,48,439,81,146,-65
51,153,48,453,0,102,-102
51,153,51,3,90,78,12
51,153,51,13,1166,902,264
51,153,51,33,65,152,-87
51,153,51,41,203,257,-54
51,153,51,47,252,696,-444
51,153,51,59,14248,7802,6446
51,153,51,61,813,2023,-1210
51,153,51,69,139,288,-149
51,153,51,85,0,76,-76
51,153,51,87,135,239,-104
51,153,51,95,0,102,-102
51,153,51,99,0,68,-68
51,153,51,107,2243,2209,34
51,153,51,109,0,99,-99
51,153,51,137,79,267,-188
51,153,51,171,69,113,-44
51,153,51,177,596,1408,-812
51,153,51,179,1811,4862,-3051
51,153,51,187,136,429,-293
51,153,51,510,2469,1215,1254
51,153,51,550,119,160,-41
51,153,51,600,258,171,87
51,153,51,610,0,56,-56
51,153,51,630,270,296,-26
51,153,51,650,65,85,-20
51,153,51,660,57,0,57
51,153,51,683,2836,2631,205
51,153,51,685,1104,1051,53
51,153,51,700,133,80,53
51,153,51,710,182,139,43
51,153,51,760,164,240,-76
51,153,51,770,0,60,-60
51,153,51,810,270,299,-29
51,153,51,840,65,87,-22
51,153,53,33,78,119,-41
51,153,53,53,0,90,-90
51,153,54,3,0,143,-143
51,153,54,37,0,107,-107
51,155,51,35,56,59,-3
51,155,51,71,87,56,31
51,155,51,121,534,484,50
51,155,51,197,200,167,33
51,155,51,750,327,341,-14
51,157,51,47,123,161,-38
51,157,51,61,108,84,24
51,159,51,57,149,0,149
51,159,51,133,100,70,30
51,159,51,193,145,150,-5
51,161,37,119,0,78,-78
51,161,37,183,0,77,-77
51,161,51,19,558,567,-9
51,161,51,23,528,727,-199
51,161,51,41,0,67,-67
51,161,51,45,74,85,-11
51,161,51,59,71,75,-4
51,161,51,63,0,80,-80
51,161,51,67,435,311,124
51,161,51,121,342,313,29
51,161,51,680,67,95,-28
51,161,51,760,0,55,-55
51,161,51,770,3425,2802,623
51,161,51,775,936,822,114
51,163,51,15,159,161,-2
51,163,51,23,0,65,-65
51,163,51,530,316,193,123
51,163,51,678,340,222,118
51,163,51,790,0,69,-69
51,165,51,3,56,72,-16
51,165,51,15,540,677,-137
51,165,51,59,99,61,38
51,165,51,139,300,320,-20
51,165,51,171,343,285,58
51,165,51,660,2267,1369,898
51,165,51,790,114,110,4
51,165,51,820,82,91,-9
51,167,47,163,0,87,-87
51,167,51,27,106,91,15
51,167,51,185,219,164,55
51,167,51,191,197,210,-13
51,167,51,195,191,148,43
51,169,47,73,75,138,-63
51,169,47,163,245,318,-73
51,169,47,179,69,70,-1
51,169,51,195,68,75,-7
51,171,51,59,158,87,71
51,171,51,61,73,0,73
51,171,51,69,421,381,40
51,171,51,107,66,63,3
51,171,51,139,102,72,30
51,171,51,153,113,69,44
51,171,51,165,285,343,-58
51,171,51,187,463,310,153
51,171,51,660,153,125,28
51,171,51,840,130,141,-11
51,171,54,3,0,85,-85
51,173,51,191,357,403,-46
51,173,51,197,179,207,-28
51,173,51,520,0,50,-50
51,175,51,93,146,119,27
51,175,51,550,65,0,65
51,175,51,620,385,264,121
51,175,51,800,157,112,45
51,175,51,810,97,0,97
51,177,4,13,0,59,-59
51,177,6,73,92,56,36
51,177,11,1,88,0,88
51,177,24,3,87,0,87
51,177,24,31,148,59,89
51,177,24,33,187,138,49
51,177,37,133,84,0,84
51,177,51,13,101,97,4
51,177,51,33,793,866,-73
51,177,51,41,140,176,-36
51,177,51,47,206,201,5
51,177,51,59,780,467,313
51,177,51,61,148,86,62
51,177,51,85,88,131,-43
51,177,51,87,202,246,-44
51,177,51,99,266,324,-58
51,177,51,107,189,77,112
51,177,51,109,166,313,-147
51,177,51,137,584,517,67
51,177,51,153,1408,596,812
51,177,51,179,2708,1882,826
51,177,51,193,136,93,43
51,177,51,510,128,91,37
51,177,51,550,0,61,-61
51,177,51,630,1961,1585,376
51,177,51,683,63,0,63
51,177,51,710,0,62,-62
51,177,51,760,104,172,-68
51,177,51,810,96,103,-7
51,179,4,13,94,0,94
51,179,6,37,76,71,5
51,179,6,65,82,0,82
51,179,6,71,95,86,9
51,179,6,73,400,307,93
51,179,8,41,81,0,81
51,179,11,1,127,102,25
51,179,12,31,0,60,-60
51,179,12,33,0,67,-67
51,179,12,57,0,94,-94
51,179,12,103,0,63,-63
51,179,15,3,188,92,96
51,179,24,3,107,89,18
51,179,24,5,54,0,54
51,179,24,17,86,0,86
51,179,24,31,98,107,-9
51,179,24,33,283,154,129
51,179,32,3,0,67,-67
51,179,37,49,66,0,66
51,179,37,51,83,75,8
51,179,37,133,437,370,67
51,179,37,183,61,60,1
51,179,45,51,0,67,-67
51,179,48,29,0,89,-89
51,179,48,201,0,62,-62
51,179,51,13,177,138,39
51,179,51,33,199,344,-145
51,179,51,41,0,149,-149
51,179,51,47,66,114,-48
51,179,51,59,1894,902,992
51,179,51,61,167,195,-28
51,179,51,85,0,89,-89
51,179,51,87,124,133,-9
51,179,51,99,252,308,-56
51,179,51,107,275,170,105
51,179,51,109,0,67,-67
51,179,51,137,152,219,-67
51,179,51,153,4862,1811,3051
51,179,51,177,1882,2708,-826
51,179,51,193,70,110,-40
51,179,51,510,368,224,144
51,179,51,550,0,64,-64
51,179,51,630,865,1182,-317
51,179,51,683,152,77,75
51,179,51,685,60,0,60
51,179,51,710,110,0,110
51,179,51,760,115,186,-71
51,179,51,810,140,138,2
51,181,51,700,60,0,60
51,183,51,53,0,73,-73
51,183,51,81,0,75,-75
51,183,51,149,75,76,-1
51,183,51,730,80,90,-10
51,185,51,27,193,173,20
51,185,51,167,164,219,-55
51,185,51,191,0,124,-124
51,185,54,47,94,0,94
51,185,54,55,296,336,-40
51,187,51,43,0,71,-71
51,187,51,47,66,73,-7
51,187,51,59,373,160,213
51,187,51,61,276,161,115
51,187,51,69,374,651,-277
51,187,51,107,190,92,98
51,187,51,139,0,105,-105
51,187,51,153,429,136,293
51,187,51,171,310,463,-153
51,187,51,683,81,0,81
51,187,51,840,124,105,19
51,187,54,3,0,78,-78
51,191,47,163,490,536,-46
51,191,47,179,0,91,-91
51,191,51,27,82,0,82
51,191,51,167,210,197,13
51,191,51,173,403,357,46
51,191,51,185,124,0,124
51,191,51,195,64,0,64
51,191,51,520,480,510,-30
51,193,24,17,93,0,93
51,193,51,59,69,0,69
51,193,51,99,280,215,65
51,193,51,133,79,0,79
51,193,51,159,150,145,5
51,193,51,177,93,136,-43
51,193,51,179,110,70,40
51,195,47,163,0,111,-111
51,195,51,51,183,135,48
51,195,51,105,188,160,28
51,195,51,167,148,191,-43
51,195,51,169,75,68,7
51,195,51,191,0,64,-64
51,195,51,720,248,329,-81
51,197,51,21,76,68,8
51,197,51,35,134,123,11
51,197,51,121,0,87,-87
51,197,51,155,167,200,-33
51,197,51,173,207,179,28
51,199,12,57,0,85,-85
51,199,15,3,147,117,30
51,199,32,3,80,70,10
51,199,48,29,120,179,-59
51,199,51,59,137,140,-3
51,199,51,73,207,347,-140
51,199,51,87,0,56,-56
51,199,51,93,107,128,-21
51,199,51,95,666,848,-182
51,199,51,107,0,84,-84
51,199,51,550,141,109,32
51,199,51,650,1116,786,330
51,199,51,700,1861,1633,228
51,199,51,710,133,140,-7
51,199,51,735,202,260,-58
51,199,51,760,0,104,-104
51,199,51,800,85,91,-6
51,199,51,810,199,230,-31
51,199,51,830,177,235,-58
51,510,4,13,98,137,-39
51,510,6,1,0,53,-53
51,510,6,37,250,306,-56
51,510,6,59,93,88,5
51,510,6,73,222,218,4
51,510,6,75,45,44,1
51,510,6,85,0,70,-70
51,510,8,31,51,113,-62
51,510,8,41,74,76,-2
51,510,9,1,77,0,77
51,510,10,5,0,67,-67
51,510,11,1,2324,1685,639
51,510,12,11,98,77,21
51,510,12,21,0,46,-46
51,510,12,31,70,65,5
51,510,12,57,114,124,-10
51,510,12,86,131,117,14
51,510,12,91,60,0,60
51,510,12,95,55,95,-40
51,510,12,99,63,96,-33
51,510,12,103,62,63,-1
51,510,13,89,0,56,-56
51,510,13,121,122,111,11
51,510,15,3,154,121,33
51,510,17,31,176,140,36
51,510,18,97,44,0,44
51,510,24,3,219,260,-41
51,510,24,5,81,121,-40
51,510,24,9,46,56,-10
51,510,24,17,191,208,-17
51,510,24,21,0,95,-95
51,510,24,27,78,149,-71
51,510,24,31,977,958,19
51,510,24,33,1402,1823,-421
51,510,24,37,55,0,55
51,510,24,510,136,131,5
51,510,25,17,121,116,5
51,510,25,25,90,64,26
51,510,32,3,67,61,6
51,510,34,17,83,54,29
51,510,35,1,0,50,-50
51,510,36,47,87,86,1
51,510,36,61,140,98,42
51,510,36,81,103,69,34
51,510,36,103,0,49,-49
51,510,37,51,72,0,72
51,510,37,63,0,66,-66
51,510,37,119,84,158,-74
51,510,37,133,70,0,70
51,510,37,183,94,103,-9
51,510,39,49,68,72,-4
51,510,42,3,98,117,-19
51,510,42,45,64,0,64
51,510,42,91,61,0,61
51,510,42,101,85,103,-18
51,510,45,19,51,88,-37
51,510,47,37,45,66,-21
51,510,48,29,110,85,25
51,510,48,113,65,123,-58
51,510,48,201,124,91,33
51,510,48,439,0,52,-52
51,510,48,453,86,102,-16
51,510,51,3,68,61,7
51,510,51,13,4237,2953,1284
51,510,51,41,49,59,-10
51,510,51,59,7029,10202,-3173
51,510,51,61,58,59,-1
51,510,51,87,88,134,-46
51,510,51,107,454,795,-341
51,510,51,153,1215,2469,-1254
51,510,51,177,91,128,-37
51,510,51,179,224,368,-144
51,510,51,540,0,52,-52
51,510,51,600,69,111,-42
51,510,51,610,55,99,-44
51,510,51,683,80,75,5
51,510,51,685,0,53,-53
51,510,51,700,53,0,53
51,510,51,710,79,67,12
51,510,51,760,112,139,-27
51,510,51,810,133,162,-29
51,510,53,33,118,163,-45
51,510,53,53,0,71,-71
51,520,47,163,478,685,-207
51,520,47,179,0,67,-67
51,520,51,173,50,0,50
51,520,51,191,510,480,30
51,530,51,163,193,316,-123
51,540,6,37,0,43,-43
51,540,8,31,0,51,-51
51,540,11,1,120,149,-29
51,540,17,31,54,57,-3
51,540,24,31,0,63,-63
51,540,25,17,0,57,-57
51,540,36,47,61,59,2
51,540,36,61,61,132,-71
51,540,51,3,2067,2616,-549
51,540,51,13,84,81,3
51,540,51,15,0,54,-54
51,540,51,59,157,99,58
51,540,51,65,132,222,-90
51,540,51,79,103,172,-69
51,540,51,87,58,89,-31
51,540,51,109,0,114,-114
51,540,51,125,50,61,-11
51,540,51,137,0,80,-80
51,540,51,510,52,0,52
51,540,51,760,115,215,-100
51,540,51,810,0,51,-51
51,540,51,820,55,136,-81
51,540,53,33,0,50,-50
51,550,4,13,82,69,13
51,550,6,37,75,105,-30
51,550,6,73,494,374,120
51,550,6,111,93,0,93
51,550,9,11,138,68,70
51,550,12,11,74,0,74
51,550,12,19,93,85,8
51,550,12,31,285,282,3
51,550,12,33,144,68,76
51,550,12,57,92,124,-32
51,550,12,86,82,0,82
51,550,12,95,0,90,-90
51,550,12,109,0,93,-93
51,550,13,39,120,101,19
51,550,13,135,0,56,-56
51,550,15,3,276,185,91
51,550,17,97,87,0,87
51,550,24,3,103,110,-7
51,550,24,31,99,85,14
51,550,24,33,101,109,-8
51,550,24,37,86,82,4
51,550,36,5,79,0,79
51,550,36,47,99,58,41
51,550,37,29,111,124,-13
51,550,37,51,74,0,74
51,550,37,53,307,575,-268
51,550,37,55,76,125,-49
51,550,37,119,82,103,-21
51,550,37,133,137,124,13
51,550,37,139,209,250,-41
51,550,37,183,98,190,-92
51,550,45,15,107,75,32
51,550,45,19,55,52,3
51,550,47,157,0,105,-105
51,550,48,29,101,95,6
51,550,48,201,70,98,-28
51,550,48,439,0,71,-71
51,550,51,13,0,58,-58
51,550,51,41,154,125,29
51,550,51,59,209,270,-61
51,550,51,87,124,106,18
51,550,51,93,148,261,-113
51,550,51,95,0,65,-65
51,550,51,107,85,93,-8
51,550,51,153,160,119,41
51,550,51,175,0,65,-65
51,550,51,177,61,0,61
51,550,51,179,64,0,64
51,550,51,199,109,141,-32
51,550,51,650,525,381,144
51,550,51,700,450,432,18
51,550,51,710,3556,3016,540
51,550,51,740,3027,2808,219
51,550,51,760,71,126,-55
51,550,51,800,1212,1579,-367
51,550,51,810,7314,5476,1838
51,550,53,35,104,100,4
51,570,51,41,880,800,80
51,570,51,53,141,187,-46
51,570,51,87,95,108,-13
51,570,51,149,173,238,-65
51,570,51,670,167,149,18
51,570,51,730,339,231,108
51,570,51,760,104,121,-17
51,580,51,5,298,338,-40
51,590,37,33,155,218,-63
51,590,37,81,92,195,-103
51,590,37,157,80,80,0
51,590,37,183,0,68,-68
51,590,51,83,141,0,141
51,590,51,143,1041,1410,-369
51,595,51,81,255,369,-114
51,600,24,31,51,82,-31
51,600,24,33,85,59,26
51,600,51,13,257,105,152
51,600,51,59,2114,2054,60
51,600,51,107,139,240,-101
51,600,51,153,171,258,-87
51,600,51,510,111,69,42
51,610,11,1,123,103,20
51,610,24,31,72,59,13
51,610,51,13,361,188,173
51,610,51,59,783,843,-60
51,610,51,107,135,150,-15
51,610,51,153,56,0,56
51,610,51,510,99,55,44
51,620,51,93,110,72,38
51,620,51,175,264,385,-121
51,620,51,800,142,193,-51
51,630,11,1,0,43,-43
51,630,51,13,61,0,61
51,630,51,33,124,229,-105
51,630,51,47,54,0,54
51,630,51,59,163,147,16
51,630,51,87,53,67,-14
51,630,51,99,109,142,-33
51,630,51,137,80,68,12
51,630,51,153,296,270,26
51,630,51,177,1585,1961,-376
51,630,51,179,1182,865,317
51,630,51,760,53,109,-56
51,640,51,35,273,327,-54
51,640,51,77,195,187,8
51,650,4,13,0,74,-74
51,650,6,37,74,0,74
51,650,6,73,134,116,18
51,650,8,41,56,67,-11
51,650,12,31,90,192,-102
51,650,12,57,58,0,58
51,650,13,67,0,54,-54
51,650,15,3,168,99,69
51,650,17,97,49,0,49
51,650,24,33,99,167,-68
51,650,32,3,63,86,-23
51,650,36,5,64,0,64
51,650,36,47,58,58,0
51,650,37,51,70,79,-9
51,650,37,119,104,110,-6
51,650,37,183,89,65,24
51,650,45,15,71,75,-4
51,650,48,29,107,123,-16
51,650,48,201,52,63,-11
51,650,48,451,60,0,60
51,650,51,41,67,113,-46
51,650,51,59,161,156,5
51,650,51,73,124,246,-122
51,650,51,87,112,123,-11
51,650,51,93,256,396,-140
51,650,51,95,163,263,-100
51,650,51,153,85,65,20
51,650,51,199,786,1116,-330
51,650,51,550,381,525,-144
51,650,51,700,5188,5435,-247
51,650,51,710,1170,830,340
51,650,51,735,144,211,-67
51,650,51,740,391,286,105
51,650,51,760,116,115,1
51,650,51,800,306,419,-113
51,650,51,810,787,723,64
51,660,51,3,0,53,-53
51,660,51,15,185,290,-105
51,660,51,59,77,116,-39
51,660,51,69,0,50,-50
51,660,51,87,0,52,-52
51,660,51,107,0,54,-54
51,660,51,139,61,62,-1
51,660,51,153,0,57,-57
51,660,51,165,1369,2267,-898
51,660,51,171,125,153,-28
51,660,51,760,0,56,-56
51,660,51,790,115,145,-30
51,660,51,820,0,52,-52
51,670,51,41,603,582,21
51,670,51,53,101,168,-67
51,670,51,87,172,103,69
51,670,51,149,449,599,-150
51,670,51,570,149,167,-18
51,670,51,730,402,381,21
51,670,51,760,219,141,78
51,678,51,163,222,340,-118
51,680,37,119,0,74,-74
51,680,37,183,0,80,-80
51,680,51,3,59,0,59
51,680,51,9,599,647,-48
51,680,51,11,202,184,18
51,680,51,19,1027,1433,-406
51,680,51,31,1501,1804,-303
51,680,51,41,0,74,-74
51,680,51,59,0,89,-89
51,680,51,87,0,68,-68
51,680,51,143,117,81,36
51,680,51,161,95,67,28
51,680,51,760,0,102,-102
51,680,51,770,76,148,-72
51,680,51,810,0,54,-54
51,683,24,31,77,66,11
51,683,24,33,176,84,92
51,683,51,13,63,74,-11
51,683,51,47,0,174,-174
51,683,51,59,1065,671,394
51,683,51,61,143,340,-197
51,683,51,107,317,213,104
51,683,51,153,2631,2836,-205
51,683,51,177,0,63,-63
51,683,51,179,77,152,-75
51,683,51,187,0,81,-81
51,683,51,510,75,80,-5
51,683,51,685,410,456,-46
51,685,24,33,66,67,-1
51,685,51,59,652,380,272
51,685,51,61,0,136,-136
51,685,51,107,158,190,-32
51,685,51,153,1051,1104,-53
51,685,51,179,0,60,-60
51,685,51,510,53,0,53
51,685,51,683,456,410,46
51,690,37,81,0,62,-62
51,690,51,89,919,890,29
51,700,4,13,58,122,-64
51,700,6,37,80,81,-1
51,700,6,73,111,134,-23
51,700,8,41,171,151,20
51,700,12,11,63,76,-13
51,700,12,31,78,160,-82
51,700,12,57,0,133,-133
51,700,12,86,66,0,66
51,700,12,95,0,91,-91
51,700,13,51,66,78,-12
51,700,13,89,0,73,-73
51,700,13,135,0,70,-70
51,700,15,3,229,200,29
51,700,17,31,51,0,51
51,700,24,3,54,78,-24
51,700,24,33,75,85,-10
51,700,32,3,73,89,-16
51,700,34,13,61,0,61
51,700,36,5,62,0,62
51,700,36,45,0,75,-75
51,700,36,47,101,0,101
51,700,36,81,79,0,79
51,700,37,51,151,172,-21
51,700,37,81,0,69,-69
51,700,37,119,56,122,-66
51,700,37,133,78,0,78
51,700,37,183,66,106,-40
51,700,39,49,0,72,-72
51,700,42,101,90,47,43
51,700,45,15,98,71,27
51,700,47,125,103,114,-11
51,700,48,27,96,137,-41
51,700,48,29,81,150,-69
51,700,48,141,136,138,-2
51,700,48,201,83,83,0
51,700,51,41,150,234,-84
51,700,51,59,152,194,-42
51,700,51,73,367,479,-112
51,700,51,85,0,64,-64
51,700,51,87,187,207,-20
51,700,51,93,394,465,-71
51,700,51,95,796,779,17
51,700,51,107,0,67,-67
51,700,51,127,0,115,-115
51,700,51,153,80,133,-53
51,700,51,181,0,60,-60
51,700,51,199,1633,1861,-228
51,700,51,510,0,53,-53
51,700,51,550,432,450,-18
51,700,51,650,5435,5188,247
51,700,51,710,833,795,38
51,700,51,730,59,76,-17
51,700,51,735,195,241,-46
51,700,51,740,306,433,-127
51,700,51,760,145,142,3
51,700,51,800,298,401,-103
51,700,51,810,655,752,-97
51,700,51,830,163,174,-11
51,700,53,53,108,195,-87
51,710,4,13,101,131,-30
51,710,6,31,0,106,-106
51,710,6,37,166,182,-16
51,710,6,65,60,82,-22
51,710,6,67,51,0,51
51,710,6,71,79,74,5
51,710,6,73,611,723,-112
51,710,6,111,56,81,-25
51,710,8,41,58,0,58
51,710,9,11,111,105,6
51,710,10,5,94,143,-49
51,710,11,1,126,165,-39
51,710,12,11,102,76,26
51,710,12,19,0,108,-108
51,710,12,31,315,546,-231
51,710,12,33,266,103,163
51,710,12,57,80,125,-45
51,710,12,86,54,69,-15
51,710,12,95,68,87,-19
51,710,12,103,0,74,-74
51,710,12,113,85,0,85
51,710,13,89,55,105,-50
51,710,13,121,75,60,15
51,710,13,135,55,80,-25
51,710,15,3,174,233,-59
51,710,17,31,138,114,24
51,710,17,97,166,148,18
51,710,24,3,122,143,-21
51,710,24,5,58,0,58
51,710,24,31,89,97,-8
51,710,24,33,112,152,-40
51,710,24,37,84,95,-11
51,710,24,510,64,44,20
51,710,25,25,0,49,-49
51,710,26,163,77,0,77
51,710,28,47,94,72,22
51,710,32,3,74,78,-4
51,710,34,13,69,0,69
51,710,36,5,103,0,103
51,710,36,47,155,95,60
51,710,36,61,61,51,10
51,710,36,81,113,69,44
51,710,36,91,98,0,98
51,710,36,103,53,0,53
51,710,37,51,0,61,-61
51,710,37,53,60,140,-80
51,710,37,119,74,148,-74
51,710,37,133,118,188,-70
51,710,37,139,0,117,-117
51,710,37,183,93,103,-10
51,710,42,101,80,74,6
51,710,45,15,270,100,170
51,710,45,19,86,0,86
51,710,47,157,77,83,-6
51,710,48,29,92,126,-34
51,710,48,113,74,133,-59
51,710,48,201,109,166,-57
51,710,48,355,65,0,65
51,710,48,439,83,86,-3
51,710,48,453,0,53,-53
51,710,51,3,51,58,-7
51,710,51,13,102,101,1
51,710,51,41,116,148,-32
51,710,51,59,330,345,-15
51,710,51,87,114,153,-39
51,710,51,93,80,127,-47
51,710,51,95,61,82,-21
51,710,51,107,53,96,-43
51,710,51,153,139,182,-43
51,710,51,177,62,0,62
51,710,51,179,0,110,-110
51,710,51,199,140,133,7
51,710,51,510,67,79,-12
51,710,51,550,3016,3556,-540
51,710,51,650,830,1170,-340
51,710,51,700,795,833,-38
51,710,51,740,1403,1634,-231
51,710,51,760,157,256,-99
51,710,51,800,517,783,-266
51,710,51,810,7215,7834,-619
51,710,53,29,0,60,-60
51,710,53,33,66,106,-40
51,710,53,35,133,115,18
51,720,51,195,329,248,81
51,730,37,51,64,0,64
51,730,51,41,822,1038,-216
51,730,51,53,397,473,-76
51,730,51,87,243,204,39
51,730,51,149,481,607,-126
51,730,51,183,90,80,10
51,730,51,570,231,339,-108
51,730,51,670,381,402,-21
51,730,51,700,76,59,17
51,730,51,760,322,326,-4
51,735,51,199,260,202,58
51,735,51,650,211,144,67
51,735,51,700,241,195,46
51,740,6,73,100,172,-72
51,740,12,31,65,154,-89
51,740,12,33,69,0,69
51,740,13,39,102,0,102
51,740,15,3,48,0,48
51,740,37,133,61,83,-22
51,740,48,29,87,0,87
51,740,51,41,0,53,-53
51,740,51,59,0,82,-82
51,740,51,93,122,202,-80
51,740,51,550,2808,3027,-219
51,740,51,650,286,391,-105
51,740,51,700,433,306,127
51,740,51,710,1634,1403,231
51,740,51,760,0,60,-60
51,740,51,800,1353,1472,-119
51,740,51,810,1253,1145,108
51,750,51,121,491,459,32
51,750,51,155,341,327,14
51,750,51,770,0,71,-71
51,760,4,13,58,49,9
51,760,6,37,145,143,2
51,760,6,73,55,63,-8
51,760,8,31,49,79,-30
51,760,11,1,242,233,9
51,760,12,11,53,0,53
51,760,12,31,0,60,-60
51,760,12,57,0,50,-50
51,760,12,95,0,58,-58
51,760,13,89,0,69,-69
51,760,13,121,90,99,-9
51,760,17,31,109,161,-52
51,760,24,3,0,58,-58
51,760,24,5,0,70,-70
51,760,24,31,133,116,17
51,760,24,33,133,147,-14
51,760,24,510,87,95,-8
51,760,25,17,59,45,14
51,760,25,25,44,47,-3
51,760,36,5,0,72,-72
51,760,36,47,231,204,27
51,760,36,61,166,128,38
51,760,36,81,99,65,34
51,760,36,103,84,0,84
51,760,37,51,0,55,-55
51,760,37,63,68,92,-24
51,760,37,67,54,0,54
51,760,37,81,74,0,74
51,760,37,119,123,174,-51
51,760,37,183,130,161,-31
51,760,41,51,0,50,-50
51,760,42,3,73,0,73
51,760,42,101,91,137,-46
51,760,45,19,82,51,31
51,760,45,79,45,0,45
51,760,47,37,57,62,-5
51,760,48,113,0,57,-57
51,760,48,201,73,57,16
51,760,48,453,0,84,-84
51,760,51,3,214,114,100
51,760,51,7,70,0,70
51,760,51,13,250,158,92
51,760,51,33,67,58,9
51,760,51,41,5585,6865,-1280
51,760,51,47,51,0,51
51,760,51,53,84,90,-6
51,760,51,59,665,370,295
51,760,51,61,56,0,56
51,760,51,65,57,0,57
51,760,51,73,61,0,61
51,760,51,75,203,208,-5
51,760,51,85,803,876,-73
51,760,51,87,7103,9624,-2521
51,760,51,95,166,97,69
51,760,51,101,71,60,11
51,760,51,107,179,140,39
51,760,51,109,63,74,-11
51,760,51,117,50,0,50
51,760,51,121,92,0,92
51,760,51,127,83,79,4
51,760,51,145,192,137,55
51,760,51,147,53,0,53
51,760,51,149,106,117,-11
51,760,51,153,240,164,76
51,760,51,161,55,0,55
51,760,51,177,172,104,68
51,760,51,179,186,115,71
51,760,51,199,104,0,104
51,760,51,510,139,112,27
51,760,51,540,215,115,100
51,760,51,550,126,71,55
51,760,51,570,121,104,17
51,760,51,630,109,53,56
51,760,51,650,115,116,-1
51,760,51,660,56,0,56
51,760,51,670,141,219,-78
51,760,51,680,102,0,102
51,760,51,700,142,145,-3
51,760,51,710,256,157,99
51,760,51,730,326,322,4
51,760,51,740,60,0,60
51,760,51,770,84,56,28
51,760,51,800,59,0,59
51,760,51,810,278,219,59
51,760,51,830,55,0,55
51,760,53,33,52,76,-24
51,770,37,81,59,72,-13
51,770,37,119,100,158,-58
51,770,37,183,56,71,-15
51,770,51,5,54,0,54
51,770,51,19,437,583,-146
51,770,51,23,446,607,-161
51,770,51,31,73,0,73
51,770,51,41,0,54,-54
51,770,51,59,72,54,18
51,770,51,63,0,50,-50
51,770,51,67,446,478,-32
51,770,51,87,52,79,-27
51,770,51,89,0,82,-82
51,770,51,121,292,251,41
51,770,51,153,60,0,60
51,770,51,161,2802,3425,-623
51,770,51,680,148,76,72
51,770,51,750,71,0,71
51,770,51,760,56,84,-28
51,770,51,775,745,829,-84
51,770,51,810,60,61,-1
51,775,51,19,54,65,-11
51,775,51,23,99,83,16
51,775,51,67,69,73,-4
51,775,51,121,168,90,78
51,775,51,161,822,936,-114
51,775,51,770,829,745,84
51,790,51,3,67,59,8
51,790,51,15,1261,1281,-20
51,790,51,163,69,0,69
51,790,51,165,110,114,-4
51,790,51,660,145,115,30
51,790,51,820,304,246,58
51,800,6,73,145,104,41
51,800,12,31,81,94,-13
51,800,15,3,102,0,102
51,800,24,33,0,64,-64
51,800,37,73,85,125,-40
51,800,37,119,0,60,-60
51,800,51,41,83,0,83
51,800,51,59,67,68,-1
51,800,51,93,552,535,17
51,800,51,95,0,76,-76
51,800,51,175,112,157,-45
51,800,51,199,91,85,6
51,800,51,550,1579,1212,367
51,800,51,620,193,142,51
51,800,51,650,419,306,113
51,800,51,700,401,298,103
51,800,51,710,783,517,266
51,800,51,740,1472,1353,119
51,800,51,760,0,59,-59
51,800,51,810,1169,791,378
51,810,4,13,181,247,-66
51,810,6,1,56,66,-10
51,810,6,13,55,0,55
51,810,6,29,61,69,-8
51,810,6,31,182,270,-88
51,810,6,37,325,226,99
51,810,6,53,0,98,-98
51,810,6,59,141,150,-9
51,810,6,65,152,105,47
51,810,6,67,68,0,68
51,810,6,71,94,123,-29
51,810,6,73,1556,1265,291
51,810,6,111,166,150,16
51,810,8,5,65,63,2
51,810,8,31,0,46,-46
51,810,8,41,134,143,-9
51,810,9,1,64,0,64
51,810,9,3,83,0,83
51,810,9,9,65,0,65
51,810,9,11,189,106,83
51,810,10,3,0,81,-81
51,810,11,1,161,149,12
51,810,12,5,104,67,37
51,810,12,9,86,83,3
51,810,12,11,185,151,34
51,810,12,19,139,245,-106
51,810,12,31,557,702,-145
51,810,12,33,346,294,52
51,810,12,57,153,300,-147
51,810,12,69,0,54,-54
51,810,12,71,74,127,-53
51,810,12,81,53,0,53
51,810,12,86,147,164,-17
51,810,12,87,83,79,4
51,810,12,91,135,88,47
51,810,12,95,121,184,-63
51,810,12,99,82,158,-76
51,810,12,101,0,66,-66
51,810,12,103,66,125,-59
51,810,12,105,0,69,-69
51,810,12,109,0,170,-170
51,810,12,113,93,101,-8
51,810,12,127,0,55,-55
51,810,13,39,146,116,30
51,810,13,51,58,64,-6
51,810,13,67,82,95,-13
51,810,13,89,72,73,-1
51,810,13,121,66,185,-119
51,810,13,135,0,106,-106
51,810,15,3,506,526,-20
51,810,17,31,176,153,23
51,810,17,97,236,183,53
51,810,21,111,68,0,68
51,810,24,3,269,236,33
51,810,24,5,76,86,-10
51,810,24,17,0,107,-107
51,810,24,27,0,84,-84
51,810,24,31,174,140,34
51,810,24,33,152,168,-16
51,810,24,37,173,256,-83
51,810,24,510,87,0,87
51,810,25,17,0,82,-82
51,810,26,125,75,0,75
51,810,26,163,48,0,48
51,810,28,47,142,146,-4
51,810,28,75,70,0,70
51,810,32,1,0,75,-75
51,810,32,3,118,171,-53
51,810,34,3,48,0,48
51,810,34,5,69,69,0
51,810,34,13,54,0,54
51,810,34,17,72,0,72
51,810,34,23,90,0,90
51,810,34,29,55,0,55
51,810,36,5,154,58,96
51,810,36,47,202,149,53
51,810,36,55,58,58,0
51,810,36,59,126,0,126
51,810,36,61,117,91,26
51,810,36,81,180,91,89
51,810,36,91,84,0,84
51,810,36,103,143,74,69
51,810,36,119,55,0,55
51,810,37,29,0,89,-89
51,810,37,51,170,148,22
51,810,37,53,245,537,-292
51,810,37,55,98,110,-12
51,810,37,67,56,70,-14
51,810,37,81,0,83,-83
51,810,37,119,167,231,-64
51,810,37,129,56,72,-16
51,810,37,133,270,264,6
51,810,37,139,138,241,-103
51,810,37,183,218,240,-22
51,810,39,35,92,0,92
51,810,39,49,58,105,-47
51,810,42,3,102,92,10
51,810,42,17,53,0,53
51,810,42,45,78,0,78
51,810,42,91,92,0,92
51,810,42,101,118,87,31
51,810,44,5,93,126,-33
51,810,45,13,87,95,-8
51,810,45,15,154,145,9
51,810,45,19,109,87,22
51,810,45,35,0,97,-97
51,810,45,51,63,50,13
51,810,45,63,0,59,-59
51,810,45,79,0,61,-61
51,810,47,157,222,175,47
51,810,48,27,0,94,-94
51,810,48,29,201,286,-85
51,810,48,85,85,93,-8
51,810,48,113,109,138,-29
51,810,48,121,0,76,-76
51,810,48,141,71,0,71
51,810,48,201,205,176,29
51,810,48,355,74,69,5
51,810,48,439,164,171,-7
51,810,48,453,58,101,-43
51,810,51,1,61,62,-1
51,810,51,3,0,103,-103
51,810,51,13,120,149,-29
51,810,51,41,252,372,-120
51,810,51,59,639,569,70
51,810,51,73,0,65,-65
51,810,51,85,68,0,68
51,810,51,87,286,291,-5
51,810,51,93,97,186,-89
51,810,51,95,152,212,-60
51,810,51,99,68,0,68
51,810,51,107,176,135,41
51,810,51,121,50,0,50
51,810,51,131,72,81,-9
51,810,51,153,299,270,29
51,810,51,175,0,97,-97
51,810,51,177,103,96,7
51,810,51,179,138,140,-2
51,810,51,199,230,199,31
51,810,51,510,162,133,29
51,810,51,540,51,0,51
51,810,51,550,5476,7314,-1838
51,810,51,650,723,787,-64
51,810,51,680,54,0,54
51,810,51,700,752,655,97
51,810,51,710,7834,7215,619
51,810,51,740,1145,1253,-108
51,810,51,760,219,278,-59
51,810,51,770,61,60,1
51,810,51,800,791,1169,-378
51,810,53,29,149,211,-62
51,810,53,33,107,114,-7
51,810,53,35,278,192,86
51,810,53,53,96,54,42
51,810,53,61,58,95,-37
51,820,51,3,278,203,75
51,820,51,15,826,1222,-396
51,820,51,125,74,0,74
51,820,51,165,91,82,9
51,820,51,540,136,55,81
51,820,51,660,52,0,52
51,820,51,790,246,304,-58
51,830,51,59,53,0,53
51,830,51,95,776,914,-138
51,830,51,199,235,177,58
51,830,51,700,174,163,11
51,830,51,760,0,55,-55
51,840,51,43,120,95,25
51,840,51,59,114,81,33
51,840,51,69,1461,2149,-688
51,840,51,107,192,129,63
51,840,51,153,87,65,22
51,840,51,171,141,130,11
51,840,51,187,105,124,-19
51,840,54,3,171,364,-193
51,840,54,27,0,68,-68
51,840,54,37,0,61,-61
53,1,53,5,94,176,-82
53,1,53,21,227,251,-24
53,1,53,25,352,562,-210
53,1,53,63,85,105,-20
53,3,16,57,78,78,0
53,3,16,69,872,820,52
53,3,53,33,62,47,15
53,3,53,63,132,126,6
53,3,53,75,93,0,93
53,5,4,13,225,253,-28
53,5,6,37,180,92,88
53,5,6,59,83,0,83
53,5,6,65,68,0,68
53,5,6,67,69,0,69
53,5,6,73,112,82,30
53,5,16,1,99,173,-74
53,5,16,27,78,0,78
53,5,16,55,55,77,-22
53,5,32,3,153,169,-16
53,5,41,5,74,67,7
53,5,41,17,56,63,-7
53,5,41,49,0,69,-69
53,5,41,51,129,97,32
53,5,41,59,390,315,75
53,5,41,67,114,83,31
53,5,48,201,0,71,-71
53,5,48,479,0,109,-109
53,5,49,35,106,0,106
53,5,49,49,0,77,-77
53,5,53,1,176,94,82
53,5,53,7,84,96,-12
53,5,53,11,255,237,18
53,5,53,17,63,0,63
53,5,53,21,5088,5439,-351
53,5,53,25,383,266,117
53,5,53,33,689,690,-1
53,5,53,35,126,88,38
53,5,53,37,123,57,66
53,5,53,39,76,0,76
53,5,53,53,321,282,39
53,5,53,61,397,220,177
53,5,53,63,583,576,7
53,5,53,67,126,131,-5
53,5,53,71,489,403,86
53,5,53,73,108,65,43
53,5,53,75,125,72,53
53,5,53,77,1494,957,537
53,7,4,13,0,101,-101
53,7,6,37,74,0,74
53,7,53,5,96,84,12
53,7,53,17,2096,2640,-544
53,7,53,25,216,330,-114
53,7,53,33,864,408,456
53,7,53,35,65,0,65
53,7,53,37,92,94,-2
53,7,53,47,199,156,43
53,7,53,53,226,212,14
53,7,53,61,487,252,235
53,7,53,63,119,235,-116
53,7,53,67,53,68,-15
53,7,53,73,70,67,3
53,7,53,75,48,0,48
53,7,53,77,124,135,-11
53,9,4,13,122,103,19
53,9,6,37,137,0,137
53,9,6,59,62,0,62
53,9,6,65,67,0,67
53,9,6,73,120,55,65
53,9,15,3,52,0,52
53,9,32,3,0,56,-56
53,9,41,51,100,0,100
53,9,53,11,63,51,12
53,9,53,27,76,70,6
53,9,53,31,232,228,4
53,9,53,33,834,332,502
53,9,53,35,321,232,89
53,9,53,45,68,0,68
53,9,53,53,289,190,99
53,9,53,61,294,199,95
53,9,53,63,86,120,-34
53,9,53,67,112,103,9
53,9,53,73,83,130,-47
53,11,2,20,171,59,112
53,11,4,13,513,790,-277
53,11,4,15,0,65,-65
53,11,4,19,153,183,-30
53,11,4,21,58,155,-97
53,11,4,27,0,50,-50
53,11,6,1,280,70,210
53,11,6,7,63,0,63
53,11,6,13,220,0,220
53,11,6,19,94,0,94
53,11,6,29,89,0,89
53,11,6,37,867,284,583
53,11,6,53,54,0,54
53,11,6,59,432,150,282
53,11,6,61,76,66,10
53,11,6,65,292,190,102
53,11,6,67,270,96,174
53,11,6,71,158,112,46
53,11,6,73,529,293,236
53,11,6,75,123,0,123
53,11,6,77,96,0,96
53,11,6,81,147,0,147
53,11,6,83,63,0,63
53,11,6,85,476,139,337
53,11,6,87,65,0,65
53,11,6,89,64,0,64
53,11,6,95,58,0,58
53,11,6,97,117,0,117
53,11,6,99,72,0,72
53,11,6,111,126,0,126
53,11,8,5,63,73,-10
53,11,8,31,79,59,20
53,11,8,41,139,63,76
53,11,12,57,0,74,-74
53,11,12,95,57,0,57
53,11,12,103,59,0,59
53,11,15,1,101,66,35
53,11,15,3,392,164,228
53,11,15,9,63,0,63
53,11,16,1,175,380,-205
53,11,16,27,0,137,-137
53,11,16,55,0,93,-93
53,11,17,31,119,72,47
53,11,27,53,68,0,68
53,11,32,3,399,457,-58
53,11,32,31,143,109,34
53,11,35,1,76,0,76
53,11,41,3,121,70,51
53,11,41,5,2540,1718,822
53,11,41,7,124,79,45
53,11,41,9,209,176,33
53,11,41,17,278,385,-107
53,11,41,19,80,0,80
53,11,41,27,83,0,83
53,11,41,29,147,92,55
53,11,41,39,391,268,123
53,11,41,41,104,87,17
53,11,41,43,133,137,-4
53,11,41,47,499,390,109
53,11,41,51,7852,4722,3130
53,11,41,53,108,78,30
53,11,41,57,77,0,77
53,11,41,59,0,78,-78
53,11,41,65,98,0,98
53,11,41,67,2931,2001,930
53,11,41,71,148,144,4
53,11,45,83,0,152,-152
53,11,48,29,123,113,10
53,11,48,85,0,113,-113
53,11,48,113,66,106,-40
53,11,48,121,63,79,-16
53,11,48,201,173,78,95
53,11,48,439,101,86,15
53,11,48,453,136,103,33
53,11,49,35,210,180,30
53,11,49,49,100,104,-4
53,11,53,5,237,255,-18
53,11,53,9,51,63,-12
53,11,53,15,1868,3404,-1536
53,11,53,21,0,80,-80
53,11,53,25,88,0,88
53,11,53,27,94,112,-18
53,11,53,29,64,0,64
53,11,53,33,1374,1130,244
53,11,53,35,181,140,41
53,11,53,37,72,0,72
53,11,53,39,98,177,-79
53,11,53,41,171,351,-180
53,11,53,45,62,84,-22
53,11,53,49,127,264,-137
53,11,53,53,770,634,136
53,11,53,57,0,78,-78
53,11,53,59,346,422,-76
53,11,53,61,438,416,22
53,11,53,63,416,470,-54
53,11,53,67,397,406,-9
53,11,53,71,71,55,16
53,11,53,73,221,142,79
53,11,53,75,97,59,38
53,11,53,77,151,122,29
53,13,53,71,112,127,-15
53,15,4,13,96,147,-51
53,15,6,37,86,0,86
53,15,6,73,80,0,80
53,15,32,3,68,0,68
53,15,41,5,196,106,90
53,15,41,7,63,89,-26
53,15,41,9,393,255,138
53,15,41,17,0,71,-71
53,15,41,47,79,0,79
53,15,41,51,540,273,267
53,15,41,67,216,168,48
53,15,53,11,3404,1868,1536
53,15,53,27,0,60,-60
53,15,53,33,270,206,64
53,15,53,41,349,585,-236
53,15,53,49,82,83,-1
53,15,53,53,226,141,85
53,15,53,61,179,111,68
53,15,53,63,86,121,-35
53,15,53,67,133,196,-63
53,15,53,69,96,108,-12
53,15,53,73,0,74,-74
53,15,53,77,56,0,56
53,17,53,5,0,63,-63
53,17,53,7,2640,2096,544
53,17,53,25,193,344,-151
53,17,53,33,312,176,136
53,17,53,47,259,195,64
53,17,53,53,62,66,-4
53,17,53,61,178,108,70
53,17,53,63,95,145,-50
53,17,53,77,102,71,31
53,19,53,47,68,0,68
53,19,53,63,73,114,-41
53,19,53,65,102,100,2
53,21,6,37,148,0,148
53,21,32,3,96,0,96
53,21,41,59,112,92,20
53,21,53,1,251,227,24
53,21,53,5,5439,5088,351
53,21,53,11,80,0,80
53,21,53,25,255,189,66
53,21,53,33,233,207,26
53,21,53,53,125,76,49
53,21,53,61,133,0,133
53,21,53,63,146,219,-73
53,21,53,71,301,263,38
53,21,53,77,557,191,366
53,25,4,13,0,102,-102
53,25,6,37,70,0,70
53,25,16,55,0,70,-70
53,25,32,3,80,0,80
53,25,53,1,562,352,210
53,25,53,5,266,383,-117
53,25,53,7,330,216,114
53,25,53,11,0,88,-88
53,25,53,17,344,193,151
53,25,53,21,189,255,-66
53,25,53,33,496,250,246
53,25,53,37,94,135,-41
53,25,53,47,176,110,66
53,25,53,53,264,108,156
53,25,53,57,65,0,65
53,25,53,61,357,197,160
53,25,53,63,345,407,-62
53,25,53,67,0,65,-65
53,25,53,73,0,55,-55
53,25,53,77,360,320,40
53,27,4,13,56,79,-23
53,27,6,73,57,0,57
53,27,53,9,70,76,-6
53,27,53,11,112,94,18
53,27,53,15,60,0,60
53,27,53,33,680,266,414
53,27,53,35,128,0,128
53,27,53,41,174,175,-1
53,27,53,45,288,241,47
53,27,53,49,114,129,-15
53,27,53,53,582,283,299
53,27,53,61,254,133,121
53,27,53,63,94,100,-6
53,27,53,67,892,861,31
53,27,53,73,0,57,-57
53,29,4,13,135,148,-13
53,29,6,29,74,0,74
53,29,6,31,297,246,51
53,29,6,37,191,89,102
53,29,6,59,104,62,42
53,29,6,65,146,67,79
53,29,6,71,73,63,10
53,29,6,73,524,423,101
53,29,6,111,100,75,25
53,29,12,19,112,138,-26
53,29,12,31,291,120,171
53,29,12,33,143,104,39
53,29,15,3,270,120,150
53,29,16,1,0,86,-86
53,29,24,37,94,123,-29
53,29,32,3,74,101,-27
53,29,48,29,63,62,1
53,29,48,201,46,0,46
53,29,51,710,60,0,60
53,29,51,810,211,149,62
53,29,53,11,0,64,-64
53,29,53,33,1384,665,719
53,29,53,35,218,223,-5
53,29,53,53,167,167,0
53,29,53,57,625,760,-135
53,29,53,61,1980,1425,555
53,29,53,63,76,96,-20
53,29,53,67,70,0,70
53,29,53,73,167,304,-137
53,31,6,73,64,0,64
53,31,41,51,60,0,60
53,31,53,9,228,232,-4
53,31,53,33,599,239,360
53,31,53,35,435,370,65
53,31,53,45,0,50,-50
53,31,53,53,179,107,72
53,31,53,61,180,80,100
53,31,53,67,63,0,63
53,31,53,73,0,61,-61
53,33,1,73,108,66,42
53,33,1,89,81,100,-19
53,33,2,13,65,0,65
53,33,2,16,55,0,55
53,33,2,20,766,366,400
53,33,2,90,168,87,81
53,33,2,110,91,72,19
53,33,2,122,67,0,67
53,33,2,130,57,0,57
53,33,2,170,75,58,17
53,33,4,5,100,61,39
53,33,4,13,2652,3776,-1124
53,33,4,15,53,110,-57
53,33,4,19,678,730,-52
53,33,4,21,126,297,-171
53,33,4,25,90,162,-72
53,33,4,27,54,90,-36
53,33,5,7,193,124,69
53,33,5,119,74,67,7
53,33,5,143,90,76,14
53,33,6,1,2077,1280,797
53,33,6,7,110,64,46
53,33,6,13,881,550,331
53,33,6,17,119,119,0
53,33,6,19,248,138,110
53,33,6,23,56,62,-6
53,33,6,29,204,180,24
53,33,6,37,5607,3999,1608
53,33,6,39,58,0,58
53,33,6,41,261,151,110
53,33,6,53,191,102,89
53,33,6,55,57,0,57
53,33,6,59,2172,1579,593
53,33,6,61,215,178,37
53,33,6,65,878,932,-54
53,33,6,67,740,706,34
53,33,6,71,602,421,181
53,33,6,73,2572,2168,404
53,33,6,75,2057,1365,692
53,33,6,77,191,157,34
53,33,6,79,140,151,-11
53,33,6,81,1190,712,478
53,33,6,83,343,210,133
53,33,6,85,3592,2320,1272
53,33,6,87,199,154,45
53,33,6,89,85,0,85
53,33,6,95,185,73,112
53,33,6,97,259,190,69
53,33,6,99,81,71,10
53,33,6,107,57,71,-14
53,33,6,111,457,291,166
53,33,6,113,181,91,90
53,33,8,1,137,96,41
53,33,8,5,375,305,70
53,33,8,13,419,289,130
53,33,8,14,81,0,81
53,33,8,31,774,676,98
53,33,8,35,213,268,-55
53,33,8,41,289,314,-25
53,33,8,59,293,264,29
53,33,8,67,53,52,1
53,33,8,69,234,176,58
53,33,8,77,55,0,55
53,33,8,123,69,0,69
53,33,9,1,249,136,113
53,33,9,3,225,138,87
53,33,9,9,189,105,84
53,33,9,11,84,0,84
53,33,10,3,133,56,77
53,33,11,1,807,440,367
53,33,12,1,209,0,209
53,33,12,9,94,188,-94
53,33,12,11,480,355,125
53,33,12,21,56,59,-3
53,33,12,31,221,162,59
53,33,12,33,59,60,-1
53,33,12,57,324,307,17
53,33,12,69,56,0,56
53,33,12,71,125,117,8
53,33,12,73,81,0,81
53,33,12,81,91,94,-3
53,33,12,86,475,288,187
53,33,12,95,441,312,129
53,33,12,97,47,0,47
53,33,12,99,347,194,153
53,33,12,101,69,66,3
53,33,12,103,278,234,44
53,33,12,105,59,61,-2
53,33,12,109,0,89,-89
53,33,12,111,44,0,44
53,33,12,115,64,109,-45
53,33,12,117,134,83,51
53,33,12,119,0,51,-51
53,33,12,127,85,59,26
53,33,13,51,139,68,71
53,33,13,67,320,174,146
53,33,13,89,352,236,116
53,33,13,117,79,67,12
53,33,13,121,753,461,292
53,33,13,135,231,142,89
53,33,15,1,242,253,-11
53,33,15,3,1335,957,378
53,33,15,7,80,80,0
53,33,15,9,251,176,75
53,33,16,1,509,1079,-570
53,33,16,13,55,138,-83
53,33,16,17,66,103,-37
53,33,16,19,63,96,-33
53,33,16,27,100,174,-74
53,33,16,55,166,593,-427
53,33,16,57,110,107,3
53,33,16,69,51,0,51
53,33,16,83,81,65,16
53,33,17,19,281,63,218
53,33,17,31,2546,1389,1157
53,33,17,43,391,266,125
53,33,17,89,125,79,46
53,33,17,97,268,121,147
53,33,17,197,121,92,29
53,33,18,3,67,65,2
53,33,18,57,105,166,-61
53,33,18,97,303,203,100
53,33,18,105,160,45,115
53,33,18,141,90,0,90
53,33,18,157,157,0,157
53,33,19,103,93,0,93
53,33,19,153,117,83,34
53,33,19,169,85,0,85
53,33,20,91,334,173,161
53,33,20,173,151,96,55
53,33,21,67,85,0,85
53,33,21,111,184,110,74
53,33,22,33,107,0,107
53,33,22,51,71,0,71
53,33,22,55,47,0,47
53,33,22,71,151,163,-12
53,33,22,103,59,0,59
53,33,23,5,83,112,-29
53,33,24,3,171,103,68
53,33,24,5,150,64,86
53,33,24,27,131,65,66
53,33,24,31,480,317,163
53,33,24,33,143,96,47
53,33,24,510,263,108,155
53,33,25,1,0,59,-59
53,33,25,5,59,0,59
53,33,25,9,137,102,35
53,33,25,15,84,51,33
53,33,25,17,1236,632,604
53,33,25,21,314,112,202
53,33,25,23,56,0,56
53,33,25,25,664,412,252
53,33,25,27,157,110,47
53,33,26,65,111,0,111
53,33,26,77,49,69,-20
53,33,26,81,158,114,44
53,33,26,99,75,79,-4
53,33,26,125,418,261,157
53,33,26,161,474,191,283
53,33,26,163,275,193,82
53,33,27,3,58,0,58
53,33,27,37,144,159,-15
53,33,27,53,886,729,157
53,33,27,109,78,0,78
53,33,27,123,223,217,6
53,33,27,145,63,0,63
53,33,27,163,56,0,56
53,33,29,19,55,0,55
53,33,29,77,69,0,69
53,33,29,95,242,121,121
53,33,29,183,119,0,119
53,33,29,189,371,183,188
53,33,29,510,255,133,122
53,33,30,13,0,49,-49
53,33,30,29,95,195,-100
53,33,30,31,203,223,-20
53,33,30,49,0,102,-102
53,33,30,63,208,270,-62
53,33,30,81,0,69,-69
53,33,30,111,93,118,-25
53,33,31,55,205,216,-11
53,33,31,109,104,0,104
53,33,32,3,1457,1647,-190
53,33,32,31,367,364,3
53,33,33,9,92,0,92
53,33,33,11,106,65,41
53,33,34,3,295,103,192
53,33,34,5,69,0,69
53,33,34,7,53,0,53
53,33,34,13,160,83,77
53,33,34,17,592,234,358
53,33,34,21,147,64,83
53,33,34,23,467,124,343
53,33,34,25,105,52,53
53,33,34,27,211,69,142
53,33,34,29,48,0,48
53,33,34,35,120,0,120
53,33,34,39,82,0,82
53,33,35,1,357,222,135
53,33,35,13,82,53,29
53,33,35,49,84,134,-50
53,33,36,1,93,0,93
53,33,36,5,142,0,142
53,33,36,29,155,105,50
53,33,36,47,1271,786,485
53,33,36,55,182,96,86
53,33,36,59,176,68,108
53,33,36,61,1470,1093,377
53,33,36,67,112,61,51
53,33,36,71,51,0,51
53,33,36,81,642,193,449
53,33,36,91,65,0,65
53,33,36,103,165,132,33
53,33,36,109,136,50,86
53,33,36,119,254,91,163
53,33,37,21,104,68,36
53,33,37,51,69,59,10
53,33,37,63,280,96,184
53,33,37,81,99,84,15
53,33,37,119,439,305,134
53,33,37,129,51,0,51
53,33,37,133,71,0,71
53,33,37,135,109,72,37
53,33,37,183,546,338,208
53,33,38,17,100,63,37
53,33,39,35,325,193,132
53,33,39,49,522,377,145
53,33,39,61,321,180,141
53,33,39,113,79,80,-1
53,33,39,153,75,57,18
53,33,39,165,72,0,72
53,33,40,27,82,0,82
53,33,40,109,197,168,29
53,33,40,143,110,118,-8
53,33,41,3,199,136,63
53,33,41,5,523,539,-16
53,33,41,7,73,104,-31
53,33,41,11,51,48,3
53,33,41,17,203,661,-458
53,33,41,19,66,70,-4
53,33,41,27,0,56,-56
53,33,41,29,143,227,-84
53,33,41,33,0,51,-51
53,33,41,35,50,60,-10
53,33,41,39,402,436,-34
53,33,41,41,0,78,-78
53,33,41,43,71,86,-15
53,33,41,47,217,240,-23
53,33,41,51,1986,2251,-265
53,33,41,53,62,67,-5
53,33,41,59,65,65,0
53,33,41,67,1240,1089,151
53,33,41,71,80,112,-32
53,33,42,3,567,301,266
53,33,42,17,78,0,78
53,33,42,27,76,0,76
53,33,42,29,113,80,33
53,33,42,43,0,63,-63
53,33,42,45,100,69,31
53,33,42,71,64,0,64
53,33,42,91,224,105,119
53,33,42,101,498,315,183
53,33,44,7,155,90,65
53,33,45,15,72,70,2
53,33,45,19,255,150,105
53,33,45,35,72,0,72
53,33,45,45,75,74,1
53,33,45,79,63,0,63
53,33,46,99,64,0,64
53,33,46,103,0,74,-74
53,33,47,37,352,292,60
53,33,47,65,79,66,13
53,33,47,93,84,77,7
53,33,47,157,171,107,64
53,33,47,187,84,129,-45
53,33,48,27,62,91,-29
53,33,48,29,495,423,72
53,33,48,41,80,0,80
53,33,48,85,896,492,404
53,33,48,113,1058,774,284
53,33,48,121,344,412,-68
53,33,48,141,200,133,67
53,33,48,157,241,168,73
53,33,48,167,74,0,74
53,33,48,201,1536,931,605
53,33,48,209,0,77,-77
53,33,48,303,57,0,57
53,33,48,339,110,153,-43
53,33,48,355,66,0,66
53,33,48,439,560,526,34
53,33,48,453,1316,1058,258
53,33,48,491,291,443,-152
53,33,49,5,52,0,52
53,33,49,11,131,87,44
53,33,49,35,804,802,2
53,33,49,43,55,56,-1
53,33,49,49,449,374,75
53,33,49,53,0,88,-88
53,33,49,57,70,102,-32
53,33,50,7,101,109,-8
53,33,51,3,54,0,54
53,33,51,13,338,193,145
53,33,51,59,804,385,419
53,33,51,87,89,0,89
53,33,51,107,228,203,25
53,33,51,121,54,0,54
53,33,51,153,119,78,41
53,33,51,510,163,118,45
53,33,51,540,50,0,50
53,33,51,710,106,66,40
53,33,51,760,76,52,24
53,33,51,810,114,107,7
53,33,53,3,47,62,-15
53,33,53,5,690,689,1
53,33,53,7,408,864,-456
53,33,53,9,332,834,-502
53,33,53,11,1130,1374,-244
53,33,53,15,206,270,-64
53,33,53,17,176,312,-136
53,33,53,21,207,233,-26
53,33,53,25,250,496,-246
53,33,53,27,266,680,-414
53,33,53,29,665,1384,-719
53,33,53,31,239,599,-360
53,33,53,35,2279,4295,-2016
53,33,53,37,643,1288,-645
53,33,53,39,0,59,-59
53,33,53,41,251,469,-218
53,33,53,45,276,707,-431
53,33,53,47,130,327,-197
53,33,53,49,45,187,-142
53,33,53,53,18249,31355,-13106
53,33,53,55,170,374,-204
53,33,53,57,606,1127,-521
53,33,53,61,20300,33005,-12705
53,33,53,63,1665,2857,-1192
53,33,53,65,79,162,-83
53,33,53,67,2087,3219,-1132
53,33,53,71,185,358,-173
53,33,53,73,1678,2389,-711
53,33,53,75,437,283,154
53,33,53,77,837,1013,-176
53,33,55,25,608,278,330
53,33,55,79,261,170,91
53,33,55,87,45,0,45
53,33,55,133,106,67,39
53,35,2,20,96,57,39
53,35,4,13,294,443,-149
53,35,4,19,64,135,-71
53,35,4,21,0,77,-77
53,35,6,1,157,65,92
53,35,6,13,89,0,89
53,35,6,19,63,0,63
53,35,6,29,128,0,128
53,35,6,31,0,73,-73
53,35,6,37,433,257,176
53,35,6,53,85,0,85
53,35,6,59,201,109,92
53,35,6,65,194,194,0
53,35,6,67,95,76,19
53,35,6,71,217,123,94
53,35,6,73,1088,922,166
53,35,6,77,62,0,62
53,35,6,81,71,0,71
53,35,6,85,140,0,140
53,35,6,95,78,0,78
53,35,6,111,147,61,86
53,35,8,41,73,86,-13
53,35,9,11,390,230,160
53,35,11,1,76,0,76
53,35,12,9,0,82,-82
53,35,12,31,102,156,-54
53,35,12,33,59,88,-29
53,35,12,57,0,60,-60
53,35,12,95,0,63,-63
53,35,13,39,171,202,-31
53,35,15,3,802,474,328
53,35,16,1,78,115,-37
53,35,16,55,0,82,-82
53,35,17,31,93,60,33
53,35,17,97,90,83,7
53,35,24,3,0,82,-82
53,35,24,31,87,0,87
53,35,32,3,185,191,-6
53,35,36,91,258,0,258
53,35,37,133,62,131,-69
53,35,41,5,58,54,4
53,35,41,17,0,78,-78
53,35,41,39,61,81,-20
53,35,41,47,59,0,59
53,35,41,51,140,132,8
53,35,41,67,138,123,15
53,35,45,15,306,244,62
53,35,45,19,88,0,88
53,35,45,35,0,86,-86
53,35,48,29,129,129,0
53,35,48,113,74,0,74
53,35,48,201,155,77,78
53,35,48,439,0,69,-69
53,35,48,453,80,80,0
53,35,49,35,81,55,26
53,35,51,59,101,125,-24
53,35,51,550,100,104,-4
53,35,51,710,115,133,-18
53,35,51,810,192,278,-86
53,35,53,5,88,126,-38
53,35,53,7,0,65,-65
53,35,53,9,232,321,-89
53,35,53,11,140,181,-41
53,35,53,27,0,128,-128
53,35,53,29,223,218,5
53,35,53,31,370,435,-65
53,35,53,33,4295,2279,2016
53,35,53,37,69,86,-17
53,35,53,41,0,75,-75
53,35,53,45,823,1381,-558
53,35,53,53,2920,2700,220
53,35,53,57,63,107,-44
53,35,53,61,976,739,237
53,35,53,63,178,277,-99
53,35,53,67,349,392,-43
53,35,53,73,165,186,-21
53,35,53,75,50,0,50
53,35,53,77,74,92,-18
53,37,4,13,0,58,-58
53,37,53,5,57,123,-66
53,37,53,7,94,92,2
53,37,53,11,0,72,-72
53,37,53,25,135,94,41
53,37,53,33,1288,643,645
53,37,53,35,86,69,17
53,37,53,53,370,302,68
53,37,53,61,407,210,197
53,37,53,63,80,138,-58
53,37,53,67,57,124,-67
53,37,53,73,47,0,47
53,37,53,77,332,354,-22
53,39,41,5,58,0,58
53,39,41,27,194,178,16
53,39,41,51,172,57,115
53,39,41,65,267,194,73
53,39,53,5,0,76,-76
53,39,53,11,177,98,79
53,39,53,33,59,0,59
53,39,53,59,135,96,39
53,39,53,77,64,64,0
53,41,4,13,54,76,-22
53,41,6,37,68,0,68
53,41,41,5,73,0,73
53,41,41,51,73,47,26
53,41,41,67,63,0,63
53,41,53,11,351,171,180
53,41,53,15,585,349,236
53,41,53,27,175,174,1
53,41,53,33,469,251,218
53,41,53,35,75,0,75
53,41,53,45,93,80,13
53,41,53,53,801,387,414
53,41,53,61,165,79,86
53,41,53,63,88,88,0
53,41,53,67,1704,1480,224
53,41,53,77,68,64,4
53,43,53,63,367,362,5
53,45,4,13,51,119,-68
53,45,6,37,72,0,72
53,45,6,73,86,0,86
53,45,53,9,0,68,-68
53,45,53,11,84,62,22
53,45,53,27,241,288,-47
53,45,53,31,50,0,50
53,45,53,33,707,276,431
53,45,53,35,1381,823,558
53,45,53,41,80,93,-13
53,45,53,53,883,568,315
53,45,53,61,198,142,56
53,45,53,63,66,58,8
53,45,53,67,1191,920,271
53,47,53,7,156,199,-43
53,47,53,17,195,259,-64
53,47,53,19,0,68,-68
53,47,53,25,110,176,-66
53,47,53,33,327,130,197
53,47,53,53,122,68,54
53,47,53,57,57,0,57
53,47,53,61,232,91,141
53,47,53,63,178,246,-68
53,47,53,77,148,0,148
53,49,41,5,69,0,69
53,49,41,7,219,118,101
53,49,41,51,96,0,96
53,49,53,11,264,127,137
53,49,53,15,83,82,1
53,49,53,27,129,114,15
53,49,53,33,187,45,142
53,49,53,53,110,54,56
53,49,53,67,52,68,-16
53,51,16,17,142,169,-27
53,51,16,55,0,69,-69
53,51,53,63,445,427,18
53,53,1,45,85,128,-43
53,53,1,89,68,87,-19
53,53,1,113,0,113,-113
53,53,2,20,533,329,204
53,53,2,90,245,144,101
53,53,2,170,121,59,62
53,53,4,3,93,178,-85
53,53,4,5,64,0,64
53,53,4,13,1106,1868,-762
53,53,4,15,57,128,-71
53,53,4,19,266,323,-57
53,53,4,21,78,314,-236
53,53,4,25,65,108,-43
53,53,4,27,68,114,-46
53,53,5,119,59,0,59
53,53,6,1,340,186,154
53,53,6,7,56,0,56
53,53,6,13,243,108,135
53,53,6,19,162,146,16
53,53,6,29,161,109,52
53,53,6,37,1403,828,575
53,53,6,53,142,108,34
53,53,6,59,605,395,210
53,53,6,61,120,80,40
53,53,6,65,560,475,85
53,53,6,67,365,313,52
53,53,6,71,567,385,182
53,53,6,73,943,575,368
53,53,6,75,108,0,108
53,53,6,77,141,79,62
53,53,6,79,59,0,59
53,53,6,81,113,0,113
53,53,6,83,70,0,70
53,53,6,85,304,148,156
53,53,6,87,58,0,58
53,53,6,95,128,120,8
53,53,6,97,121,0,121
53,53,6,99,83,0,83
53,53,6,107,90,0,90
53,53,6,111,165,104,61
53,53,8,1,0,66,-66
53,53,8,5,123,111,12
53,53,8,13,64,63,1
53,53,8,31,121,103,18
53,53,8,35,0,89,-89
53,53,8,41,689,638,51
53,53,8,59,90,58,32
53,53,8,69,71,0,71
53,53,11,1,79,63,16
53,53,12,9,63,118,-55
53,53,12,11,132,122,10
53,53,12,31,118,109,9
53,53,12,33,67,0,67
53,53,12,57,112,219,-107
53,53,12,71,0,58,-58
53,53,12,86,116,94,22
53,53,12,91,97,84,13
53,53,12,95,112,161,-49
53,53,12,99,51,70,-19
53,53,12,101,61,79,-18
53,53,12,103,77,96,-19
53,53,12,105,83,0,83
53,53,12,113,0,74,-74
53,53,13,51,103,85,18
53,53,13,53,90,0,90
53,53,13,67,71,0,71
53,53,13,73,88,117,-29
53,53,13,89,62,56,6
53,53,13,121,57,77,-20
53,53,13,135,94,71,23
53,53,13,179,266,232,34
53,53,13,215,212,245,-33
53,53,13,245,142,0,142
53,53,15,1,148,89,59
53,53,15,3,1384,1171,213
53,53,15,9,82,0,82
53,53,16,1,182,317,-135
53,53,16,17,0,94,-94
53,53,16,27,69,180,-111
53,53,16,55,141,192,-51
53,53,17,31,305,221,84
53,53,17,43,0,54,-54
53,53,17,113,0,73,-73
53,53,17,163,0,107,-107
53,53,18,97,68,67,1
53,53,20,61,252,155,97
53,53,20,103,156,122,34
53,53,20,161,0,99,-99
53,53,21,47,217,117,100
53,53,21,93,0,117,-117
53,53,22,33,60,0,60
53,53,22,115,130,152,-22
53,53,24,3,113,116,-3
53,53,24,31,121,103,18
53,53,24,33,59,70,-11
53,53,25,17,76,69,7
53,53,26,125,0,62,-62
53,53,27,53,82,72,10
53,53,29,95,71,73,-2
53,53,29,169,144,239,-95
53,53,29,189,95,0,95
53,53,30,29,69,98,-29
53,53,30,31,86,60,26
53,53,30,49,0,54,-54
53,53,30,63,62,72,-10
53,53,30,111,80,65,15
53,53,31,55,76,67,9
53,53,32,3,667,932,-265
53,53,32,31,187,148,39
53,53,34,5,98,0,98
53,53,35,1,91,113,-22
53,53,36,5,61,0,61
53,53,36,29,72,0,72
53,53,36,45,207,193,14
53,53,36,47,113,65,48
53,53,36,61,82,0,82
53,53,36,71,57,0,57
53,53,36,81,86,57,29
53,53,36,103,55,0,55
53,53,37,51,394,515,-121
53,53,37,85,125,162,-37
53,53,37,93,0,131,-131
53,53,37,119,61,0,61
53,53,37,125,0,130,-130
53,53,37,133,0,64,-64
53,53,37,183,75,100,-25
53,53,39,35,59,0,59
53,53,39,49,0,76,-76
53,53,40,31,233,332,-99
53,53,40,109,86,77,9
53,53,40,143,65,0,65
53,53,41,5,202,167,35
53,53,41,7,0,63,-63
53,53,41,17,97,165,-68
53,53,41,19,61,59,2
53,53,41,29,110,79,31
53,53,41,39,186,213,-27
53,53,41,43,56,80,-24
53,53,41,47,144,115,29
53,53,41,51,477,422,55
53,53,41,67,359,331,28
53,53,41,71,0,59,-59
53,53,42,3,62,59,3
53,53,42,101,0,63,-63
53,53,45,15,0,82,-82
53,53,45,19,83,81,2
53,53,45,79,124,185,-61
53,53,47,125,329,338,-9
53,53,47,157,83,73,10
53,53,48,27,443,602,-159
53,53,48,29,555,632,-77
53,53,48,85,114,123,-9
53,53,48,99,167,224,-57
53,53,48,113,139,229,-90
53,53,48,121,78,125,-47
53,53,48,141,655,594,61
53,53,48,187,72,97,-25
53,53,48,201,271,296,-25
53,53,48,339,78,102,-24
53,53,48,355,0,79,-79
53,53,48,439,204,317,-113
53,53,48,453,189,143,46
53,53,48,491,77,162,-85
53,53,49,11,103,110,-7
53,53,49,35,294,246,48
53,53,49,49,132,123,9
53,53,49,53,0,77,-77
53,53,49,57,0,103,-103
53,53,51,13,0,63,-63
53,53,51,41,0,94,-94
53,53,51,59,248,239,9
53,53,51,149,0,121,-121
53,53,51,153,90,0,90
53,53,51,510,71,0,71
53,53,51,700,195,108,87
53,53,51,810,54,96,-42
53,53,53,5,282,321,-39
53,53,53,7,212,226,-14
53,53,53,9,190,289,-99
53,53,53,11,634,770,-136
53,53,53,15,141,226,-85
53,53,53,17,66,62,4
53,53,53,21,76,125,-49
53,53,53,25,108,264,-156
53,53,53,27,283,582,-299
53,53,53,29,167,167,0
53,53,53,31,107,179,-72
53,53,53,33,31355,18249,13106
53,53,53,35,2700,2920,-220
53,53,53,37,302,370,-68
53,53,53,41,387,801,-414
53,53,53,45,568,883,-315
53,53,53,47,68,122,-54
53,53,53,49,54,110,-56
53,53,53,57,189,216,-27
53,53,53,61,2569,1755,814
53,53,53,63,820,1090,-270
53,53,53,65,0,117,-117
53,53,53,67,4652,7155,-2503
53,53,53,71,76,93,-17
53,53,53,73,403,489,-86
53,53,53,75,168,82,86
53,53,53,77,373,453,-80
53,53,55,79,65,0,65
53,55,53,33,374,170,204
53,55,53,57,83,112,-29
53,55,53,61,113,0,113
53,55,53,73,116,108,8
53,57,4,13,93,183,-90
53,57,4,19,0,74,-74
53,57,6,37,175,85,90
53,57,6,59,57,0,57
53,57,6,65,65,56,9
53,57,6,73,136,103,33
53,57,12,31,89,0,89
53,57,12,33,60,0,60
53,57,15,3,65,0,65
53,57,32,3,68,0,68
53,57,53,11,78,0,78
53,57,53,25,0,65,-65
53,57,53,29,760,625,135
53,57,53,33,1127,606,521
53,57,53,35,107,63,44
53,57,53,47,0,57,-57
53,57,53,53,216,189,27
53,57,53,55,112,83,29
53,57,53,61,2540,1614,926
53,57,53,63,70,138,-68
53,57,53,67,85,78,7
53,57,53,73,1320,1328,-8
53,59,41,27,85,0,85
53,59,41,51,104,59,45
53,59,53,11,422,346,76
53,59,53,39,96,135,-39
53,61,1,89,0,61,-61
53,61,2,20,175,98,77
53,61,4,13,846,1654,-808
53,61,4,15,0,95,-95
53,61,4,19,202,309,-107
53,61,4,21,78,234,-156
53,61,4,25,0,89,-89
53,61,4,27,0,72,-72
53,61,6,1,277,186,91
53,61,6,13,177,75,102
53,61,6,19,80,0,80
53,61,6,29,116,66,50
53,61,6,37,967,652,315
53,61,6,53,74,0,74
53,61,6,59,535,417,118
53,61,6,61,79,0,79
53,61,6,65,363,298,65
53,61,6,67,223,189,34
53,61,6,71,260,198,62
53,61,6,73,784,676,108
53,61,6,75,102,67,35
53,61,6,77,120,80,40
53,61,6,81,132,61,71
53,61,6,83,119,0,119
53,61,6,85,378,209,169
53,61,6,95,53,58,-5
53,61,6,97,86,0,86
53,61,6,111,118,120,-2
53,61,8,1,50,74,-24
53,61,8,5,102,105,-3
53,61,8,13,54,74,-20
53,61,8,31,80,90,-10
53,61,8,35,72,140,-68
53,61,8,41,128,135,-7
53,61,8,59,74,0,74
53,61,12,9,0,86,-86
53,61,12,11,112,0,112
53,61,12,31,91,102,-11
53,61,12,57,64,103,-39
53,61,12,86,102,0,102
53,61,12,95,84,91,-7
53,61,12,99,95,64,31
53,61,12,103,58,79,-21
53,61,13,121,58,97,-39
53,61,13,135,74,0,74
53,61,15,1,81,95,-14
53,61,15,3,420,244,176
53,61,15,9,0,65,-65
53,61,16,1,109,333,-224
53,61,16,17,0,64,-64
53,61,16,27,75,160,-85
53,61,16,55,88,315,-227
53,61,17,31,248,136,112
53,61,17,43,0,69,-69
53,61,17,97,68,0,68
53,61,18,97,52,0,52
53,61,20,173,98,107,-9
53,61,24,31,69,0,69
53,61,24,33,64,0,64
53,61,25,17,91,79,12
53,61,27,53,91,80,11
53,61,29,189,71,60,11
53,61,30,29,0,93,-93
53,61,30,31,62,61,1
53,61,30,49,0,71,-71
53,61,30,63,71,89,-18
53,61,32,3,468,625,-157
53,61,32,31,61,115,-54
53,61,35,1,74,81,-7
53,61,36,47,56,0,56
53,61,36,61,52,50,2
53,61,37,119,71,117,-46
53,61,37,183,0,89,-89
53,61,39,49,73,0,73
53,61,40,109,82,78,4
53,61,41,5,187,165,22
53,61,41,17,0,144,-144
53,61,41,29,0,77,-77
53,61,41,39,117,151,-34
53,61,41,43,0,60,-60
53,61,41,47,114,120,-6
53,61,41,51,218,305,-87
53,61,41,67,352,312,40
53,61,42,3,53,0,53
53,61,42,101,56,0,56
53,61,45,15,0,64,-64
53,61,45,19,58,89,-31
53,61,47,37,0,53,-53
53,61,48,29,123,162,-39
53,61,48,85,128,207,-79
53,61,48,113,181,148,33
53,61,48,121,121,106,15
53,61,48,201,246,230,16
53,61,48,339,0,71,-71
53,61,48,439,220,183,37
53,61,48,453,163,164,-1
53,61,48,491,0,174,-174
53,61,49,11,0,82,-82
53,61,49,35,243,237,6
53,61,49,49,131,171,-40
53,61,51,59,117,72,45
53,61,51,810,95,58,37
53,61,53,5,220,397,-177
53,61,53,7,252,487,-235
53,61,53,9,199,294,-95
53,61,53,11,416,438,-22
53,61,53,15,111,179,-68
53,61,53,17,108,178,-70
53,61,53,21,0,133,-133
53,61,53,25,197,357,-160
53,61,53,27,133,254,-121
53,61,53,29,1425,1980,-555
53,61,53,31,80,180,-100
53,61,53,33,33005,20300,12705
53,61,53,35,739,976,-237
53,61,53,37,210,407,-197
53,61,53,41,79,165,-86
53,61,53,45,142,198,-56
53,61,53,47,91,232,-141
53,61,53,53,1755,2569,-814
53,61,53,55,0,113,-113
53,61,53,57,1614,2540,-926
53,61,53,63,643,1249,-606
53,61,53,65,0,178,-178
53,61,53,67,464,667,-203
53,61,53,71,61,90,-29
53,61,53,73,1118,1388,-270
53,61,53,75,143,100,43
53,61,53,77,402,385,17
53,61,55,25,57,0,57
53,63,2,20,236,89,147
53,63,2,90,78,0,78
53,63,2,170,70,0,70
53,63,4,13,645,713,-68
53,63,4,19,149,180,-31
53,63,4,21,60,111,-51
53,63,4,27,0,54,-54
53,63,6,1,134,0,134
53,63,6,13,127,0,127
53,63,6,19,67,0,67
53,63,6,29,79,0,79
53,63,6,37,549,241,308
53,63,6,53,56,0,56
53,63,6,59,284,115,169
53,63,6,61,54,0,54
53,63,6,65,299,113,186
53,63,6,67,198,134,64
53,63,6,71,226,96,130
53,63,6,73,460,198,262
53,63,6,75,63,0,63
53,63,6,77,70,0,70
53,63,6,83,54,0,54
53,63,6,85,138,93,45
53,63,6,95,107,0,107
53,63,6,97,112,0,112
53,63,6,99,61,0,61
53,63,6,111,114,53,61
53,63,8,5,66,53,13
53,63,8,31,100,53,47
53,63,8,41,169,122,47
53,63,8,59,69,45,24
53,63,12,57,0,66,-66
53,63,15,3,221,121,100
53,63,15,9,66,0,66
53,63,16,1,270,269,1
53,63,16,9,68,75,-7
53,63,16,17,333,375,-42
53,63,16,21,58,0,58
53,63,16,27,68,71,-3
53,63,16,55,2473,2331,142
53,63,16,57,232,84,148
53,63,16,69,140,92,48
53,63,16,79,57,100,-43
53,63,17,31,65,60,5
53,63,20,173,70,0,70
53,63,27,53,56,0,56
53,63,30,13,95,0,95
53,63,30,29,170,122,48
53,63,30,31,77,56,21
53,63,30,49,58,0,58
53,63,30,53,65,0,65
53,63,30,63,265,155,110
53,63,30,81,57,0,57
53,63,30,111,92,111,-19
53,63,32,3,368,342,26
53,63,32,31,124,89,35
53,63,35,1,89,0,89
53,63,38,105,0,81,-81
53,63,41,5,191,117,74
53,63,41,17,108,87,21
53,63,41,29,64,0,64
53,63,41,39,199,84,115
53,63,41,47,137,81,56
53,63,41,51,440,217,223
53,63,41,59,95,69,26
53,63,41,67,239,195,44
53,63,48,29,140,127,13
53,63,48,85,66,0,66
53,63,48,113,77,0,77
53,63,48,201,100,52,48
53,63,48,439,62,94,-32
53,63,48,453,105,63,42
53,63,49,11,91,76,15
53,63,49,35,198,166,32
53,63,49,49,149,93,56
53,63,51,59,0,75,-75
53,63,53,1,105,85,20
53,63,53,3,126,132,-6
53,63,53,5,576,583,-7
53,63,53,7,235,119,116
53,63,53,9,120,86,34
53,63,53,11,470,416,54
53,63,53,15,121,86,35
53,63,53,17,145,95,50
53,63,53,19,114,73,41
53,63,53,21,219,146,73
53,63,53,25,407,345,62
53,63,53,27,100,94,6
53,63,53,29,96,76,20
53,63,53,33,2857,1665,1192
53,63,53,35,277,178,99
53,63,53,37,138,80,58
53,63,53,41,88,88,0
53,63,53,43,362,367,-5
53,63,53,45,58,66,-8
53,63,53,47,246,178,68
53,63,53,51,427,445,-18
53,63,53,53,1090,820,270
53,63,53,57,138,70,68
53,63,53,61,1249,643,606
53,63,53,65,1451,1589,-138
53,63,53,67,341,319,22
53,63,53,71,237,169,68
53,63,53,73,322,164,158
53,63,53,75,565,433,132
53,63,53,77,521,306,215
53,65,16,55,74,0,74
53,65,53,19,100,102,-2
53,65,53,33,162,79,83
53,65,53,53,117,0,117
53,65,53,61,178,0,178
53,65,53,63,1589,1451,138
53,67,2,20,191,80,111
53,67,2,90,88,0,88
53,67,4,3,0,71,-71
53,67,4,13,332,542,-210
53,67,4,19,75,98,-23
53,67,4,21,61,78,-17
53,67,6,1,141,65,76
53,67,6,13,104,0,104
53,67,6,19,64,0,64
53,67,6,37,402,216,186
53,67,6,59,189,61,128
53,67,6,65,167,111,56
53,67,6,67,108,93,15
53,67,6,71,157,75,82
53,67,6,73,277,195,82
53,67,6,81,71,0,71
53,67,6,85,80,0,80
53,67,6,97,63,0,63
53,67,8,41,226,227,-1
53,67,12,57,64,0,64
53,67,12,103,56,0,56
53,67,13,215,72,0,72
53,67,15,1,0,52,-52
53,67,15,3,440,305,135
53,67,16,1,0,113,-113
53,67,16,55,0,102,-102
53,67,17,31,98,70,28
53,67,20,61,89,0,89
53,67,20,103,87,108,-21
53,67,24,31,68,0,68
53,67,29,169,105,111,-6
53,67,32,3,173,244,-71
53,67,35,1,0,61,-61
53,67,36,45,139,0,139
53,67,36,47,56,0,56
53,67,37,51,228,195,33
53,67,41,5,80,103,-23
53,67,41,17,57,72,-15
53,67,41,29,79,0,79
53,67,41,39,119,76,43
53,67,41,47,90,76,14
53,67,41,51,255,254,1
53,67,41,67,163,159,4
53,67,47,125,139,123,16
53,67,48,27,209,199,10
53,67,48,29,150,140,10
53,67,48,141,262,141,121
53,67,48,201,85,69,16
53,67,48,439,65,82,-17
53,67,48,453,92,60,32
53,67,49,35,91,0,91
53,67,51,59,0,87,-87
53,67,53,5,131,126,5
53,67,53,7,68,53,15
53,67,53,9,103,112,-9
53,67,53,11,406,397,9
53,67,53,15,196,133,63
53,67,53,25,65,0,65
53,67,53,27,861,892,-31
53,67,53,29,0,70,-70
53,67,53,31,0,63,-63
53,67,53,33,3219,2087,1132
53,67,53,35,392,349,43
53,67,53,37,124,57,67
53,67,53,41,1480,1704,-224
53,67,53,45,920,1191,-271
53,67,53,49,68,52,16
53,67,53,53,7155,4652,2503
53,67,53,57,78,85,-7
53,67,53,61,667,464,203
53,67,53,63,319,341,-22
53,67,53,71,0,52,-52
53,67,53,73,210,196,14
53,67,53,75,69,0,69
53,67,53,77,176,129,47
53,69,53,15,108,96,12
53,71,4,13,0,63,-63
53,71,41,51,71,68,3
53,71,41,59,472,422,50
53,71,53,5,403,489,-86
53,71,53,11,55,71,-16
53,71,53,13,127,112,15
53,71,53,21,263,301,-38
53,71,53,33,358,185,173
53,71,53,53,93,76,17
53,71,53,61,90,61,29
53,71,53,63,169,237,-68
53,71,53,67,52,0,52
53,71,53,75,48,0,48
53,71,53,77,72,0,72
53,73,2,20,108,72,36
53,73,4,13,226,314,-88
53,73,4,19,66,107,-41
53,73,4,21,0,57,-57
53,73,6,1,82,0,82
53,73,6,13,85,0,85
53,73,6,37,293,150,143
53,73,6,59,141,58,83
53,73,6,65,108,84,24
53,73,6,67,53,0,53
53,73,6,71,63,0,63
53,73,6,73,272,151,121
53,73,6,75,55,0,55
53,73,6,85,90,0,90
53,73,6,87,61,0,61
53,73,15,3,89,61,28
53,73,16,1,69,91,-22
53,73,17,31,88,61,27
53,73,32,3,158,136,22
53,73,41,17,0,75,-75
53,73,41,39,61,0,61
53,73,41,51,181,181,0
53,73,41,67,0,70,-70
53,73,48,201,68,0,68
53,73,48,453,72,0,72
53,73,49,35,84,0,84
53,73,53,5,65,108,-43
53,73,53,7,67,70,-3
53,73,53,9,130,83,47
53,73,53,11,142,221,-79
53,73,53,15,74,0,74
53,73,53,25,55,0,55
53,73,53,27,57,0,57
53,73,53,29,304,167,137
53,73,53,31,61,0,61
53,73,53,33,2389,1678,711
53,73,53,35,186,165,21
53,73,53,37,0,47,-47
53,73,53,53,489,403,86
53,73,53,55,108,116,-8
53,73,53,57,1328,1320,8
53,73,53,61,1388,1118,270
53,73,53,63,164,322,-158
53,73,53,67,196,210,-14
53,73,53,77,77,80,-3
53,75,4,13,0,59,-59
53,75,16,1,0,66,-66
53,75,16,55,0,75,-75
53,75,16,57,495,439,56
53,75,16,69,73,89,-16
53,75,53,3,0,93,-93
53,75,53,5,72,125,-53
53,75,53,7,0,48,-48
53,75,53,11,59,97,-38
53,75,53,33,283,437,-154
53,75,53,35,0,50,-50
53,75,53,53,82,168,-86
53,75,53,61,100,143,-43
53,75,53,63,433,565,-132
53,75,53,67,0,69,-69
53,75,53,71,0,48,-48
53,75,53,77,58,61,-3
53,77,4,13,164,162,2
53,77,6,19,68,0,68
53,77,6,37,201,135,66
53,77,6,59,75,0,75
53,77,6,65,99,68,31
53,77,6,73,116,83,33
53,77,16,1,46,78,-32
53,77,32,3,74,125,-51
53,77,41,5,70,0,70
53,77,41,47,0,61,-61
53,77,41,51,82,86,-4
53,77,41,59,77,0,77
53,77,41,67,71,81,-10
53,77,48,479,0,420,-420
53,77,49,35,66,0,66
53,77,53,5,957,1494,-537
53,77,53,7,135,124,11
53,77,53,11,122,151,-29
53,77,53,15,0,56,-56
53,77,53,17,71,102,-31
53,77,53,21,191,557,-366
53,77,53,25,320,360,-40
53,77,53,33,1013,837,176
53,77,53,35,92,74,18
53,77,53,37,354,332,22
53,77,53,39,64,64,0
53,77,53,41,64,68,-4
53,77,53,47,0,148,-148
53,77,53,53,453,373,80
53,77,53,61,385,402,-17
53,77,53,63,306,521,-215
53,77,53,67,129,176,-47
53,77,53,71,0,72,-72
53,77,53,73,80,77,3
53,77,53,75,61,58,3
54,1,54,33,75,84,-9
54,1,54,83,155,168,-13
54,1,54,91,0,73,-73
54,1,54,97,93,80,13
54,3,11,1,52,0,52
54,3,24,1,64,0,64
54,3,24,3,94,69,25
54,3,24,5,135,61,74
54,3,24,13,85,0,85
54,3,24,21,451,281,170
54,3,24,31,252,79,173
54,3,24,33,135,53,82
54,3,24,43,1171,858,313
54,3,24,510,80,0,80
54,3,42,55,241,271,-30
54,3,45,51,0,71,-71
54,3,51,43,53,0,53
54,3,51,59,138,98,40
54,3,51,69,866,488,378
54,3,51,107,352,128,224
54,3,51,153,143,0,143
54,3,51,171,85,0,85
54,3,51,187,78,0,78
54,3,51,840,364,171,193
54,3,54,27,129,114,15
54,3,54,37,1518,1170,348
54,3,54,61,88,76,12
54,3,54,65,326,429,-103
54,5,54,39,175,289,-114
54,5,54,43,89,84,5
54,5,54,45,153,125,28
54,7,54,41,0,57,-57
54,7,54,67,69,0,69
54,9,39,81,146,178,-32
54,9,42,3,64,102,-38
54,9,42,125,82,111,-29
54,9,54,29,407,354,53
54,9,54,69,109,102,7
54,11,21,19,101,198,-97
54,11,21,67,0,51,-51
54,11,21,89,0,74,-74
54,11,21,111,0,53,-53
54,11,39,49,0,111,-111
54,11,39,87,551,690,-139
54,11,54,39,395,402,-7
54,11,54,43,209,144,65
54,11,54,53,180,394,-214
54,11,54,61,0,56,-56
54,11,54,79,479,532,-53
54,11,54,81,75,0,75
54,11,54,99,712,905,-193
54,13,54,87,0,68,-68
54,15,54,39,115,118,-3
54,17,54,33,141,185,-44
54,19,54,25,85,110,-25
54,19,54,39,227,279,-52
54,19,54,67,147,146,1
54,19,54,81,435,517,-82
54,23,54,31,123,165,-42
54,23,54,57,79,71,8
54,25,54,19,110,85,25
54,25,54,39,0,56,-56
54,25,54,63,199,161,38
54,25,54,81,79,90,-11
54,25,54,89,68,91,-23
54,27,51,69,145,158,-13
54,27,51,840,68,0,68
54,27,54,3,114,129,-15
54,27,54,31,69,102,-33
54,27,54,57,117,179,-62
54,27,54,65,0,77,-77
54,29,39,29,149,202,-53
54,29,39,81,206,236,-30
54,29,42,3,191,131,60
54,29,42,7,82,0,82
54,29,42,125,127,118,9
54,29,54,9,354,407,-53
54,31,54,23,165,123,42
54,31,54,27,102,69,33
54,33,42,3,0,53,-53
54,33,54,1,84,75,9
54,33,54,17,185,141,44
54,33,54,41,239,194,45
54,33,54,49,576,544,32
54,33,54,61,208,292,-84
54,33,54,91,269,275,-6
54,33,54,97,136,80,56
54,35,54,39,280,253,27
54,35,54,53,70,88,-18
54,35,54,79,71,0,71
54,35,54,87,71,67,4
54,35,54,107,153,143,10
54,37,24,21,399,237,162
54,37,24,27,53,0,53
54,37,24,31,161,75,86
54,37,24,33,69,0,69
54,37,24,43,161,161,0
54,37,51,43,89,0,89
54,37,51,59,247,87,160
54,37,51,69,116,128,-12
54,37,51,107,642,296,346
54,37,51,153,107,0,107
54,37,51,840,61,0,61
54,37,54,3,1170,1518,-348
54,37,54,61,0,55,-55
54,39,12,9,0,61,-61
54,39,12,127,0,80,-80
54,39,21,111,0,53,-53
54,39,37,119,0,92,-92
54,39,37,183,0,58,-58
54,39,39,49,62,134,-72
54,39,42,3,0,74,-74
54,39,45,51,0,122,-122
54,39,54,5,289,175,114
54,39,54,11,402,395,7
54,39,54,15,118,115,3
54,39,54,19,279,227,52
54,39,54,25,56,0,56
54,39,54,35,253,280,-27
54,39,54,43,213,229,-16
54,39,54,45,108,81,27
54,39,54,49,0,55,-55
54,39,54,53,0,87,-87
54,39,54,61,140,201,-61
54,39,54,67,88,76,12
54,39,54,79,1495,1981,-486
54,39,54,81,218,153,65
54,39,54,87,198,188,10
54,39,54,99,0,73,-73
54,39,54,107,82,101,-19
54,41,54,7,57,0,57
54,41,54,33,194,239,-45
54,41,54,97,145,173,-28
54,43,54,5,84,89,-5
54,43,54,11,144,209,-65
54,43,54,39,229,213,16
54,43,54,45,108,91,17
54,43,54,79,0,70,-70
54,45,54,5,125,153,-28
54,45,54,39,81,108,-27
54,45,54,43,91,108,-17
54,45,54,59,109,129,-20
54,47,51,185,0,94,-94
54,47,54,55,157,268,-111
54,47,54,109,74,107,-33
54,49,42,3,0,81,-81
54,49,54,33,544,576,-32
54,49,54,39,55,0,55
54,49,54,61,632,592,40
54,49,54,77,80,67,13
54,49,54,91,165,221,-56
54,51,39,13,228,241,-13
54,51,54,69,489,613,-124
54,53,39,53,139,152,-13
54,53,39,105,101,87,14
54,53,54,11,394,180,214
54,53,54,35,88,70,18
54,53,54,39,87,0,87
54,53,54,79,140,140,0
54,55,45,51,0,79,-79
54,55,51,21,60,0,60
54,55,51,121,0,61,-61
54,55,51,185,336,296,40
54,55,54,47,268,157,111
54,55,54,63,0,94,-94
54,55,54,81,160,166,-6
54,55,54,89,79,71,8
54,57,24,1,544,429,115
54,57,54,23,71,79,-8
54,57,54,27,179,117,62
54,59,21,195,153,233,-80
54,59,54,45,129,109,20
54,59,54,99,0,136,-136
54,61,24,23,49,0,49
54,61,24,31,51,52,-1
54,61,37,119,0,57,-57
54,61,42,3,161,355,-194
54,61,42,51,191,224,-33
54,61,42,59,205,116,89
54,61,42,125,107,115,-8
54,61,42,129,0,81,-81
54,61,45,51,0,67,-67
54,61,48,201,0,63,-63
54,61,51,59,0,71,-71
54,61,54,3,76,88,-12
54,61,54,11,56,0,56
54,61,54,33,292,208,84
54,61,54,37,55,0,55
54,61,54,39,201,140,61
54,61,54,49,592,632,-40
54,61,54,69,47,0,47
54,61,54,77,464,538,-74
54,61,54,79,0,52,-52
54,61,54,83,51,0,51
54,61,54,91,124,86,38
54,61,54,97,60,0,60
54,61,54,107,109,64,45
54,63,51,71,64,80,-16
54,63,54,25,161,199,-38
54,63,54,55,94,0,94
54,63,54,89,73,102,-29
54,65,24,43,121,124,-3
54,65,51,69,80,57,23
54,65,54,3,429,326,103
54,65,54,27,77,0,77
54,67,54,7,0,69,-69
54,67,54,19,146,147,-1
54,67,54,39,76,88,-12
54,67,54,81,0,62,-62
54,67,54,101,88,92,-4
54,69,39,13,445,496,-51
54,69,39,81,60,76,-16
54,69,42,3,96,130,-34
54,69,42,125,150,116,34
54,69,54,9,102,109,-7
54,69,54,51,613,489,124
54,69,54,61,0,47,-47
54,73,39,167,80,0,80
54,73,54,107,73,112,-39
54,77,24,23,118,108,10
54,77,54,49,67,80,-13
54,77,54,61,538,464,74
54,79,54,11,532,479,53
54,79,54,35,0,71,-71
54,79,54,39,1981,1495,486
54,79,54,43,70,0,70
54,79,54,53,140,140,0
54,79,54,61,52,0,52
54,81,54,11,0,75,-75
54,81,54,19,517,435,82
54,81,54,25,90,79,11
54,81,54,39,153,218,-65
54,81,54,55,166,160,6
54,81,54,67,62,0,62
54,81,54,89,118,86,32
54,81,54,109,186,99,87
54,83,54,1,168,155,13
54,83,54,61,0,51,-51
54,83,54,93,101,118,-17
54,83,54,97,92,104,-12
54,85,54,107,132,146,-14
54,87,54,13,68,0,68
54,87,54,35,67,71,-4
54,87,54,39,188,198,-10
54,89,54,25,91,68,23
54,89,54,55,71,79,-8
54,89,54,63,102,73,29
54,89,54,81,86,118,-32
54,91,54,1,73,0,73
54,91,54,33,275,269,6
54,91,54,49,221,165,56
54,91,54,61,86,124,-38
54,93,54,83,118,101,17
54,95,54,103,207,194,13
54,97,54,1,80,93,-13
54,97,54,33,80,136,-56
54,97,54,41,173,145,28
54,97,54,61,0,60,-60
54,97,54,83,104,92,12
54,99,21,19,100,162,-62
54,99,21,127,123,158,-35
54,99,39,87,195,192,3
54,99,54,11,905,712,193
54,99,54,39,73,0,73
54,99,54,59,136,0,136
54,101,54,67,92,88,4
54,103,39,111,58,0,58
54,103,54,95,194,207,-13
54,105,54,107,153,167,-14
54,107,39,9,67,55,12
54,107,39,49,0,119,-119
54,107,39,167,769,901,-132
54,107,54,35,143,153,-10
54,107,54,39,101,82,19
54,107,54,61,64,109,-45
54,107,54,73,112,73,39
54,107,54,85,146,132,14
54,107,54,105,167,153,14
54,109,54,47,107,74,33
54,109,54,81,99,186,-87
55,1,55,21,189,172,17
55,1,55,25,120,82,38
55,1,55,57,79,80,-1
55,1,55,77,113,87,26
55,1,55,79,105,0,105
55,1,55,111,191,117,74
55,1,55,133,84,0,84
55,1,55,137,59,0,59
55,1,55,141,219,219,0
55,3,55,7,256,236,20
55,3,55,99,57,76,-19
55,5,27,53,116,138,-22
55,5,27,123,0,80,-80
55,5,55,13,55,0,55
55,5,55,17,263,276,-13
55,5,55,25,0,51,-51
55,5,55,33,155,135,20
55,5,55,35,179,196,-17
55,5,55,95,304,217,87
55,5,55,107,138,134,4
55,5,55,109,76,98,-22
55,5,55,113,59,0,59
55,5,55,129,271,213,58
55,7,27,137,58,51,7
55,7,55,3,236,256,-20
55,7,55,31,118,119,-1
55,9,4,13,117,154,-37
55,9,6,37,0,65,-65
55,9,6,73,57,0,57
55,9,8,31,0,42,-42
55,9,17,31,339,264,75
55,9,17,97,74,0,74
55,9,26,41,81,64,17
55,9,26,43,73,0,73
55,9,26,103,49,0,49
55,9,26,109,92,91,1
55,9,27,37,0,83,-83
55,9,27,53,132,301,-169
55,9,27,123,67,139,-72
55,9,55,15,276,243,33
55,9,55,25,275,361,-86
55,9,55,27,73,0,73
55,9,55,29,353,293,60
55,9,55,35,82,55,27
55,9,55,39,137,93,44
55,9,55,41,0,70,-70
55,9,55,59,62,0,62
55,9,55,61,547,548,-1
55,9,55,63,90,0,90
55,9,55,71,574,608,-34
55,9,55,73,192,150,42
55,9,55,75,484,421,63
55,9,55,79,639,567,72
55,9,55,83,899,1358,-459
55,9,55,85,54,60,-6
55,9,55,87,1715,1953,-238
55,9,55,89,81,80,1
55,9,55,97,84,54,30
55,9,55,101,64,0,64
55,9,55,105,0,54,-54
55,9,55,115,469,510,-41
55,9,55,117,183,156,27
55,9,55,127,61,0,61
55,9,55,131,78,0,78
55,9,55,133,126,161,-35
55,9,55,135,118,99,19
55,9,55,139,527,549,-22
55,9,55,141,92,63,29
55,11,27,169,95,80,15
55,11,55,35,153,143,10
55,11,55,91,65,78,-13
55,11,55,121,155,117,38
55,13,27,3,62,0,62
55,13,27,25,65,0,65
55,13,27,37,61,0,61
55,13,27,53,75,0,75
55,13,27,123,76,0,76
55,13,27,163,67,0,67
55,13,55,5,0,55,-55
55,13,55,95,229,170,59
55,13,55,129,91,87,4
55,15,55,9,243,276,-33
55,15,55,25,60,64,-4
55,15,55,39,140,142,-2
55,15,55,71,324,293,31
55,15,55,79,83,92,-9
55,15,55,87,1773,1737,36
55,15,55,117,168,131,37
55,15,55,135,53,69,-16
55,15,55,139,839,741,98
55,17,27,53,63,77,-14
55,17,55,5,276,263,13
55,17,55,19,152,138,14
55,17,55,25,0,73,-73
55,17,55,33,272,267,5
55,17,55,35,1868,1590,278
55,17,55,63,64,0,64
55,17,55,107,132,152,-20
55,17,55,109,73,51,22
55,17,55,119,71,117,-46
55,17,55,121,66,0,66
55,19,55,17,138,152,-14
55,19,55,35,116,104,12
55,19,55,53,110,97,13
55,19,55,73,399,350,49
55,19,55,119,239,253,-14
55,19,55,141,217,282,-65
55,21,55,1,172,189,-17
55,21,55,25,2226,1332,894
55,21,55,27,421,482,-61
55,21,55,39,54,69,-15
55,21,55,47,0,89,-89
55,21,55,55,77,79,-2
55,21,55,57,63,96,-33
55,21,55,77,183,322,-139
55,21,55,79,89,57,32
55,21,55,105,87,118,-31
55,21,55,111,601,662,-61
55,21,55,133,66,76,-10
55,23,19,43,73,92,-19
55,23,55,25,62,42,20
55,23,55,43,207,203,4
55,23,55,63,0,98,-98
55,23,55,123,67,105,-38
55,25,4,13,319,468,-149
55,25,4,19,85,155,-70
55,25,6,1,96,127,-31
55,25,6,13,0,73,-73
55,25,6,37,280,329,-49
55,25,6,59,134,119,15
55,25,6,67,0,65,-65
55,25,6,73,178,257,-79
55,25,6,75,73,114,-41
55,25,6,81,0,81,-81
55,25,6,85,98,328,-230
55,25,8,5,48,109,-61
55,25,8,13,62,120,-58
55,25,8,31,134,264,-130
55,25,8,35,0,66,-66
55,25,8,41,73,90,-17
55,25,8,59,70,115,-45
55,25,8,69,0,109,-109
55,25,9,3,53,0,53
55,25,9,9,0,52,-52
55,25,11,1,117,148,-31
55,25,12,11,0,60,-60
55,25,12,57,54,108,-54
55,25,12,71,72,142,-70
55,25,12,86,66,60,6
55,25,12,95,73,80,-7
55,25,12,99,76,52,24
55,25,12,103,66,97,-31
55,25,12,115,0,77,-77
55,25,13,89,59,54,5
55,25,13,121,50,114,-64
55,25,15,3,64,0,64
55,25,17,19,96,87,9
55,25,17,31,1675,1302,373
55,25,17,37,57,0,57
55,25,17,43,321,199,122
55,25,17,89,136,0,136
55,25,17,97,258,142,116
55,25,17,111,108,55,53
55,25,17,113,80,0,80
55,25,17,177,62,0,62
55,25,17,197,92,75,17
55,25,17,201,344,206,138
55,25,18,97,84,82,2
55,25,19,13,70,0,70
55,25,19,61,164,0,164
55,25,19,103,143,74,69
55,25,19,113,81,63,18
55,25,19,153,116,104,12
55,25,19,163,56,0,56
55,25,19,169,79,0,79
55,25,21,111,0,68,-68
55,25,24,31,81,118,-37
55,25,24,510,0,68,-68
55,25,25,17,129,233,-104
55,25,25,21,0,68,-68
55,25,25,25,48,109,-61
55,25,26,81,67,0,67
55,25,26,125,75,90,-15
55,25,26,161,122,137,-15
55,25,26,163,84,44,40
55,25,27,3,65,62,3
55,25,27,37,74,95,-21
55,25,27,53,415,697,-282
55,25,27,109,118,88,30
55,25,27,123,108,324,-216
55,25,27,137,0,50,-50
55,25,27,163,48,100,-52
55,25,29,189,88,83,5
55,25,29,510,0,55,-55
55,25,32,3,98,140,-42
55,25,34,17,0,53,-53
55,25,34,23,56,0,56
55,25,35,1,0,52,-52
55,25,36,47,88,111,-23
55,25,36,55,50,0,50
55,25,36,61,136,219,-83
55,25,36,81,51,47,4
55,25,36,109,0,63,-63
55,25,37,63,0,69,-69
55,25,37,119,84,85,-1
55,25,37,183,89,142,-53
55,25,39,35,65,60,5
55,25,39,49,97,127,-30
55,25,39,61,73,87,-14
55,25,41,39,0,66,-66
55,25,41,51,101,172,-71
55,25,41,67,0,64,-64
55,25,42,3,85,114,-29
55,25,42,101,68,94,-26
55,25,47,37,0,84,-84
55,25,48,29,68,102,-34
55,25,48,85,71,103,-32
55,25,48,113,93,133,-40
55,25,48,121,69,0,69
55,25,48,201,144,182,-38
55,25,48,439,94,68,26
55,25,48,453,115,217,-102
55,25,49,35,69,74,-5
55,25,51,13,0,60,-60
55,25,51,59,66,68,-2
55,25,53,33,278,608,-330
55,25,53,61,0,57,-57
55,25,55,1,82,120,-38
55,25,55,5,51,0,51
55,25,55,9,361,275,86
55,25,55,15,64,60,4
55,25,55,17,73,0,73
55,25,55,21,1332,2226,-894
55,25,55,23,42,62,-20
55,25,55,27,479,580,-101
55,25,55,29,0,82,-82
55,25,55,35,252,159,93
55,25,55,39,229,187,42
55,25,55,43,305,187,118
55,25,55,45,648,864,-216
55,25,55,47,0,57,-57
55,25,55,49,547,644,-97
55,25,55,55,1070,1264,-194
55,25,55,57,119,88,31
55,25,55,59,129,124,5
55,25,55,63,367,312,55
55,25,55,65,138,86,52
55,25,55,69,0,62,-62
55,25,55,71,73,73,0
55,25,55,73,285,224,61
55,25,55,77,126,143,-17
55,25,55,79,1521,1452,69
55,25,55,81,96,67,29
55,25,55,85,126,134,-8
55,25,55,87,336,289,47
55,25,55,89,175,96,79
55,25,55,97,313,179,134
55,25,55,101,225,156,69
55,25,55,103,90,61,29
55,25,55,105,1588,1977,-389
55,25,55,109,57,0,57
55,25,55,111,917,1128,-211
55,25,55,117,176,129,47
55,25,55,123,53,81,-28
55,25,55,125,54,80,-26
55,25,55,127,310,235,75
55,25,55,131,174,122,52
55,25,55,133,873,704,169
55,25,55,135,50,0,50
55,25,55,139,342,305,37
55,25,55,141,207,125,82
55,27,17,31,0,57,-57
55,27,55,9,0,73,-73
55,27,55,21,482,421,61
55,27,55,25,580,479,101
55,27,55,39,854,946,-92
55,27,55,47,77,115,-38
55,27,55,55,1135,958,177
55,27,55,79,354,293,61
55,27,55,89,61,65,-4
55,27,55,105,83,58,25
55,27,55,111,62,64,-2
55,27,55,117,0,72,-72
55,27,55,131,712,556,156
55,27,55,133,675,432,243
55,27,55,139,112,149,-37
55,29,17,31,100,0,100
55,29,55,9,293,353,-60
55,29,55,25,82,0,82
55,29,55,61,172,195,-23
55,29,55,71,59,0,59
55,29,55,79,128,53,75
55,29,55,87,56,48,8
55,29,55,133,61,0,61
55,31,27,17,123,134,-11
55,31,27,53,57,115,-58
55,31,27,137,996,893,103
55,31,55,7,119,118,1
55,31,55,129,86,73,13
55,33,27,53,86,121,-35
55,33,27,123,0,95,-95
55,33,27,163,56,0,56
55,33,55,5,135,155,-20
55,33,55,17,267,272,-5
55,33,55,35,642,644,-2
55,33,55,91,93,114,-21
55,33,55,93,176,104,72
55,33,55,95,51,60,-9
55,33,55,109,342,237,105
55,35,4,13,0,60,-60
55,35,17,31,61,0,61
55,35,27,37,0,92,-92
55,35,27,53,193,250,-57
55,35,27,109,71,61,10
55,35,27,123,105,156,-51
55,35,27,163,0,69,-69
55,35,55,5,196,179,17
55,35,55,9,55,82,-27
55,35,55,11,143,153,-10
55,35,55,17,1590,1868,-278
55,35,55,19,104,116,-12
55,35,55,25,159,252,-93
55,35,55,33,644,642,2
55,35,55,53,99,107,-8
55,35,55,63,121,98,23
55,35,55,73,93,108,-15
55,35,55,79,94,116,-22
55,35,55,87,0,66,-66
55,35,55,91,59,82,-23
55,35,55,93,0,44,-44
55,35,55,97,65,0,65
55,35,55,107,105,70,35
55,35,55,109,121,125,-4
55,35,55,119,65,0,65
55,35,55,121,357,337,20
55,35,55,133,54,0,54
55,35,55,139,0,50,-50
55,35,55,141,102,55,47
55,37,26,43,126,122,4
55,39,17,31,195,74,121
55,39,55,9,93,137,-44
55,39,55,15,142,140,2
55,39,55,21,69,54,15
55,39,55,25,187,229,-42
55,39,55,27,946,854,92
55,39,55,47,263,305,-42
55,39,55,71,66,55,11
55,39,55,73,58,0,58
55,39,55,77,0,69,-69
55,39,55,79,313,262,51
55,39,55,87,196,212,-16
55,39,55,89,72,0,72
55,39,55,117,216,294,-78
55,39,55,131,528,358,170
55,39,55,133,141,163,-22
55,39,55,137,0,84,-84
55,39,55,139,642,825,-183
55,41,55,9,70,0,70
55,41,55,85,0,70,-70
55,43,17,85,107,106,1
55,43,19,61,261,280,-19
55,43,55,23,203,207,-4
55,43,55,25,187,305,-118
55,43,55,49,317,272,45
55,43,55,63,0,58,-58
55,43,55,65,234,314,-80
55,43,55,79,0,66,-66
55,43,55,103,172,196,-24
55,43,55,111,53,68,-15
55,45,17,177,181,105,76
55,45,17,201,60,49,11
55,45,55,25,864,648,216
55,45,55,65,177,198,-21
55,45,55,105,409,336,73
55,47,55,21,89,0,89
55,47,55,25,57,0,57
55,47,55,27,115,77,38
55,47,55,39,305,263,42
55,47,55,77,74,88,-14
55,47,55,137,170,188,-18
55,47,55,139,208,217,-9
55,49,55,25,644,547,97
55,49,55,43,272,317,-45
55,49,55,65,90,94,-4
55,49,55,103,70,82,-12
55,49,55,111,90,140,-50
55,51,26,53,142,73,69
55,53,55,19,97,110,-13
55,53,55,35,107,99,8
55,53,55,63,182,145,37
55,53,55,81,161,112,49
55,53,55,121,212,170,42
55,55,4,13,0,59,-59
55,55,17,31,58,0,58
55,55,55,21,79,77,2
55,55,55,25,1264,1070,194
55,55,55,27,958,1135,-177
55,55,55,79,474,265,209
55,55,55,101,52,46,6
55,55,55,105,420,392,28
55,55,55,111,58,0,58
55,55,55,127,420,382,38
55,55,55,131,83,88,-5
55,55,55,133,1241,1004,237
55,57,55,1,80,79,1
55,57,55,21,96,63,33
55,57,55,25,88,119,-31
55,57,55,63,52,68,-16
55,57,55,79,69,0,69
55,57,55,81,334,349,-15
55,57,55,111,397,337,60
55,57,55,123,88,0,88
55,57,55,141,61,72,-11
55,59,4,13,75,188,-113
55,59,6,73,0,57,-57
55,59,17,31,1009,493,516
55,59,17,43,151,75,76
55,59,17,89,53,0,53
55,59,17,97,3199,1637,1562
55,59,17,111,372,193,179
55,59,32,3,0,103,-103
55,59,55,9,0,62,-62
55,59,55,25,124,129,-5
55,59,55,79,652,890,-238
55,59,55,101,2245,2685,-440
55,59,55,105,71,54,17
55,59,55,127,414,555,-141
55,59,55,131,0,63,-63
55,59,55,133,202,195,7
55,61,55,9,548,547,1
55,61,55,29,195,172,23
55,61,55,71,64,98,-34
55,61,55,87,0,71,-71
55,63,4,13,0,85,-85
55,63,17,31,93,77,16
55,63,27,37,0,62,-62
55,63,27,53,127,214,-87
55,63,27,55,343,412,-69
55,63,27,109,94,144,-50
55,63,27,123,61,132,-71
55,63,27,163,0,58,-58
55,63,27,169,193,177,16
55,63,55,9,0,90,-90
55,63,55,17,0,64,-64
55,63,55,23,98,0,98
55,63,55,25,312,367,-55
55,63,55,35,98,121,-23
55,63,55,43,58,0,58
55,63,55,53,145,182,-37
55,63,55,57,68,52,16
55,63,55,73,72,74,-2
55,63,55,79,135,161,-26
55,63,55,81,580,680,-100
55,63,55,87,64,58,6
55,63,55,111,0,79,-79
55,63,55,121,365,385,-20
55,63,55,123,533,456,77
55,63,55,133,67,79,-12
55,63,55,141,63,0,63
55,65,19,61,48,0,48
55,65,55,25,86,138,-52
55,65,55,43,314,234,80
55,65,55,45,198,177,21
55,65,55,49,94,90,4
55,67,55,69,76,0,76
55,67,55,73,135,188,-53
55,67,55,79,62,0,62
55,67,55,85,64,95,-31
55,67,55,87,72,0,72
55,67,55,115,128,77,51
55,69,55,25,62,0,62
55,69,55,67,0,76,-76
55,69,55,73,579,476,103
55,69,55,85,169,235,-66
55,71,17,31,59,0,59
55,71,55,9,608,574,34
55,71,55,15,293,324,-31
55,71,55,25,73,73,0
55,71,55,29,0,59,-59
55,71,55,39,55,66,-11
55,71,55,61,98,64,34
55,71,55,79,187,210,-23
55,71,55,87,103,168,-65
55,71,55,117,679,581,98
55,71,55,133,0,44,-44
55,71,55,139,87,107,-20
55,73,17,31,74,61,13
55,73,27,53,65,111,-46
55,73,27,123,0,111,-111
55,73,55,9,150,192,-42
55,73,55,19,350,399,-49
55,73,55,25,224,285,-61
55,73,55,35,108,93,15
55,73,55,39,0,58,-58
55,73,55,63,74,72,2
55,73,55,67,188,135,53
55,73,55,69,476,579,-103
55,73,55,79,167,176,-9
55,73,55,85,189,198,-9
55,73,55,87,118,171,-53
55,73,55,97,427,393,34
55,73,55,99,0,63,-63
55,73,55,115,303,248,55
55,73,55,119,129,155,-26
55,73,55,125,73,88,-15
55,73,55,133,70,89,-19
55,73,55,135,62,61,1
55,73,55,139,87,137,-50
55,73,55,141,768,622,146
55,75,26,43,135,119,16
55,75,26,109,479,376,103
55,75,55,9,421,484,-63
55,75,55,79,116,56,60
55,75,55,83,281,319,-38
55,75,55,87,125,63,62
55,75,55,133,59,0,59
55,75,55,139,53,49,4
55,77,55,1,87,113,-26
55,77,55,21,322,183,139
55,77,55,25,143,126,17
55,77,55,39,69,0,69
55,77,55,47,88,74,14
55,77,55,79,60,0,60
55,77,55,111,63,63,0
55,77,55,137,72,139,-67
55,78,55,115,160,193,-33
55,79,4,13,472,1227,-755
55,79,4,19,74,200,-126
55,79,4,21,0,149,-149
55,79,6,1,60,121,-61
55,79,6,37,271,438,-167
55,79,6,59,98,92,6
55,79,6,67,64,72,-8
55,79,6,71,0,62,-62
55,79,6,73,193,252,-59
55,79,6,75,56,83,-27
55,79,6,81,0,50,-50
55,79,6,85,70,128,-58
55,79,8,5,0,61,-61
55,79,8,13,0,72,-72
55,79,8,31,114,269,-155
55,79,8,41,59,79,-20
55,79,8,59,0,90,-90
55,79,8,69,0,72,-72
55,79,9,3,70,0,70
55,79,11,1,66,109,-43
55,79,12,11,98,98,0
55,79,12,31,70,101,-31
55,79,12,57,134,164,-30
55,79,12,71,63,157,-94
55,79,12,81,0,67,-67
55,79,12,83,0,51,-51
55,79,12,86,74,75,-1
55,79,12,95,121,167,-46
55,79,12,97,82,82,0
55,79,12,99,73,103,-30
55,79,12,101,60,0,60
55,79,12,103,96,132,-36
55,79,12,105,69,105,-36
55,79,12,115,0,71,-71
55,79,13,67,98,105,-7
55,79,13,89,131,136,-5
55,79,13,121,110,210,-100
55,79,13,135,0,129,-129
55,79,17,31,2279,1962,317
55,79,17,43,329,271,58
55,79,17,89,132,97,35
55,79,17,97,564,365,199
55,79,17,111,147,128,19
55,79,17,197,121,81,40
55,79,17,201,210,111,99
55,79,18,89,135,78,57
55,79,18,97,181,209,-28
55,79,18,141,56,0,56
55,79,19,103,77,0,77
55,79,19,153,56,0,56
55,79,21,111,76,63,13
55,79,24,31,0,57,-57
55,79,25,17,61,124,-63
55,79,25,25,60,59,1
55,79,26,65,52,0,52
55,79,26,81,72,83,-11
55,79,26,125,104,117,-13
55,79,26,161,73,76,-3
55,79,26,163,110,158,-48
55,79,27,37,81,112,-31
55,79,27,53,399,534,-135
55,79,27,109,0,72,-72
55,79,27,123,190,208,-18
55,79,29,95,73,0,73
55,79,29,189,97,88,9
55,79,29,510,90,63,27
55,79,31,55,66,0,66
55,79,32,3,222,416,-194
55,79,35,1,0,56,-56
55,79,36,47,93,87,6
55,79,36,61,107,129,-22
55,79,36,81,54,0,54
55,79,37,119,70,221,-151
55,79,37,183,62,113,-51
55,79,39,35,91,87,4
55,79,39,49,116,163,-47
55,79,39,61,49,62,-13
55,79,39,95,0,57,-57
55,79,40,109,51,0,51
55,79,41,51,71,160,-89
55,79,41,67,0,49,-49
55,79,42,3,75,79,-4
55,79,42,101,73,86,-13
55,79,47,37,123,135,-12
55,79,47,157,136,190,-54
55,79,48,29,119,182,-63
55,79,48,85,84,131,-47
55,79,48,113,164,439,-275
55,79,48,121,0,117,-117
55,79,48,201,289,359,-70
55,79,48,439,174,325,-151
55,79,48,453,147,200,-53
55,79,49,35,75,88,-13
55,79,51,59,0,60,-60
55,79,53,33,170,261,-91
55,79,53,53,0,65,-65
55,79,55,1,0,105,-105
55,79,55,9,567,639,-72
55,79,55,15,92,83,9
55,79,55,21,57,89,-32
55,79,55,25,1452,1521,-69
55,79,55,27,293,354,-61
55,79,55,29,53,128,-75
55,79,55,35,116,94,22
55,79,55,39,262,313,-51
55,79,55,43,66,0,66
55,79,55,55,265,474,-209
55,79,55,57,0,69,-69
55,79,55,59,890,652,238
55,79,55,63,161,135,26
55,79,55,67,0,62,-62
55,79,55,71,210,187,23
55,79,55,73,176,167,9
55,79,55,75,56,116,-60
55,79,55,77,0,60,-60
55,79,55,81,51,0,51
55,79,55,85,52,91,-39
55,79,55,87,498,345,153
55,79,55,89,1512,2581,-1069
55,79,55,97,150,119,31
55,79,55,101,2345,2981,-636
55,79,55,105,258,225,33
55,79,55,111,78,70,8
55,79,55,115,0,76,-76
55,79,55,117,499,545,-46
55,79,55,125,48,66,-18
55,79,55,127,546,533,13
55,79,55,131,1516,2584,-1068
55,79,55,133,8580,13504,-4924
55,79,55,135,54,82,-28
55,79,55,137,0,52,-52
55,79,55,139,502,492,10
55,79,55,141,95,108,-13
55,81,55,25,67,96,-29
55,81,55,53,112,161,-49
55,81,55,57,349,334,15
55,81,55,63,680,580,100
55,81,55,79,0,51,-51
55,81,55,123,176,214,-38
55,83,55,9,1358,899,459
55,83,55,75,319,281,38
55,83,55,87,146,145,1
55,83,55,115,221,205,16
55,85,17,31,51,0,51
55,85,55,9,60,54,6
55,85,55,25,134,126,8
55,85,55,41,70,0,70
55,85,55,67,95,64,31
55,85,55,69,235,169,66
55,85,55,73,198,189,9
55,85,55,79,91,52,39
55,85,55,87,70,59,11
55,85,55,97,49,0,49
55,85,55,125,437,453,-16
55,85,55,133,112,52,60
55,85,55,139,52,0,52
55,87,4,13,85,100,-15
55,87,17,31,148,174,-26
55,87,27,53,67,109,-42
55,87,27,123,0,47,-47
55,87,53,33,0,45,-45
55,87,55,9,1953,1715,238
55,87,55,15,1737,1773,-36
55,87,55,25,289,336,-47
55,87,55,29,48,56,-8
55,87,55,35,66,0,66
55,87,55,39,212,196,16
55,87,55,61,71,0,71
55,87,55,63,58,64,-6
55,87,55,67,0,72,-72
55,87,55,71,168,103,65
55,87,55,73,171,118,53
55,87,55,75,63,125,-62
55,87,55,79,345,498,-153
55,87,55,83,145,146,-1
55,87,55,85,59,70,-11
55,87,55,89,51,0,51
55,87,55,97,136,77,59
55,87,55,101,57,0,57
55,87,55,105,59,0,59
55,87,55,115,257,226,31
55,87,55,117,101,63,38
55,87,55,131,88,71,17
55,87,55,133,176,139,37
55,87,55,135,834,896,-62
55,87,55,137,59,119,-60
55,87,55,139,3928,3894,34
55,87,55,141,99,0,99
55,89,4,13,62,83,-21
55,89,17,31,161,113,48
55,89,27,53,0,44,-44
55,89,55,9,80,81,-1
55,89,55,25,96,175,-79
55,89,55,27,65,61,4
55,89,55,39,0,72,-72
55,89,55,79,2581,1512,1069
55,89,55,87,0,51,-51
55,89,55,101,85,0,85
55,89,55,117,411,507,-96
55,89,55,131,876,916,-40
55,89,55,133,521,465,56
55,89,55,139,0,62,-62
55,91,55,11,78,65,13
55,91,55,33,114,93,21
55,91,55,35,82,59,23
55,91,55,93,72,64,8
55,93,27,3,53,0,53
55,93,27,37,331,239,92
55,93,27,49,200,143,57
55,93,27,53,137,181,-44
55,93,27,123,213,201,12
55,93,27,163,363,206,157
55,93,55,33,104,176,-72
55,93,55,35,44,0,44
55,93,55,91,64,72,-8
55,93,55,95,0,68,-68
55,93,55,109,941,1026,-85
55,95,27,3,111,72,39
55,95,27,25,234,153,81
55,95,27,37,102,0,102
55,95,27,53,196,133,63
55,95,27,123,175,114,61
55,95,27,163,257,153,104
55,95,55,5,217,304,-87
55,95,55,13,170,229,-59
55,95,55,33,60,51,9
55,95,55,93,68,0,68
55,95,55,109,698,555,143
55,97,17,31,56,55,1
55,97,55,9,54,84,-30
55,97,55,25,179,313,-134
55,97,55,35,0,65,-65
55,97,55,73,393,427,-34
55,97,55,79,119,150,-31
55,97,55,85,0,49,-49
55,97,55,87,77,136,-59
55,97,55,133,48,84,-36
55,97,55,135,410,261,149
55,97,55,137,115,107,8
55,97,55,139,142,118,24
55,97,55,141,738,741,-3
55,99,55,3,76,57,19
55,99,55,73,63,0,63
55,99,55,119,64,79,-15
55,101,4,13,111,181,-70
55,101,4,19,0,59,-59
55,101,17,31,506,322,184
55,101,17,43,61,0,61
55,101,17,97,610,277,333
55,101,17,111,84,65,19
55,101,27,53,0,44,-44
55,101,32,3,0,68,-68
55,101,55,9,0,64,-64
55,101,55,25,156,225,-69
55,101,55,55,46,52,-6
55,101,55,59,2685,2245,440
55,101,55,79,2981,2345,636
55,101,55,87,0,57,-57
55,101,55,89,0,85,-85
55,101,55,105,72,75,-3
55,101,55,117,0,59,-59
55,101,55,127,640,823,-183
55,101,55,131,65,121,-56
55,101,55,133,929,946,-17
55,101,55,139,0,95,-95
55,103,55,25,61,90,-29
55,103,55,43,196,172,24
55,103,55,49,82,70,12
55,103,55,111,181,203,-22
55,103,55,123,103,88,15
55,105,4,13,78,84,-6
55,105,17,7,84,63,21
55,105,17,31,259,153,106
55,105,17,43,50,0,50
55,105,17,111,128,71,57
55,105,17,201,1087,1073,14
55,105,27,53,0,58,-58
55,105,55,9,54,0,54
55,105,55,21,118,87,31
55,105,55,25,1977,1588,389
55,105,55,27,58,83,-25
55,105,55,45,336,409,-73
55,105,55,55,392,420,-28
55,105,55,59,54,71,-17
55,105,55,79,225,258,-33
55,105,55,87,0,59,-59
55,105,55,101,75,72,3
55,105,55,111,0,58,-58
55,105,55,127,697,479,218
55,105,55,133,142,143,-1
55,105,55,139,49,0,49
55,107,55,5,134,138,-4
55,107,55,17,152,132,20
55,107,55,35,70,105,-35
55,109,4,13,0,97,-97
55,109,27,3,174,121,53
55,109,27,37,408,232,176
55,109,27,53,378,347,31
55,109,27,123,773,479,294
55,109,27,163,1429,820,609
55,109,55,5,98,76,22
55,109,55,17,51,73,-22
55,109,55,25,0,57,-57
55,109,55,33,237,342,-105
55,109,55,35,125,121,4
55,109,55,93,1026,941,85
55,109,55,95,555,698,-143
55,111,17,31,91,56,35
55,111,55,1,117,191,-74
55,111,55,21,662,601,61
55,111,55,25,1128,917,211
55,111,55,27,64,62,2
55,111,55,43,68,53,15
55,111,55,49,140,90,50
55,111,55,55,0,58,-58
55,111,55,57,337,397,-60
55,111,55,63,79,0,79
55,111,55,77,63,63,0
55,111,55,79,70,78,-8
55,111,55,103,203,181,22
55,111,55,105,58,0,58
55,111,55,123,0,55,-55
55,111,55,133,67,0,67
55,113,27,53,50,0,50
55,113,55,5,0,59,-59
55,113,55,129,146,144,2
55,115,55,9,510,469,41
55,115,55,67,77,128,-51
55,115,55,73,248,303,-55
55,115,55,78,193,160,33
55,115,55,79,76,0,76
55,115,55,83,205,221,-16
55,115,55,87,226,257,-31
55,115,55,135,283,248,35
55,115,55,139,152,96,56
55,117,4,13,0,63,-63
55,117,17,31,99,90,9
55,117,55,9,156,183,-27
55,117,55,15,131,168,-37
55,117,55,25,129,176,-47
55,117,55,27,72,0,72
55,117,55,39,294,216,78
55,117,55,71,581,679,-98
55,117,55,79,545,499,46
55,117,55,87,63,101,-38
55,117,55,89,507,411,96
55,117,55,101,59,0,59
55,117,55,131,263,203,60
55,117,55,133,136,115,21
55,117,55,139,113,95,18
55,119,55,17,117,71,46
55,119,55,19,253,239,14
55,119,55,35,0,65,-65
55,119,55,73,155,129,26
55,119,55,99,79,64,15
55,121,27,169,95,54,41
55,121,55,11,117,155,-38
55,121,55,17,0,66,-66
55,121,55,35,337,357,-20
55,121,55,53,170,212,-42
55,121,55,63,385,365,20
55,123,55,23,105,67,38
55,123,55,25,81,53,28
55,123,55,57,0,88,-88
55,123,55,63,456,533,-77
55,123,55,81,214,176,38
55,123,55,103,88,103,-15
55,123,55,111,55,0,55
55,125,17,31,87,0,87
55,125,55,25,80,54,26
55,125,55,73,88,73,15
55,125,55,79,66,48,18
55,125,55,85,453,437,16
55,125,55,133,76,0,76
55,127,4,13,55,103,-48
55,127,6,73,0,48,-48
55,127,17,7,0,81,-81
55,127,17,31,571,254,317
55,127,17,43,166,45,121
55,127,17,89,140,0,140
55,127,17,97,289,175,114
55,127,17,111,784,347,437
55,127,17,197,74,0,74
55,127,17,201,101,90,11
55,127,55,9,0,61,-61
55,127,55,25,235,310,-75
55,127,55,55,382,420,-38
55,127,55,59,555,414,141
55,127,55,79,533,546,-13
55,127,55,101,823,640,183
55,127,55,105,479,697,-218
55,127,55,133,779,806,-27
55,129,27,53,56,0,56
55,129,55,5,213,271,-58
55,129,55,13,87,91,-4
55,129,55,31,73,86,-13
55,129,55,113,144,146,-2
55,131,4,13,61,93,-32
55,131,17,31,85,58,27
55,131,55,9,0,78,-78
55,131,55,25,122,174,-52
55,131,55,27,556,712,-156
55,131,55,39,358,528,-170
55,131,55,55,88,83,5
55,131,55,59,63,0,63
55,131,55,79,2584,1516,1068
55,131,55,87,71,88,-17
55,131,55,89,916,876,40
55,131,55,101,121,65,56
55,131,55,117,203,263,-60
55,131,55,133,2208,1575,633
55,131,55,139,124,109,15
55,133,4,13,256,417,-161
55,133,4,19,0,95,-95
55,133,6,37,81,100,-19
55,133,6,59,0,61,-61
55,133,6,73,104,124,-20
55,133,8,31,0,80,-80
55,133,8,41,0,56,-56
55,133,12,21,0,90,-90
55,133,12,57,0,67,-67
55,133,12,71,76,138,-62
55,133,12,81,0,79,-79
55,133,12,103,0,107,-107
55,133,12,115,0,82,-82
55,133,12,119,0,53,-53
55,133,17,31,643,466,177
55,133,17,43,152,110,42
55,133,17,89,66,0,66
55,133,17,97,192,136,56
55,133,17,111,101,0,101
55,133,17,201,79,0,79
55,133,26,125,0,72,-72
55,133,27,37,68,0,68
55,133,27,53,180,221,-41
55,133,27,123,0,76,-76
55,133,32,3,52,80,-28
55,133,37,119,0,62,-62
55,133,37,183,0,65,-65
55,133,48,85,0,119,-119
55,133,48,113,0,64,-64
55,133,48,121,0,72,-72
55,133,48,201,72,85,-13
55,133,48,439,0,56,-56
55,133,48,453,0,57,-57
55,133,53,33,67,106,-39
55,133,55,1,0,84,-84
55,133,55,9,161,126,35
55,133,55,21,76,66,10
55,133,55,25,704,873,-169
55,133,55,27,432,675,-243
55,133,55,29,0,61,-61
55,133,55,35,0,54,-54
55,133,55,39,163,141,22
55,133,55,55,1004,1241,-237
55,133,55,59,195,202,-7
55,133,55,63,79,67,12
55,133,55,71,44,0,44
55,133,55,73,89,70,19
55,133,55,75,0,59,-59
55,133,55,79,13504,8580,4924
55,133,55,85,52,112,-60
55,133,55,87,139,176,-37
55,133,55,89,465,521,-56
55,133,55,97,84,48,36
55,133,55,101,946,929,17
55,133,55,105,143,142,1
55,133,55,111,0,67,-67
55,133,55,117,115,136,-21
55,133,55,125,0,76,-76
55,133,55,127,806,779,27
55,133,55,131,1575,2208,-633
55,133,55,139,209,189,20
55,133,55,141,62,57,5
55,135,55,9,99,118,-19
55,135,55,15,69,53,16
55,135,55,25,0,50,-50
55,135,55,73,61,62,-1
55,135,55,79,82,54,28
55,135,55,87,896,834,62
55,135,55,97,261,410,-149
55,135,55,115,248,283,-35
55,135,55,137,202,116,86
55,135,55,139,347,367,-20
55,135,55,141,71,0,71
55,137,55,1,0,59,-59
55,137,55,39,84,0,84
55,137,55,47,188,170,18
55,137,55,77,139,72,67
55,137,55,79,52,0,52
55,137,55,87,119,59,60
55,137,55,97,107,115,-8
55,137,55,135,116,202,-86
55,137,55,139,308,205,103
55,137,55,141,75,81,-6
55,139,4,13,77,77,0
55,139,6,37,0,43,-43
55,139,17,31,184,141,43
55,139,27,53,0,115,-115
55,139,55,9,549,527,22
55,139,55,15,741,839,-98
55,139,55,25,305,342,-37
55,139,55,27,149,112,37
55,139,55,35,50,0,50
55,139,55,39,825,642,183
55,139,55,47,217,208,9
55,139,55,71,107,87,20
55,139,55,73,137,87,50
55,139,55,75,49,53,-4
55,139,55,79,492,502,-10
55,139,55,85,0,52,-52
55,139,55,87,3894,3928,-34
55,139,55,89,62,0,62
55,139,55,97,118,142,-24
55,139,55,101,95,0,95
55,139,55,105,0,49,-49
55,139,55,115,96,152,-56
55,139,55,117,95,113,-18
55,139,55,131,109,124,-15
55,139,55,133,189,209,-20
55,139,55,135,367,347,20
55,139,55,137,205,308,-103
55,139,55,141,48,57,-9
55,141,27,53,0,71,-71
55,141,55,1,219,219,0
55,141,55,9,63,92,-29
55,141,55,19,282,217,65
55,141,55,25,125,207,-82
55,141,55,35,55,102,-47
55,141,55,57,72,61,11
55,141,55,63,0,63,-63
55,141,55,73,622,768,-146
55,141,55,79,108,95,13
55,141,55,87,0,99,-99
55,141,55,97,741,738,3
55,141,55,133,57,62,-5
55,141,55,135,0,71,-71
55,141,55,137,81,75,6
55,141,55,139,57,48,9
56,1,4,13,0,64,-64
56,1,8,1,0,46,-46
56,1,8,5,0,73,-73
56,1,8,31,0,73,-73
56,1,8,59,0,63,-63
56,1,8,69,195,241,-46
56,1,8,123,0,84,-84
56,1,49,35,0,65,-65
56,1,56,5,58,46,12
56,1,56,7,73,81,-8
56,1,56,13,64,78,-14
56,1,56,21,322,449,-127
56,1,56,25,125,151,-26
56,1,56,29,81,0,81
56,1,56,33,50,63,-13
56,1,56,37,56,0,56
56,3,56,29,216,229,-13
56,5,4,13,0,93,-93
56,5,30,111,0,71,-71
56,5,46,81,76,73,3
56,5,46,103,110,93,17
56,5,56,1,46,58,-12
56,5,56,9,74,77,-3
56,5,56,11,127,148,-21
56,5,56,19,84,0,84
56,5,56,21,74,72,2
56,5,56,25,147,131,16
56,5,56,29,61,0,61
56,5,56,33,124,137,-13
56,5,56,45,78,0,78
56,7,56,1,81,73,8
56,7,56,21,65,122,-57
56,7,56,25,0,96,-96
56,7,56,37,75,0,75
56,9,56,5,77,74,3
56,9,56,25,191,267,-76
56,11,56,5,148,127,21
56,13,56,1,78,64,14
56,13,56,21,67,105,-38
56,13,56,25,129,189,-60
56,13,56,29,0,66,-66
56,13,56,37,0,57,-57
56,15,31,157,70,117,-47
56,15,56,21,62,126,-64
56,19,56,5,0,84,-84
56,19,56,25,61,0,61
56,19,56,33,121,118,3
56,21,4,13,109,241,-132
56,21,4,19,0,83,-83
56,21,6,37,63,48,15
56,21,6,83,87,0,87
56,21,8,1,163,106,57
56,21,8,5,160,131,29
56,21,8,13,59,50,9
56,21,8,31,87,91,-4
56,21,8,35,67,50,17
56,21,8,41,120,162,-42
56,21,8,59,114,97,17
56,21,8,69,583,504,79
56,21,8,77,79,0,79
56,21,8,123,332,271,61
56,21,31,157,64,53,11
56,21,32,3,125,132,-7
56,21,38,101,103,0,103
56,21,48,29,130,158,-28
56,21,56,1,449,322,127
56,21,56,5,72,74,-2
56,21,56,7,122,65,57
56,21,56,13,105,67,38
56,21,56,15,126,62,64
56,21,56,25,196,152,44
56,21,56,31,82,70,12
56,21,56,33,0,63,-63
56,21,56,37,113,0,113
56,23,49,35,84,0,84
56,23,56,35,0,73,-73
56,23,56,37,85,61,24
56,23,56,39,214,71,143
56,23,56,41,0,72,-72
56,25,4,13,68,123,-55
56,25,8,1,0,72,-72
56,25,8,5,77,56,21
56,25,8,31,0,80,-80
56,25,8,41,0,73,-73
56,25,8,59,61,0,61
56,25,8,69,77,123,-46
56,25,8,123,0,114,-114
56,25,30,111,66,111,-45
56,25,32,3,113,84,29
56,25,56,1,151,125,26
56,25,56,5,131,147,-16
56,25,56,7,96,0,96
56,25,56,9,267,191,76
56,25,56,13,189,129,60
56,25,56,19,0,61,-61
56,25,56,21,152,196,-44
56,25,56,29,92,59,33
56,25,56,33,94,114,-20
56,25,56,37,92,89,3
56,25,56,43,59,0,59
56,29,30,111,117,131,-14
56,29,56,1,0,81,-81
56,29,56,3,229,216,13
56,29,56,5,0,61,-61
56,29,56,13,66,0,66
56,29,56,25,59,92,-33
56,31,56,21,70,82,-12
56,33,30,111,69,147,-78
56,33,56,1,63,50,13
56,33,56,5,137,124,13
56,33,56,19,118,121,-3
56,33,56,21,63,0,63
56,33,56,25,114,94,20
56,35,56,23,73,0,73
56,35,56,37,110,0,110
56,35,56,39,52,0,52
56,37,4,13,0,75,-75
56,37,8,123,0,62,-62
56,37,32,3,0,67,-67
56,37,49,35,100,171,-71
56,37,49,49,0,69,-69
56,37,56,1,0,56,-56
56,37,56,7,0,75,-75
56,37,56,13,57,0,57
56,37,56,21,0,113,-113
56,37,56,23,61,85,-24
56,37,56,25,89,92,-3
56,37,56,35,0,110,-110
56,37,56,41,121,140,-19
56,39,6,37,65,0,65
56,39,8,31,0,55,-55
56,39,16,19,0,79,-79
56,39,16,81,229,345,-116
56,39,30,31,0,88,-88
56,39,36,61,47,0,47
56,39,49,35,57,95,-38
56,39,56,23,71,214,-143
56,39,56,35,0,52,-52
56,41,49,35,97,136,-39
56,41,56,23,72,0,72
56,41,56,37,140,121,19
56,43,56,25,0,59,-59
56,45,56,5,0,78,-78
